Generate the inflected form for: Βισάλτης N;ACC(DU)	Βῐσᾰ́λτᾱ	Βῐσᾰ́λτᾱ
Generate the inflected form for: Βισάλτης N;ACC(PL)	Βῐσᾰ́λτᾱς	Βῐσᾰ́λτᾱς
Generate the inflected form for: Βισάλτης N;ACC(SG)	Βῐσᾰ́λτην	Βῐσᾰ́λτην
Generate the inflected form for: Βισάλτης N;DAT(DU)	Βῐσᾰ́λταιν	Βῐσᾰ́λταιν
Generate the inflected form for: Βισάλτης N;DAT(PL)	Βῐσᾰ́λταις	Βῐσᾰ́λταις
Generate the inflected form for: Βισάλτης N;DAT(SG)	Βῐσᾰ́λτῃ	Βῐσᾰ́λτῃ
Generate the inflected form for: Βισάλτης N;GEN(DU)	Βῐσᾰ́λταιν	Βῐσᾰ́λταιν
Generate the inflected form for: Βισάλτης N;GEN(PL)	Βῐσᾰ́λτων	Βῐσᾰλτῶν
Generate the inflected form for: Βισάλτης N;GEN(SG)	Βῐσᾰ́λτου	Βῐσᾰ́λτου
Generate the inflected form for: Βισάλτης N;NOM(DU)	Βῐσᾰ́λτᾱ	Βῐσᾰ́λτᾱ
Generate the inflected form for: Βισάλτης N;NOM(PL)	Βῐσᾰ́λται	Βῐσᾰ́λται
Generate the inflected form for: Βισάλτης N;NOM(SG)	Βῐσᾰ́λτης	Βῐσᾰ́λτης
Generate the inflected form for: Βισάλτης N;VOC(DU)	Βῐσᾰ́λτᾱ	Βῐσᾰ́λτᾱ
Generate the inflected form for: Βισάλτης N;VOC(PL)	Βῐσᾰ́λται	Βῐσᾰ́λται
Generate the inflected form for: Βισάλτης N;VOC(SG)	Βῐσᾰ́λτη	Βῐσᾰ́λτᾰ
Generate the inflected form for: Μασσαλιώτης N;ACC(DU)	Μᾰσσαλιώτᾱ	Μασσαλιώτᾱ
Generate the inflected form for: Μασσαλιώτης N;ACC(PL)	Μᾰσσαλιώτᾱς	Μασσαλιώτᾱς
Generate the inflected form for: Μασσαλιώτης N;ACC(SG)	Μᾰσσαλιώτην	Μασσαλιώτην
Generate the inflected form for: Μασσαλιώτης N;DAT(DU)	Μᾰσσαλιώταιν	Μασσαλιώταιν
Generate the inflected form for: Μασσαλιώτης N;DAT(PL)	Μᾰσσαλιώταις	Μασσαλιώταις
Generate the inflected form for: Μασσαλιώτης N;DAT(SG)	Μᾰσσαλιώτῃ	Μασσαλιώτῃ
Generate the inflected form for: Μασσαλιώτης N;GEN(DU)	Μᾰσσαλιώταιν	Μασσαλιώταιν
Generate the inflected form for: Μασσαλιώτης N;GEN(PL)	Μᾰσσαλιώτων	Μασσαλιωτῶν
Generate the inflected form for: Μασσαλιώτης N;GEN(SG)	Μᾰσσαλιώτου	Μασσαλιώτου
Generate the inflected form for: Μασσαλιώτης N;NOM(DU)	Μᾰσσαλιώτᾱ	Μασσαλιώτᾱ
Generate the inflected form for: Μασσαλιώτης N;NOM(PL)	Μᾰσσαλιώται	Μασσαλιῶται
Generate the inflected form for: Μασσαλιώτης N;NOM(SG)	Μασσαλιώτης	Μασσαλιώτης
Generate the inflected form for: Μασσαλιώτης N;VOC(DU)	Μᾰσσαλιώτᾱ	Μασσαλιώτᾱ
Generate the inflected form for: Μασσαλιώτης N;VOC(PL)	Μᾰσσαλιώται	Μασσαλιῶται
Generate the inflected form for: Μασσαλιώτης N;VOC(SG)	Μᾰσσαλιώτη	Μασσαλιῶτᾰ
Generate the inflected form for: Μιθριακός ADJ;ACC(DU;MASC)	Μιθριακώ	Μιθριακώ
Generate the inflected form for: Μιθριακός ADJ;ACC(DU;NEUT)	Μιθριακώ	Μιθριακώ
Generate the inflected form for: Μιθριακός ADJ;ACC(PL;FEM)	Μιθριακᾱ́ς	Μιθριακᾱ́ς
Generate the inflected form for: Μιθριακός ADJ;ACC(PL;MASC)	Μιθριακούς	Μιθριακούς
Generate the inflected form for: Μιθριακός ADJ;ACC(PL;NEUT)	Μιθριακᾰ́	Μιθριακᾰ́
Generate the inflected form for: Μιθριακός ADJ;ACC(SG;FEM)	Μιθριακήν	Μιθριακήν
Generate the inflected form for: Μιθριακός ADJ;DAT(DU;FEM)	Μιθριακαῖν	Μιθριακαῖν
Generate the inflected form for: Μιθριακός ADJ;DAT(DU;MASC)	Μιθριακοῖν	Μιθριακοῖν
Generate the inflected form for: Μιθριακός ADJ;DAT(PL;MASC)	Μιθριακοῖς	Μιθριακοῖς
Generate the inflected form for: Μιθριακός ADJ;DAT(SG;FEM)	Μιθριακῇ	Μιθριακῇ
Generate the inflected form for: Μιθριακός ADJ;DAT(SG;MASC)	Μιθριακῷ	Μιθριακῷ
Generate the inflected form for: Μιθριακός ADJ;DAT(SG;NEUT)	Μιθριακῷ	Μιθριακῷ
Generate the inflected form for: Μιθριακός ADJ;GEN(DU;FEM)	Μιθριακαῖν	Μιθριακαῖν
Generate the inflected form for: Μιθριακός ADJ;GEN(DU;MASC)	Μιθριακοῖν	Μιθριακοῖν
Generate the inflected form for: Μιθριακός ADJ;GEN(DU;NEUT)	Μιθριακοῖν	Μιθριακοῖν
Generate the inflected form for: Μιθριακός ADJ;GEN(PL;MASC)	Μιθριακῶν	Μιθριακῶν
Generate the inflected form for: Μιθριακός ADJ;GEN(PL;NEUT)	Μιθριακῶν	Μιθριακῶν
Generate the inflected form for: Μιθριακός ADJ;GEN(SG;FEM)	Μιθριακῆς	Μιθριακῆς
Generate the inflected form for: Μιθριακός ADJ;GEN(SG;MASC)	Μιθριακοῦ	Μιθριακοῦ
Generate the inflected form for: Μιθριακός ADJ;GEN(SG;NEUT)	Μιθριακοῦ	Μιθριακοῦ
Generate the inflected form for: Μιθριακός ADJ;NOM(DU;FEM)	Μιθριακᾱ́	Μιθριακᾱ́
Generate the inflected form for: Μιθριακός ADJ;NOM(DU;MASC)	Μιθριακώ	Μιθριακώ
Generate the inflected form for: Μιθριακός ADJ;NOM(DU;NEUT)	Μιθριακώ	Μιθριακώ
Generate the inflected form for: Μιθριακός ADJ;NOM(PL;FEM)	Μιθριακαί	Μιθριακαί
Generate the inflected form for: Μιθριακός ADJ;NOM(PL;MASC)	Μιθριακοί	Μιθριακοί
Generate the inflected form for: Μιθριακός ADJ;NOM(PL;NEUT)	Μιθριακᾰ́	Μιθριακᾰ́
Generate the inflected form for: Μιθριακός ADJ;NOM(SG;FEM)	Μιθριακή	Μιθριακή
Generate the inflected form for: Μιθριακός ADJ;VOC(DU;MASC)	Μιθριακώ	Μιθριακώ
Generate the inflected form for: Μιθριακός ADJ;VOC(PL;FEM)	Μιθριακαί	Μιθριακαί
Generate the inflected form for: Μιθριακός ADJ;VOC(PL;NEUT)	Μιθριακᾰ́	Μιθριακᾰ́
Generate the inflected form for: Μιθριακός ADJ;VOC(SG;FEM)	Μιθριακή	Μιθριακή
Generate the inflected form for: Μιθριακός ADJ;VOC(SG;MASC)	Μιθριακέ	Μιθριακέ
Generate the inflected form for: Μιθριακός ADJ;VOC(SG;NEUT)	Μιθριακόν	Μιθριακόν
Generate the inflected form for: αἴγιλος N;ACC(DU)	αἰγῐ́λω	αἰγῐ́λω
Generate the inflected form for: αἴγιλος N;ACC(PL)	αἰγῐλους	αἰγῐ́λους
Generate the inflected form for: αἴγιλος N;ACC(SG)	αἴγιλον	αἴγῐλον
Generate the inflected form for: αἴγιλος N;DAT(DU)	αἰγῐ́λοιν	αἰγῐ́λοιν
Generate the inflected form for: αἴγιλος N;DAT(PL)	αἰγῐ́λοις	αἰγῐ́λοις
Generate the inflected form for: αἴγιλος N;DAT(SG)	αἰγῐ́λῳ	αἰγῐ́λῳ
Generate the inflected form for: αἴγιλος N;GEN(DU)	αἰγῐ́λοιν	αἰγῐ́λοιν
Generate the inflected form for: αἴγιλος N;GEN(PL)	αἰγῐ́λων	αἰγῐ́λων
Generate the inflected form for: αἴγιλος N;GEN(SG)	αἰγῐ́λου	αἰγῐ́λου
Generate the inflected form for: αἴγιλος N;NOM(DU)	αἰγῐ́λω	αἰγῐ́λω
Generate the inflected form for: αἴγιλος N;NOM(PL)	αἴγιλοι	αἴγῐλοι
Generate the inflected form for: αἴγιλος N;NOM(SG)	αἴγιλος	αἴγῐλος
Generate the inflected form for: αἴγιλος N;VOC(DU)	αἰγῐ́λω	αἰγῐ́λω
Generate the inflected form for: αἴγιλος N;VOC(PL)	αἴγιλοι	αἴγῐλοι
Generate the inflected form for: αἴγιλος N;VOC(SG)	αἴγιλε	αἴγῐλε
Generate the inflected form for: αὔρα N;ACC(DU)	αὐρᾱ	αὔρᾱ
Generate the inflected form for: αὔρα N;ACC(PL)	αὔρᾱς	αὔρᾱς
Generate the inflected form for: αὔρα N;ACC(SG)	αὔρᾱν	αὔρᾱν
Generate the inflected form for: αὔρα N;DAT(DU)	αὐραῖν	αὔραιν
Generate the inflected form for: αὔρα N;DAT(PL)	αὐραῖς	αὔραις
Generate the inflected form for: αὔρα N;DAT(SG)	αὐρᾳ	αὔρᾳ
Generate the inflected form for: αὔρα N;GEN(DU)	αὐραῖν	αὔραιν
Generate the inflected form for: αὔρα N;GEN(PL)	αὐρῶν	αὐρῶν
Generate the inflected form for: αὔρα N;GEN(SG)	αὐρῆς	αὔρᾱς
Generate the inflected form for: αὔρα N;NOM(DU)	αὐρᾱ	αὔρᾱ
Generate the inflected form for: αὔρα N;NOM(PL)	αὔραι	αὖραι
Generate the inflected form for: αὔρα N;NOM(SG)	αὔρᾱ	αὔρᾱ
Generate the inflected form for: αὔρα N;VOC(DU)	αὐρᾱ	αὔρᾱ
Generate the inflected form for: αὔρα N;VOC(PL)	αὔραι	αὖραι
Generate the inflected form for: αὔρα N;VOC(SG)	αὔρᾱ	αὔρᾱ
Generate the inflected form for: βραχύτης N;ACC(DU)	βρᾰχῠτᾱ́	βρᾰχῠ́τητε
Generate the inflected form for: βραχύτης N;ACC(PL)	βρᾰχῠ́τᾱς	βρᾰχῠ́τητᾰς
Generate the inflected form for: βραχύτης N;ACC(SG)	βρᾰχῠ́την	βρᾰχῠ́τητᾰ
Generate the inflected form for: βραχύτης N;DAT(DU)	βρᾰχῠταῖν	βρᾰχῠτήτοιν
Generate the inflected form for: βραχύτης N;DAT(PL)	βρᾰχῠταῖς	βρᾰχῠ́τησῐ(ν)
Generate the inflected form for: βραχύτης N;DAT(SG)	βρᾰχῠτῃ	βρᾰχῠ́τητῐ
Generate the inflected form for: βραχύτης N;GEN(DU)	βρᾰχῠταῖν	βρᾰχῠτήτοιν
Generate the inflected form for: βραχύτης N;GEN(PL)	βρᾰχῠτῶν	βρᾰχῠτήτων
Generate the inflected form for: βραχύτης N;GEN(SG)	βρᾰχῠτῆς	βρᾰχῠ́τητος
Generate the inflected form for: βραχύτης N;NOM(DU)	βρᾰχῠτᾱ́	βρᾰχῠ́τητε
Generate the inflected form for: βραχύτης N;NOM(PL)	βρᾰχῠ́ται	βρᾰχῠ́τητες
Generate the inflected form for: βραχύτης N;NOM(SG)	βρᾰχῠ́της	βρᾰχῠ́της
Generate the inflected form for: βραχύτης N;VOC(DU)	βρᾰχῠτᾱ́	βρᾰχῠ́τητε
Generate the inflected form for: βραχύτης N;VOC(PL)	βρᾰχῠ́ται	βρᾰχῠ́τητες
Generate the inflected form for: βραχύτης N;VOC(SG)	βρᾰχῠ́τη	βρᾰχῠ́τη
Generate the inflected form for: γοεδνός ADJ;ACC(DU;FEM)	γοεδνᾱ́	γοεδνᾱ́
Generate the inflected form for: γοεδνός ADJ;ACC(DU;NEUT)	γοεδνώ	γοεδνώ
Generate the inflected form for: γοεδνός ADJ;ACC(PL;FEM)	γοεδνᾱ́ς	γοεδνᾱ́ς
Generate the inflected form for: γοεδνός ADJ;ACC(PL;NEUT)	γοεδνᾰ́	γοεδνᾰ́
Generate the inflected form for: γοεδνός ADJ;ACC(SG;FEM)	γοεδνήν	γοεδνήν
Generate the inflected form for: γοεδνός ADJ;ACC(SG;NEUT)	γοεδνόν	γοεδνόν
Generate the inflected form for: γοεδνός ADJ;DAT(DU;MASC)	γοεδνοῖν	γοεδνοῖν
Generate the inflected form for: γοεδνός ADJ;DAT(DU;NEUT)	γοεδνοῖν	γοεδνοῖν
Generate the inflected form for: γοεδνός ADJ;DAT(PL;MASC)	γοεδνοῖς	γοεδνοῖς
Generate the inflected form for: γοεδνός ADJ;DAT(SG;FEM)	γοεδνῇ	γοεδνῇ
Generate the inflected form for: γοεδνός ADJ;DAT(SG;MASC)	γοεδνῷ	γοεδνῷ
Generate the inflected form for: γοεδνός ADJ;DAT(SG;NEUT)	γοεδνῷ	γοεδνῷ
Generate the inflected form for: γοεδνός ADJ;GEN(DU;MASC)	γοεδνοῖν	γοεδνοῖν
Generate the inflected form for: γοεδνός ADJ;GEN(DU;NEUT)	γοεδνοῖν	γοεδνοῖν
Generate the inflected form for: γοεδνός ADJ;GEN(PL;FEM)	γοεδνῶν	γοεδνῶν
Generate the inflected form for: γοεδνός ADJ;GEN(PL;MASC)	γοεδνῶν	γοεδνῶν
Generate the inflected form for: γοεδνός ADJ;GEN(SG;FEM)	γοεδνῆς	γοεδνῆς
Generate the inflected form for: γοεδνός ADJ;GEN(SG;MASC)	γοεδνοῦ	γοεδνοῦ
Generate the inflected form for: γοεδνός ADJ;GEN(SG;NEUT)	γοεδνοῦ	γοεδνοῦ
Generate the inflected form for: γοεδνός ADJ;NOM(DU;FEM)	γοεδνᾱ́	γοεδνᾱ́
Generate the inflected form for: γοεδνός ADJ;NOM(DU;NEUT)	γοεδνώ	γοεδνώ
Generate the inflected form for: γοεδνός ADJ;NOM(PL;FEM)	γοεδναί	γοεδναί
Generate the inflected form for: γοεδνός ADJ;NOM(PL;NEUT)	γοεδνᾰ́	γοεδνᾰ́
Generate the inflected form for: γοεδνός ADJ;NOM(SG;FEM)	γοεδνή	γοεδνή
Generate the inflected form for: γοεδνός ADJ;NOM(SG;MASC)	γοεδνός	γοεδνός
Generate the inflected form for: γοεδνός ADJ;VOC(DU;FEM)	γοεδνᾱ́	γοεδνᾱ́
Generate the inflected form for: γοεδνός ADJ;VOC(DU;NEUT)	γοεδνώ	γοεδνώ
Generate the inflected form for: γοεδνός ADJ;VOC(PL;FEM)	γοεδναί	γοεδναί
Generate the inflected form for: γοεδνός ADJ;VOC(PL;MASC)	γοεδνοί	γοεδνοί
Generate the inflected form for: γοεδνός ADJ;VOC(PL;NEUT)	γοεδνᾰ́	γοεδνᾰ́
Generate the inflected form for: γοεδνός ADJ;VOC(SG;FEM)	γοεδνή	γοεδνή
Generate the inflected form for: γοεδνός ADJ;VOC(SG;MASC)	γοεδνέ	γοεδνέ
Generate the inflected form for: γοεδνός ADJ;VOC(SG;NEUT)	γοεδνόν	γοεδνόν
Generate the inflected form for: διθυμία N;ACC(DU)	δῐθῡμῐ́ᾱ	δῐθῡμῐ́ᾱ
Generate the inflected form for: διθυμία N;ACC(PL)	δῐθῡμῐ́ᾱς	δῐθῡμῐ́ᾱς
Generate the inflected form for: διθυμία N;ACC(SG)	δῐθῡμῐ́ᾱν	δῐθῡμῐ́ᾱν
Generate the inflected form for: διθυμία N;DAT(DU)	δῐθῡμῐ́αιν	δῐθῡμῐ́αιν
Generate the inflected form for: διθυμία N;DAT(PL)	δῐθῡμῐ́αις	δῐθῡμῐ́αις
Generate the inflected form for: διθυμία N;DAT(SG)	δῐθῡμῐ́ᾳ	δῐθῡμῐ́ᾳ
Generate the inflected form for: διθυμία N;GEN(DU)	δῐθῡμῐ́αιν	δῐθῡμῐ́αιν
Generate the inflected form for: διθυμία N;GEN(PL)	δῐθῡμῐ́ᾱς	δῐθῡμῐῶν
Generate the inflected form for: διθυμία N;GEN(SG)	δῐθῡμῐ́ᾱς	δῐθῡμῐ́ᾱς
Generate the inflected form for: διθυμία N;NOM(DU)	δῐθῡμῐ́ᾱ	δῐθῡμῐ́ᾱ
Generate the inflected form for: διθυμία N;NOM(PL)	δῐθῡμῐ́αι	δῐθῡμῐ́αι
Generate the inflected form for: διθυμία N;NOM(SG)	δῐθῡμῐ́ᾱ	δῐθῡμῐ́ᾱ
Generate the inflected form for: διθυμία N;VOC(DU)	δῐθῡμῐ́ᾱ	δῐθῡμῐ́ᾱ
Generate the inflected form for: διθυμία N;VOC(PL)	δῐθῡμῐ́αι	δῐθῡμῐ́αι
Generate the inflected form for: διθυμία N;VOC(SG)	δῐθῡμῐ́ᾱ	δῐθῡμῐ́ᾱ
Generate the inflected form for: δορκάς N;ACC(DU)	δορκᾱ́	δορκᾰ́δε
Generate the inflected form for: δορκάς N;ACC(PL)	δορκᾱ́ς	δορκᾰ́δᾰς
Generate the inflected form for: δορκάς N;ACC(SG)	δορκᾰ́δεν	δορκᾰ́δᾰ
Generate the inflected form for: δορκάς N;DAT(DU)	δορκαῖν	δορκᾰ́δοιν
Generate the inflected form for: δορκάς N;DAT(PL)	δορκαῖς	δορκᾰ́σῐ
Generate the inflected form for: δορκάς N;DAT(SG)	δορκᾰ́δῐ	δορκᾰ́δῐ
Generate the inflected form for: δορκάς N;GEN(DU)	δορκᾰ́δοιν	δορκᾰ́δοιν
Generate the inflected form for: δορκάς N;GEN(PL)	δορκᾰ́σῶν	δορκᾰ́δων
Generate the inflected form for: δορκάς N;GEN(SG)	δορκᾰ́δος	δορκᾰ́δος
Generate the inflected form for: δορκάς N;NOM(DU)	δορκᾱ́	δορκᾰ́δε
Generate the inflected form for: δορκάς N;NOM(PL)	δορκᾰ́δες	δορκᾰ́δες
Generate the inflected form for: δορκάς N;NOM(SG)	δορκᾰ́ς	δορκᾰ́ς
Generate the inflected form for: δορκάς N;VOC(DU)	δορκᾱ́	δορκᾰ́δε
Generate the inflected form for: δορκάς N;VOC(PL)	δορκᾰ́δες	δορκᾰ́δες
Generate the inflected form for: δορκάς N;VOC(SG)	δορκᾰ́	δορκᾰ́ς
Generate the inflected form for: θήρα N;ACC(DU)	θήρᾱ	θήρᾱ
Generate the inflected form for: θήρα N;ACC(PL)	θήρᾱς	θήρᾱς
Generate the inflected form for: θήρα N;ACC(SG)	θήρᾱν	θήρᾱν
Generate the inflected form for: θήρα N;DAT(DU)	θήραιν	θήραιν
Generate the inflected form for: θήρα N;DAT(PL)	θήραις	θήραις
Generate the inflected form for: θήρα N;DAT(SG)	θήρᾳ	θήρᾳ
Generate the inflected form for: θήρα N;GEN(DU)	θήραιν	θήραιν
Generate the inflected form for: θήρα N;GEN(PL)	θήρῶν	θηρῶν
Generate the inflected form for: θήρα N;GEN(SG)	θήρᾱς	θήρᾱς
Generate the inflected form for: θήρα N;NOM(DU)	θήρᾱ	θήρᾱ
Generate the inflected form for: θήρα N;NOM(PL)	θήραι	θῆραι
Generate the inflected form for: θήρα N;NOM(SG)	θήρᾱ	θήρᾱ
Generate the inflected form for: θήρα N;VOC(DU)	θήρᾱ	θήρᾱ
Generate the inflected form for: θήρα N;VOC(PL)	θήραι	θῆραι
Generate the inflected form for: θήρα N;VOC(SG)	θήρᾱ	θήρᾱ
Generate the inflected form for: θρεπτικός ADJ;ACC(DU;FEM)	θρεπτικᾱ́	θρεπτῐκᾱ́
Generate the inflected form for: θρεπτικός ADJ;ACC(DU;MASC)	θρεπτικώ	θρεπτῐκώ
Generate the inflected form for: θρεπτικός ADJ;ACC(DU;NEUT)	θρεπτικώ	θρεπτῐκώ
Generate the inflected form for: θρεπτικός ADJ;ACC(PL;MASC)	θρεπτικούς	θρεπτῐκούς
Generate the inflected form for: θρεπτικός ADJ;ACC(PL;NEUT)	θρεπτικᾰ́	θρεπτῐκᾰ́
Generate the inflected form for: θρεπτικός ADJ;ACC(SG;FEM)	θρεπτικήν	θρεπτῐκήν
Generate the inflected form for: θρεπτικός ADJ;ACC(SG;MASC)	θρεπτικόν	θρεπτῐκόν
Generate the inflected form for: θρεπτικός ADJ;ACC(SG;NEUT)	θρεπτικόν	θρεπτῐκόν
Generate the inflected form for: θρεπτικός ADJ;DAT(DU;FEM)	θρεπτικαῖν	θρεπτῐκαῖν
Generate the inflected form for: θρεπτικός ADJ;DAT(DU;NEUT)	θρεπτικοῖν	θρεπτῐκοῖν
Generate the inflected form for: θρεπτικός ADJ;DAT(PL;FEM)	θρεπτικαῖς	θρεπτῐκαῖς
Generate the inflected form for: θρεπτικός ADJ;DAT(PL;NEUT)	θρεπτικοῖς	θρεπτῐκοῖς
Generate the inflected form for: θρεπτικός ADJ;DAT(SG;FEM)	θρεπτικῇ	θρεπτῐκῇ
Generate the inflected form for: θρεπτικός ADJ;DAT(SG;MASC)	θρεπτικῷ	θρεπτῐκῷ
Generate the inflected form for: θρεπτικός ADJ;GEN(DU;NEUT)	θρεπτικοῖν	θρεπτῐκοῖν
Generate the inflected form for: θρεπτικός ADJ;GEN(PL;MASC)	θρεπτικῶν	θρεπτῐκῶν
Generate the inflected form for: θρεπτικός ADJ;GEN(PL;NEUT)	θρεπτικῶν	θρεπτῐκῶν
Generate the inflected form for: θρεπτικός ADJ;GEN(SG;MASC)	θρεπτικοῦ	θρεπτῐκοῦ
Generate the inflected form for: θρεπτικός ADJ;GEN(SG;NEUT)	θρεπτικοῦ	θρεπτῐκοῦ
Generate the inflected form for: θρεπτικός ADJ;NOM(DU;MASC)	θρεπτικώ	θρεπτῐκώ
Generate the inflected form for: θρεπτικός ADJ;NOM(DU;NEUT)	θρεπτικώ	θρεπτῐκώ
Generate the inflected form for: θρεπτικός ADJ;NOM(PL;MASC)	θρεπτικοί	θρεπτῐκοί
Generate the inflected form for: θρεπτικός ADJ;NOM(SG;NEUT)	θρεπτικόν	θρεπτῐκόν
Generate the inflected form for: θρεπτικός ADJ;VOC(DU;FEM)	θρεπτικᾱ́	θρεπτῐκᾱ́
Generate the inflected form for: θρεπτικός ADJ;VOC(DU;MASC)	θρεπτικώ	θρεπτῐκώ
Generate the inflected form for: θρεπτικός ADJ;VOC(DU;NEUT)	θρεπτικώ	θρεπτῐκώ
Generate the inflected form for: θρεπτικός ADJ;VOC(PL;FEM)	θρεπτικαί	θρεπτῐκαί
Generate the inflected form for: θρεπτικός ADJ;VOC(PL;MASC)	θρεπτικοί	θρεπτῐκοί
Generate the inflected form for: θρεπτικός ADJ;VOC(PL;NEUT)	θρεπτικᾰ́	θρεπτῐκᾰ́
Generate the inflected form for: θρεπτικός ADJ;VOC(SG;FEM)	θρεπτική	θρεπτῐκή
Generate the inflected form for: θρεπτικός ADJ;VOC(SG;MASC)	θρεπτικέ	θρεπτῐκέ
Generate the inflected form for: θρεπτικός ADJ;VOC(SG;NEUT)	θρεπτικόν	θρεπτῐκόν
Generate the inflected form for: θυγάτηρ N;ACC(DU)	θῠγᾰ́τηρ	θῠγᾰ́τερε
Generate the inflected form for: θυγάτηρ N;ACC(PL)	θῠγᾰ́τηρᾰς	θῠγᾰτέρᾰς
Generate the inflected form for: θυγάτηρ N;ACC(SG)	θῠγᾰ́τηρν	θῠ́γᾰτρᾰ
Generate the inflected form for: θυγάτηρ N;DAT(DU)	θῠγᾰτᾰ́ροιν	θῠγᾰτέροιν
Generate the inflected form for: θυγάτηρ N;DAT(PL)	θῠγᾰ́τηρσῐ(ν)	θῠγᾰτρᾰ́σῐ(ν)
Generate the inflected form for: θυγάτηρ N;DAT(SG)	θῠγᾰ́τηρῐ	θῠγᾰτρί
Generate the inflected form for: θυγάτηρ N;GEN(DU)	θῠγᾰτᾰ́τηροιν	θῠγᾰτέροιν
Generate the inflected form for: θυγάτηρ N;GEN(PL)	θῠγᾰτᾰ́των	θῠγᾰτρῶν
Generate the inflected form for: θυγάτηρ N;GEN(SG)	θῠγᾰ́τηρς	θῠγᾰτρός
Generate the inflected form for: θυγάτηρ N;NOM(DU)	θῠγᾰ́τηρ	θῠγᾰ́τερε
Generate the inflected form for: θυγάτηρ N;NOM(PL)	θῠγᾰ́τηρες	θῠ́γᾰτρες
Generate the inflected form for: θυγάτηρ N;NOM(SG)	θῠγᾰ́τηρ	θῠγᾰ́τηρ
Generate the inflected form for: θυγάτηρ N;VOC(DU)	θῠγᾰ́τηρ	θῠγᾰ́τερε
Generate the inflected form for: θυγάτηρ N;VOC(PL)	θῠγᾰ́τηρες	θῠ́γᾰτρες
Generate the inflected form for: θυγάτηρ N;VOC(SG)	θῠγᾰ́τηρ	θῠ́γᾰτερ
Generate the inflected form for: καδμία N;ACC(DU)	κᾰδμῐ́ᾱ	κᾰδμῐ́ᾱ
Generate the inflected form for: καδμία N;ACC(PL)	κᾰδμῐ́ᾱς	κᾰδμῐ́ᾱς
Generate the inflected form for: καδμία N;ACC(SG)	κᾰδμῐ́ᾱν	κᾰδμῐ́ᾱν
Generate the inflected form for: καδμία N;DAT(DU)	κᾰδμῐ́αιν	κᾰδμῐ́αιν
Generate the inflected form for: καδμία N;DAT(PL)	κᾰδμῐ́αις	κᾰδμῐ́αις
Generate the inflected form for: καδμία N;DAT(SG)	κᾰδμῐ́ᾳ	κᾰδμῐ́ᾳ
Generate the inflected form for: καδμία N;GEN(DU)	κᾰδμῐ́αιν	κᾰδμῐ́αιν
Generate the inflected form for: καδμία N;GEN(PL)	κᾰδμῐ́ᾱς	κᾰδμῐῶν
Generate the inflected form for: καδμία N;GEN(SG)	κᾰδμῐ́ᾱς	κᾰδμῐ́ᾱς
Generate the inflected form for: καδμία N;NOM(DU)	κᾰδμῐ́ᾱ	κᾰδμῐ́ᾱ
Generate the inflected form for: καδμία N;NOM(PL)	κᾰδμῐ́αι	κᾰδμῐ́αι
Generate the inflected form for: καδμία N;NOM(SG)	κᾰδμῐ́ᾱ	κᾰδμῐ́ᾱ
Generate the inflected form for: καδμία N;VOC(DU)	κᾰδμῐ́ᾱ	κᾰδμῐ́ᾱ
Generate the inflected form for: καδμία N;VOC(PL)	κᾰδμῐ́αι	κᾰδμῐ́αι
Generate the inflected form for: καδμία N;VOC(SG)	κᾰδμῐ́ᾱ	κᾰδμῐ́ᾱ
Generate the inflected form for: κενταύριον N;ACC(DU)	κενταυρίω	ουω
Generate the inflected form for: κενταύριον N;ACC(PL)	κενταύριᾰ	κενταύρῐονᾰ
Generate the inflected form for: κενταύριον N;ACC(SG)	κενταύριον	κενταύρῐονον
Generate the inflected form for: κενταύριον N;DAT(DU)	κενταυρίοιν	ουοιν
Generate the inflected form for: κενταύριον N;DAT(PL)	κενταυρίοις	ουοις
Generate the inflected form for: κενταύριον N;DAT(SG)	κενταυρίῳ	ουῳ
Generate the inflected form for: κενταύριον N;GEN(DU)	κενταυρίοιν	ουοιν
Generate the inflected form for: κενταύριον N;GEN(PL)	κενταυρίων	ουων
Generate the inflected form for: κενταύριον N;GEN(SG)	κενταυρίου	ουου
Generate the inflected form for: κενταύριον N;NOM(DU)	κενταυρίω	ουω
Generate the inflected form for: κενταύριον N;NOM(PL)	κενταύριοι	κενταύρῐονᾰ
Generate the inflected form for: κενταύριον N;NOM(SG)	κενταύριον	κενταύρῐονον
Generate the inflected form for: κενταύριον N;VOC(DU)	κενταυρίω	ουω
Generate the inflected form for: κενταύριον N;VOC(PL)	κενταύριοι	κενταύρῐονᾰ
Generate the inflected form for: κενταύριον N;VOC(SG)	κενταύριον	κενταύρῐονον
Generate the inflected form for: κενός ADJ;ACC(DU;FEM)	κενᾱ́	κενᾱ́
Generate the inflected form for: κενός ADJ;ACC(DU;MASC)	κενώ	κενώ
Generate the inflected form for: κενός ADJ;ACC(DU;NEUT)	κενώ	κενώ
Generate the inflected form for: κενός ADJ;ACC(PL;FEM)	κενᾱ́ς	κενᾱ́ς
Generate the inflected form for: κενός ADJ;ACC(PL;MASC)	κενούς	κενούς
Generate the inflected form for: κενός ADJ;ACC(PL;NEUT)	κενᾰ́	κενᾰ́
Generate the inflected form for: κενός ADJ;ACC(SG;FEM)	κενήν	κενήν
Generate the inflected form for: κενός ADJ;ACC(SG;MASC)	κενόν	κενόν
Generate the inflected form for: κενός ADJ;ACC(SG;NEUT)	κενόν	κενόν
Generate the inflected form for: κενός ADJ;DAT(DU;FEM)	κεναῖν	κεναῖν
Generate the inflected form for: κενός ADJ;DAT(DU;MASC)	κενοῖν	κενοῖν
Generate the inflected form for: κενός ADJ;DAT(PL;FEM)	κεναῖς	κεναῖς
Generate the inflected form for: κενός ADJ;DAT(PL;MASC)	κενοῖς	κενοῖς
Generate the inflected form for: κενός ADJ;DAT(PL;NEUT)	κενοῖς	κενοῖς
Generate the inflected form for: κενός ADJ;DAT(SG;MASC)	κενῷ	κενῷ
Generate the inflected form for: κενός ADJ;DAT(SG;NEUT)	κενῷ	κενῷ
Generate the inflected form for: κενός ADJ;GEN(DU;FEM)	κεναῖν	κεναῖν
Generate the inflected form for: κενός ADJ;GEN(PL;FEM)	κενῶν	κενῶν
Generate the inflected form for: κενός ADJ;GEN(PL;MASC)	κενῶν	κενῶν
Generate the inflected form for: κενός ADJ;GEN(SG;NEUT)	κενοῦ	κενοῦ
Generate the inflected form for: κενός ADJ;NOM(DU;FEM)	κενᾱ́	κενᾱ́
Generate the inflected form for: κενός ADJ;NOM(DU;MASC)	κενώ	κενώ
Generate the inflected form for: κενός ADJ;NOM(PL;NEUT)	κενᾰ́	κενᾰ́
Generate the inflected form for: κενός ADJ;NOM(SG;FEM)	κενή	κενή
Generate the inflected form for: κενός ADJ;NOM(SG;MASC)	κενός	κενός
Generate the inflected form for: κενός ADJ;NOM(SG;NEUT)	κενόν	κενόν
Generate the inflected form for: κενός ADJ;VOC(DU;FEM)	κενᾱ́	κενᾱ́
Generate the inflected form for: κενός ADJ;VOC(DU;MASC)	κενώ	κενώ
Generate the inflected form for: κενός ADJ;VOC(DU;NEUT)	κενώ	κενώ
Generate the inflected form for: κενός ADJ;VOC(PL;MASC)	κενοί	κενοί
Generate the inflected form for: κενός ADJ;VOC(PL;NEUT)	κενᾰ́	κενᾰ́
Generate the inflected form for: κενός ADJ;VOC(SG;FEM)	κενή	κενή
Generate the inflected form for: κενός ADJ;VOC(SG;MASC)	κενέ	κενέ
Generate the inflected form for: κωλόβαθρον N;ACC(DU)	κωλοβᾰ́θρω	κωλοβᾰ́θρω
Generate the inflected form for: κωλόβαθρον N;ACC(PL)	κωλοβᾰ́θρᾰ	κωλόβᾰθρᾰ
Generate the inflected form for: κωλόβαθρον N;ACC(SG)	κωλόβαθρον	κωλόβᾰθρον
Generate the inflected form for: κωλόβαθρον N;DAT(DU)	κωλοβᾰ́θροιν	κωλοβᾰ́θροιν
Generate the inflected form for: κωλόβαθρον N;DAT(PL)	κωλοβᾰ́θροις	κωλοβᾰ́θροις
Generate the inflected form for: κωλόβαθρον N;DAT(SG)	κωλοβᾰ́θρῳ	κωλοβᾰ́θρῳ
Generate the inflected form for: κωλόβαθρον N;GEN(DU)	κωλοβᾰ́θροιν	κωλοβᾰ́θροιν
Generate the inflected form for: κωλόβαθρον N;GEN(PL)	κωλοβᾰ́θρων	κωλοβᾰ́θρων
Generate the inflected form for: κωλόβαθρον N;GEN(SG)	κωλοβᾰ́θρου	κωλοβᾰ́θρου
Generate the inflected form for: κωλόβαθρον N;NOM(DU)	κωλοβᾰ́θρω	κωλοβᾰ́θρω
Generate the inflected form for: κωλόβαθρον N;NOM(PL)	κωλόβαθροι	κωλόβᾰθρᾰ
Generate the inflected form for: κωλόβαθρον N;NOM(SG)	κωλόβαθρον	κωλόβᾰθρον
Generate the inflected form for: κωλόβαθρον N;VOC(DU)	κωλοβᾰ́θρω	κωλοβᾰ́θρω
Generate the inflected form for: κωλόβαθρον N;VOC(PL)	κωλόβᾰθροι	κωλόβᾰθρᾰ
Generate the inflected form for: κωλόβαθρον N;VOC(SG)	κωλόβαθρε	κωλόβᾰθρον
Generate the inflected form for: λειμώνιον N;ACC(DU)	λειμωνῐ́ω	λειμωνῐ́ω
Generate the inflected form for: λειμώνιον N;ACC(PL)	λειμώνῐᾰ	λειμώνῐᾰ
Generate the inflected form for: λειμώνιον N;ACC(SG)	λειμώνῐον	λειμώνῐον
Generate the inflected form for: λειμώνιον N;DAT(DU)	λειμωνῐ́οιν	λειμωνῐ́οιν
Generate the inflected form for: λειμώνιον N;DAT(PL)	λειμωνῐ́οις	λειμωνῐ́οις
Generate the inflected form for: λειμώνιον N;DAT(SG)	λειμώνῐῳ	λειμωνῐ́ῳ
Generate the inflected form for: λειμώνιον N;GEN(DU)	λειμωνῐ́οιν	λειμωνῐ́οιν
Generate the inflected form for: λειμώνιον N;GEN(PL)	λειμωνῐ́ων	λειμωνῐ́ων
Generate the inflected form for: λειμώνιον N;GEN(SG)	λειμωνῐ́ου	λειμωνῐ́ου
Generate the inflected form for: λειμώνιον N;NOM(DU)	λειμωνῐ́ω	λειμωνῐ́ω
Generate the inflected form for: λειμώνιον N;NOM(PL)	λειμώνῐοι	λειμώνῐᾰ
Generate the inflected form for: λειμώνιον N;NOM(SG)	λειμώνῐον	λειμώνῐον
Generate the inflected form for: λειμώνιον N;VOC(DU)	λειμωνῐ́ω	λειμωνῐ́ω
Generate the inflected form for: λειμώνιον N;VOC(PL)	λειμώνῐοι	λειμώνῐᾰ
Generate the inflected form for: λειμώνιον N;VOC(SG)	λειμώνῐον	λειμώνῐον
Generate the inflected form for: μελῳδία N;ACC(DU)	μελγδῐ́ᾱ	μελῳδῐ́ᾱ
Generate the inflected form for: μελῳδία N;ACC(PL)	μελῳδῐ́ᾱς	μελῳδῐ́ᾱς
Generate the inflected form for: μελῳδία N;ACC(SG)	μελῳδῐ́ᾱν	μελῳδῐ́ᾱν
Generate the inflected form for: μελῳδία N;DAT(DU)	μελγδῐ́αιν	μελῳδῐ́αιν
Generate the inflected form for: μελῳδία N;DAT(PL)	μελγδῐ́αις	μελῳδῐ́αις
Generate the inflected form for: μελῳδία N;DAT(SG)	μελγδῐῇ	μελῳδῐ́ᾳ
Generate the inflected form for: μελῳδία N;GEN(DU)	μελγδῐ́αιν	μελῳδῐ́αιν
Generate the inflected form for: μελῳδία N;GEN(PL)	μελγδῐῶν	μελῳδῐῶν
Generate the inflected form for: μελῳδία N;GEN(SG)	μελγδῐ́ᾱς	μελῳδῐ́ᾱς
Generate the inflected form for: μελῳδία N;NOM(DU)	μελγδῐ́ᾱ	μελῳδῐ́ᾱ
Generate the inflected form for: μελῳδία N;NOM(PL)	μελῳδῐ́αι	μελῳδῐ́αι
Generate the inflected form for: μελῳδία N;NOM(SG)	μελῳδῐ́ᾱ	μελῳδῐ́ᾱ
Generate the inflected form for: μελῳδία N;VOC(DU)	μελγδῐ́ᾱ	μελῳδῐ́ᾱ
Generate the inflected form for: μελῳδία N;VOC(PL)	μελῳδῐ́αι	μελῳδῐ́αι
Generate the inflected form for: μελῳδία N;VOC(SG)	μελῳδῐ́ᾱ	μελῳδῐ́ᾱ
Generate the inflected form for: οἶνος N;ACC(DU)	οἶνω	οἴνω
Generate the inflected form for: οἶνος N;ACC(PL)	οἶνους	οἴνους
Generate the inflected form for: οἶνος N;ACC(SG)	οἶνον	οἶνον
Generate the inflected form for: οἶνος N;DAT(DU)	οἶνοιν	οἴνοιν
Generate the inflected form for: οἶνος N;DAT(PL)	οἶνοις	οἴνοις
Generate the inflected form for: οἶνος N;DAT(SG)	οἶνῳ	οἴνῳ
Generate the inflected form for: οἶνος N;GEN(DU)	οἶνοιν	οἴνοιν
Generate the inflected form for: οἶνος N;GEN(PL)	οἶνων	οἴνων
Generate the inflected form for: οἶνος N;GEN(SG)	οἶνου	οἴνου
Generate the inflected form for: οἶνος N;NOM(DU)	οἶνω	οἴνω
Generate the inflected form for: οἶνος N;NOM(PL)	οἶνοι	οἶνοι
Generate the inflected form for: οἶνος N;NOM(SG)	οἶνος	οἶνος
Generate the inflected form for: οἶνος N;VOC(DU)	οἶνω	οἴνω
Generate the inflected form for: οἶνος N;VOC(PL)	οἶνοι	οἶνοι
Generate the inflected form for: οἶνος N;VOC(SG)	οἶνε	οἶνε
Generate the inflected form for: παλίμψηστος ADJ;ACC(DU;FEM)	παλιμψήστω	παλιμψήστω
Generate the inflected form for: παλίμψηστος ADJ;ACC(DU;NEUT)	παλιμψήστω	παλιμψήστω
Generate the inflected form for: παλίμψηστος ADJ;ACC(PL;MASC)	παλιμψήστους	παλιμψήστους
Generate the inflected form for: παλίμψηστος ADJ;ACC(SG;FEM)	παλίμψηστον	παλίμψηστον
Generate the inflected form for: παλίμψηστος ADJ;ACC(SG;MASC)	παλίμψηστον	παλίμψηστον
Generate the inflected form for: παλίμψηστος ADJ;ACC(SG;NEUT)	παλίμψηστον	παλίμψηστον
Generate the inflected form for: παλίμψηστος ADJ;DAT(DU;FEM)	παλιμψήστοιν	παλιμψήστοιν
Generate the inflected form for: παλίμψηστος ADJ;DAT(DU;MASC)	παλιμψήστοιν	παλιμψήστοιν
Generate the inflected form for: παλίμψηστος ADJ;DAT(DU;NEUT)	παλιμψήστοιν	παλιμψήστοιν
Generate the inflected form for: παλίμψηστος ADJ;DAT(PL;MASC)	παλιμψήστοις	παλιμψήστοις
Generate the inflected form for: παλίμψηστος ADJ;DAT(PL;NEUT)	παλιμψήστοις	παλιμψήστοις
Generate the inflected form for: παλίμψηστος ADJ;DAT(SG;MASC)	παλιμψήστῳ	παλιμψήστῳ
Generate the inflected form for: παλίμψηστος ADJ;GEN(DU;FEM)	παλιμψήστοιν	παλιμψήστοιν
Generate the inflected form for: παλίμψηστος ADJ;GEN(DU;MASC)	παλιμψήστοιν	παλιμψήστοιν
Generate the inflected form for: παλίμψηστος ADJ;GEN(DU;NEUT)	παλιμψήστοιν	παλιμψήστοιν
Generate the inflected form for: παλίμψηστος ADJ;GEN(PL;FEM)	παλιμψήστων	παλιμψήστων
Generate the inflected form for: παλίμψηστος ADJ;GEN(PL;MASC)	παλιμψήστων	παλιμψήστων
Generate the inflected form for: παλίμψηστος ADJ;GEN(PL;NEUT)	παλιμψήστων	παλιμψήστων
Generate the inflected form for: παλίμψηστος ADJ;GEN(SG;FEM)	παλιμψήστου	παλιμψήστου
Generate the inflected form for: παλίμψηστος ADJ;GEN(SG;MASC)	παλιμψήστου	παλιμψήστου
Generate the inflected form for: παλίμψηστος ADJ;GEN(SG;NEUT)	παλιμψήστου	παλιμψήστου
Generate the inflected form for: παλίμψηστος ADJ;NOM(DU;NEUT)	παλιμψήστω	παλιμψήστω
Generate the inflected form for: παλίμψηστος ADJ;NOM(PL;FEM)	παλίμψηστοι	παλίμψηστοι
Generate the inflected form for: παλίμψηστος ADJ;NOM(PL;MASC)	παλίμψηστοι	παλίμψηστοι
Generate the inflected form for: παλίμψηστος ADJ;NOM(PL;NEUT)	παλίμψηστα	παλίμψηστα
Generate the inflected form for: παλίμψηστος ADJ;VOC(DU;FEM)	παλιμψήστω	παλιμψήστω
Generate the inflected form for: παλίμψηστος ADJ;VOC(DU;MASC)	παλιμψήστω	παλιμψήστω
Generate the inflected form for: παλίμψηστος ADJ;VOC(DU;NEUT)	παλιμψήστω	παλιμψήστω
Generate the inflected form for: παλίμψηστος ADJ;VOC(PL;MASC)	παλίμψηστοι	παλίμψηστοι
Generate the inflected form for: παλίμψηστος ADJ;VOC(PL;NEUT)	παλίμψηστα	παλίμψηστα
Generate the inflected form for: παλίμψηστος ADJ;VOC(SG;FEM)	παλίμψηστε	παλίμψηστε
Generate the inflected form for: παλίμψηστος ADJ;VOC(SG;MASC)	παλίμψηστε	παλίμψηστε
Generate the inflected form for: παλίμψηστος ADJ;VOC(SG;NEUT)	παλίμψηστον	παλίμψηστον
Generate the inflected form for: παραλυτικός ADJ;ACC(DU;FEM)	παραλυτικᾱ́	παραλυτικᾱ́
Generate the inflected form for: παραλυτικός ADJ;ACC(DU;MASC)	παραλυτικώ	παραλυτικώ
Generate the inflected form for: παραλυτικός ADJ;ACC(DU;NEUT)	παραλυτικώ	παραλυτικώ
Generate the inflected form for: παραλυτικός ADJ;ACC(PL;FEM)	παραλυτικᾱ́ς	παραλυτικᾱ́ς
Generate the inflected form for: παραλυτικός ADJ;ACC(PL;MASC)	παραλυτικούς	παραλυτικούς
Generate the inflected form for: παραλυτικός ADJ;ACC(PL;NEUT)	παραλυτικᾰ́	παραλυτικᾰ́
Generate the inflected form for: παραλυτικός ADJ;ACC(SG;FEM)	παραλυτικήν	παραλυτικήν
Generate the inflected form for: παραλυτικός ADJ;ACC(SG;MASC)	παραλυτικόν	παραλυτικόν
Generate the inflected form for: παραλυτικός ADJ;ACC(SG;NEUT)	παραλυτικόν	παραλυτικόν
Generate the inflected form for: παραλυτικός ADJ;DAT(DU;FEM)	παραλυτικαῖν	παραλυτικαῖν
Generate the inflected form for: παραλυτικός ADJ;DAT(DU;MASC)	παραλυτικοῖν	παραλυτικοῖν
Generate the inflected form for: παραλυτικός ADJ;DAT(DU;NEUT)	παραλυτικοῖν	παραλυτικοῖν
Generate the inflected form for: παραλυτικός ADJ;DAT(PL;FEM)	παραλυτικαῖς	παραλυτικαῖς
Generate the inflected form for: παραλυτικός ADJ;DAT(PL;MASC)	παραλυτικοῖς	παραλυτικοῖς
Generate the inflected form for: παραλυτικός ADJ;DAT(PL;NEUT)	παραλυτικοῖς	παραλυτικοῖς
Generate the inflected form for: παραλυτικός ADJ;DAT(SG;FEM)	παραλυτικῇ	παραλυτικῇ
Generate the inflected form for: παραλυτικός ADJ;DAT(SG;MASC)	παραλυτικῷ	παραλυτικῷ
Generate the inflected form for: παραλυτικός ADJ;GEN(DU;FEM)	παραλυτικαῖν	παραλυτικαῖν
Generate the inflected form for: παραλυτικός ADJ;GEN(PL;MASC)	παραλυτικῶν	παραλυτικῶν
Generate the inflected form for: παραλυτικός ADJ;GEN(PL;NEUT)	παραλυτικῶν	παραλυτικῶν
Generate the inflected form for: παραλυτικός ADJ;GEN(SG;FEM)	παραλυτικῆς	παραλυτικῆς
Generate the inflected form for: παραλυτικός ADJ;GEN(SG;MASC)	παραλυτικοῦ	παραλυτικοῦ
Generate the inflected form for: παραλυτικός ADJ;GEN(SG;NEUT)	παραλυτικοῦ	παραλυτικοῦ
Generate the inflected form for: παραλυτικός ADJ;NOM(DU;FEM)	παραλυτικᾱ́	παραλυτικᾱ́
Generate the inflected form for: παραλυτικός ADJ;NOM(DU;MASC)	παραλυτικώ	παραλυτικώ
Generate the inflected form for: παραλυτικός ADJ;NOM(DU;NEUT)	παραλυτικώ	παραλυτικώ
Generate the inflected form for: παραλυτικός ADJ;NOM(PL;FEM)	παραλυτικαί	παραλυτικαί
Generate the inflected form for: παραλυτικός ADJ;NOM(SG;FEM)	παραλυτική	παραλυτική
Generate the inflected form for: παραλυτικός ADJ;VOC(PL;FEM)	παραλυτικαί	παραλυτικαί
Generate the inflected form for: παραλυτικός ADJ;VOC(PL;MASC)	παραλυτικοί	παραλυτικοί
Generate the inflected form for: παραλυτικός ADJ;VOC(PL;NEUT)	παραλυτικᾰ́	παραλυτικᾰ́
Generate the inflected form for: παραλυτικός ADJ;VOC(SG;FEM)	παραλυτική	παραλυτική
Generate the inflected form for: παραλυτικός ADJ;VOC(SG;MASC)	παραλυτικέ	παραλυτικέ
Generate the inflected form for: ποτήριον N;ACC(DU)	ποτηρῐ́ω	ποτηρίω
Generate the inflected form for: ποτήριον N;ACC(PL)	ποτήρῐᾰ	ποτήριᾰ
Generate the inflected form for: ποτήριον N;ACC(SG)	ποτήρῐον	ποτήριον
Generate the inflected form for: ποτήριον N;DAT(DU)	ποτηρῐ́οιν	ποτηρίοιν
Generate the inflected form for: ποτήριον N;DAT(PL)	ποτηρῐ́οις	ποτηρίοις
Generate the inflected form for: ποτήριον N;DAT(SG)	ποτηρῐ́ῳ	ποτηρίῳ
Generate the inflected form for: ποτήριον N;GEN(DU)	ποτηρῐ́οιν	ποτηρίοιν
Generate the inflected form for: ποτήριον N;GEN(PL)	ποτηρῐ́ων	ποτηρίων
Generate the inflected form for: ποτήριον N;GEN(SG)	ποτηρῐ́ου	ποτηρίου
Generate the inflected form for: ποτήριον N;NOM(DU)	ποτηρῐ́ω	ποτηρίω
Generate the inflected form for: ποτήριον N;NOM(PL)	ποτήρῐοι	ποτήριᾰ
Generate the inflected form for: ποτήριον N;NOM(SG)	ποτήρῐον	ποτήριον
Generate the inflected form for: ποτήριον N;VOC(DU)	ποτηρῐ́ω	ποτηρίω
Generate the inflected form for: ποτήριον N;VOC(PL)	ποτήρῐοι	ποτήριᾰ
Generate the inflected form for: ποτήριον N;VOC(SG)	ποτήρῐε	ποτήριον
Generate the inflected form for: πτέρνη N;ACC(DU)	πτέρνᾱ	πτέρνᾱ
Generate the inflected form for: πτέρνη N;ACC(PL)	πτέρνᾱς	πτέρνᾱς
Generate the inflected form for: πτέρνη N;ACC(SG)	πτέρνην	πτέρνην
Generate the inflected form for: πτέρνη N;DAT(DU)	πτέρναιν	πτέρναιν
Generate the inflected form for: πτέρνη N;DAT(PL)	πτέρναις	πτέρναις
Generate the inflected form for: πτέρνη N;DAT(SG)	πτέρνῃ	πτέρνῃ
Generate the inflected form for: πτέρνη N;GEN(DU)	πτέρναιν	πτέρναιν
Generate the inflected form for: πτέρνη N;GEN(PL)	πτέρνων	πτερνῶν
Generate the inflected form for: πτέρνη N;GEN(SG)	πτέρνης	πτέρνης
Generate the inflected form for: πτέρνη N;NOM(DU)	πτέρνᾱ	πτέρνᾱ
Generate the inflected form for: πτέρνη N;NOM(PL)	πτέρναι	πτέρναι
Generate the inflected form for: πτέρνη N;NOM(SG)	πτέρνη	πτέρνη
Generate the inflected form for: πτέρνη N;VOC(DU)	πτέρνᾱ	πτέρνᾱ
Generate the inflected form for: πτέρνη N;VOC(PL)	πτέρναι	πτέρναι
Generate the inflected form for: πτέρνη N;VOC(SG)	πτέρνη	πτέρνη
Generate the inflected form for: πῆγμα N;ACC(DU)	πήγμᾰτε	πήγμᾰτε
Generate the inflected form for: πῆγμα N;ACC(PL)	πώγμᾰτᾰ	πήγμᾰτᾰ
Generate the inflected form for: πῆγμα N;ACC(SG)	πῆγμᾰτᾰ	πῆγμᾰ
Generate the inflected form for: πῆγμα N;DAT(DU)	πήγματοιν	πηγμᾰ́τοιν
Generate the inflected form for: πῆγμα N;DAT(PL)	πήγμασῐ(ν)	πήγμᾰσῐ
Generate the inflected form for: πῆγμα N;DAT(SG)	πώγμᾰτῐ	πήγμᾰτῐ
Generate the inflected form for: πῆγμα N;GEN(DU)	πήγμᾰτοιν	πηγμᾰ́τοιν
Generate the inflected form for: πῆγμα N;GEN(PL)	πήγμᾰτων	πηγμᾰ́των
Generate the inflected form for: πῆγμα N;GEN(SG)	πώγμᾰτος	πήγμᾰτος
Generate the inflected form for: πῆγμα N;NOM(DU)	πώγμᾰτε	πήγμᾰτε
Generate the inflected form for: πῆγμα N;NOM(PL)	πῆγμᾰτᾰ	πήγμᾰτᾰ
Generate the inflected form for: πῆγμα N;NOM(SG)	πῆγμᾰ	πῆγμᾰ
Generate the inflected form for: πῆγμα N;VOC(DU)	πώγμᾰτε	πήγμᾰτε
Generate the inflected form for: πῆγμα N;VOC(PL)	πῆγμᾰτᾰ	πήγμᾰτᾰ
Generate the inflected form for: πῆγμα N;VOC(SG)	πῆγμᾰ	πῆγμᾰ
Generate the inflected form for: σίραιον N;ACC(DU)	σῐρᾰ́ᾱ	σιραίω
Generate the inflected form for: σίραιον N;ACC(PL)	σῐρᾰ́ᾰ	σίραιᾰ
Generate the inflected form for: σίραιον N;ACC(SG)	σῐρᾰ́ον	σίραιον
Generate the inflected form for: σίραιον N;DAT(DU)	σῐραίοιν	σιραίοιν
Generate the inflected form for: σίραιον N;DAT(PL)	σῐρᾰ́οις	σιραίοις
Generate the inflected form for: σίραιον N;DAT(SG)	σῐρᾰ́ῳ	σιραίῳ
Generate the inflected form for: σίραιον N;GEN(DU)	σῐραίοιν	σιραίοιν
Generate the inflected form for: σίραιον N;GEN(PL)	σῐραίων	σιραίων
Generate the inflected form for: σίραιον N;GEN(SG)	σῐρᾰ́ου	σιραίου
Generate the inflected form for: σίραιον N;NOM(DU)	σῐρᾰ́ω	σιραίω
Generate the inflected form for: σίραιον N;NOM(PL)	σῐ́ρᾰιοι	σίραιᾰ
Generate the inflected form for: σίραιον N;NOM(SG)	σῐ́ραιον	σίραιον
Generate the inflected form for: σίραιον N;VOC(DU)	σῐρᾰ́ᾱ	σιραίω
Generate the inflected form for: σίραιον N;VOC(PL)	σῐ́ρᾰιοι	σίραιᾰ
Generate the inflected form for: σίραιον N;VOC(SG)	σῐ́ρᾱιον	σίραιον
Generate the inflected form for: σκέπη N;ACC(DU)	σκέπᾱ	σκέπᾱ
Generate the inflected form for: σκέπη N;ACC(PL)	σκέπᾱς	σκέπᾱς
Generate the inflected form for: σκέπη N;ACC(SG)	σκέπην	σκέπην
Generate the inflected form for: σκέπη N;DAT(DU)	σκεπαῖν	σκέπαιν
Generate the inflected form for: σκέπη N;DAT(PL)	σκέπαις	σκέπαις
Generate the inflected form for: σκέπη N;DAT(SG)	σκέπῃ	σκέπῃ
Generate the inflected form for: σκέπη N;GEN(DU)	σκεπαῖν	σκέπαιν
Generate the inflected form for: σκέπη N;GEN(PL)	σκεπῶν	σκεπῶν
Generate the inflected form for: σκέπη N;GEN(SG)	σκέπης	σκέπης
Generate the inflected form for: σκέπη N;NOM(DU)	σκέπᾱ	σκέπᾱ
Generate the inflected form for: σκέπη N;NOM(PL)	σκέπαι	σκέπαι
Generate the inflected form for: σκέπη N;NOM(SG)	σκέπη	σκέπη
Generate the inflected form for: σκέπη N;VOC(DU)	σκέπᾱ	σκέπᾱ
Generate the inflected form for: σκέπη N;VOC(PL)	σκέπαι	σκέπαι
Generate the inflected form for: σκέπη N;VOC(SG)	σκέπη	σκέπη
Generate the inflected form for: σχόλιον N;ACC(DU)	σχολίω	σχολίω
Generate the inflected form for: σχόλιον N;ACC(PL)	σχόλιᾰ	σχόλιᾰ
Generate the inflected form for: σχόλιον N;ACC(SG)	σχόλιον	σχόλιον
Generate the inflected form for: σχόλιον N;DAT(DU)	σχολίοιν	σχολίοιν
Generate the inflected form for: σχόλιον N;DAT(PL)	σχολίοις	σχολίοις
Generate the inflected form for: σχόλιον N;DAT(SG)	σχολίῳ	σχολίῳ
Generate the inflected form for: σχόλιον N;GEN(DU)	σχολίοιν	σχολίοιν
Generate the inflected form for: σχόλιον N;GEN(PL)	σχολίων	σχολίων
Generate the inflected form for: σχόλιον N;GEN(SG)	σχολίου	σχολίου
Generate the inflected form for: σχόλιον N;NOM(DU)	σχολίω	σχολίω
Generate the inflected form for: σχόλιον N;NOM(PL)	σχόλιοι	σχόλιᾰ
Generate the inflected form for: σχόλιον N;NOM(SG)	σχόλιον	σχόλιον
Generate the inflected form for: σχόλιον N;VOC(DU)	σχολίω	σχολίω
Generate the inflected form for: σχόλιον N;VOC(PL)	σχόλῐοι	σχόλιᾰ
Generate the inflected form for: σχόλιον N;VOC(SG)	σχόλῐον	σχόλιον
Generate the inflected form for: τακτικός ADJ;ACC(DU;FEM)	τακτικᾱ́	τακτικᾱ́
Generate the inflected form for: τακτικός ADJ;ACC(DU;NEUT)	τακτικώ	τακτικώ
Generate the inflected form for: τακτικός ADJ;ACC(PL;FEM)	τακτικᾱ́ς	τακτικᾱ́ς
Generate the inflected form for: τακτικός ADJ;ACC(SG;FEM)	τακτικήν	τακτικήν
Generate the inflected form for: τακτικός ADJ;ACC(SG;MASC)	τακτικόν	τακτικόν
Generate the inflected form for: τακτικός ADJ;ACC(SG;NEUT)	τακτικόν	τακτικόν
Generate the inflected form for: τακτικός ADJ;DAT(DU;FEM)	τακτικαῖν	τακτικαῖν
Generate the inflected form for: τακτικός ADJ;DAT(DU;MASC)	τακτικοῖν	τακτικοῖν
Generate the inflected form for: τακτικός ADJ;DAT(DU;NEUT)	τακτικοῖν	τακτικοῖν
Generate the inflected form for: τακτικός ADJ;DAT(PL;FEM)	τακτικαῖς	τακτικαῖς
Generate the inflected form for: τακτικός ADJ;DAT(PL;MASC)	τακτικοῖς	τακτικοῖς
Generate the inflected form for: τακτικός ADJ;DAT(PL;NEUT)	τακτικοῖς	τακτικοῖς
Generate the inflected form for: τακτικός ADJ;DAT(SG;FEM)	τακτικῇ	τακτικῇ
Generate the inflected form for: τακτικός ADJ;DAT(SG;MASC)	τακτικῷ	τακτικῷ
Generate the inflected form for: τακτικός ADJ;GEN(DU;FEM)	τακτικαῖν	τακτικαῖν
Generate the inflected form for: τακτικός ADJ;GEN(PL;MASC)	τακτικῶν	τακτικῶν
Generate the inflected form for: τακτικός ADJ;GEN(PL;NEUT)	τακτικῶν	τακτικῶν
Generate the inflected form for: τακτικός ADJ;GEN(SG;FEM)	τακτικῆς	τακτικῆς
Generate the inflected form for: τακτικός ADJ;GEN(SG;MASC)	τακτικοῦ	τακτικοῦ
Generate the inflected form for: τακτικός ADJ;GEN(SG;NEUT)	τακτικοῦ	τακτικοῦ
Generate the inflected form for: τακτικός ADJ;NOM(DU;FEM)	τακτικᾱ́	τακτικᾱ́
Generate the inflected form for: τακτικός ADJ;NOM(DU;NEUT)	τακτικώ	τακτικώ
Generate the inflected form for: τακτικός ADJ;NOM(PL;NEUT)	τακτικᾰ́	τακτικᾰ́
Generate the inflected form for: τακτικός ADJ;NOM(SG;NEUT)	τακτικόν	τακτικόν
Generate the inflected form for: τακτικός ADJ;VOC(DU;FEM)	τακτικᾱ́	τακτικᾱ́
Generate the inflected form for: τακτικός ADJ;VOC(DU;MASC)	τακτικώ	τακτικώ
Generate the inflected form for: τακτικός ADJ;VOC(DU;NEUT)	τακτικώ	τακτικώ
Generate the inflected form for: τακτικός ADJ;VOC(PL;FEM)	τακτικαί	τακτικαί
Generate the inflected form for: τακτικός ADJ;VOC(PL;MASC)	τακτικοί	τακτικοί
Generate the inflected form for: τακτικός ADJ;VOC(PL;NEUT)	τακτικᾰ́	τακτικᾰ́
Generate the inflected form for: τακτικός ADJ;VOC(SG;FEM)	τακτική	τακτική
Generate the inflected form for: τακτικός ADJ;VOC(SG;MASC)	τακτικέ	τακτικέ
Generate the inflected form for: τακτικός ADJ;VOC(SG;NEUT)	τακτικόν	τακτικόν
Generate the inflected form for: ταπεινός ADJ;ACC(DU;FEM)	ταπεινᾱ́	ταπεινᾱ́
Generate the inflected form for: ταπεινός ADJ;ACC(DU;MASC)	ταπεινώ	ταπεινώ
Generate the inflected form for: ταπεινός ADJ;ACC(PL;MASC)	ταπεινούς	ταπεινούς
Generate the inflected form for: ταπεινός ADJ;ACC(PL;NEUT)	ταπεινᾰ́	ταπεινᾰ́
Generate the inflected form for: ταπεινός ADJ;ACC(SG;MASC)	ταπεινόν	ταπεινόν
Generate the inflected form for: ταπεινός ADJ;DAT(DU;FEM)	ταπειναῖν	ταπειναῖν
Generate the inflected form for: ταπεινός ADJ;DAT(DU;NEUT)	ταπεινοῖν	ταπεινοῖν
Generate the inflected form for: ταπεινός ADJ;DAT(PL;FEM)	ταπειναῖς	ταπειναῖς
Generate the inflected form for: ταπεινός ADJ;DAT(PL;MASC)	ταπεινοῖς	ταπεινοῖς
Generate the inflected form for: ταπεινός ADJ;DAT(SG;MASC)	ταπεινῷ	ταπεινῷ
Generate the inflected form for: ταπεινός ADJ;DAT(SG;NEUT)	ταπεινῷ	ταπεινῷ
Generate the inflected form for: ταπεινός ADJ;GEN(DU;FEM)	ταπειναῖν	ταπειναῖν
Generate the inflected form for: ταπεινός ADJ;GEN(DU;MASC)	ταπεινοῖν	ταπεινοῖν
Generate the inflected form for: ταπεινός ADJ;GEN(PL;FEM)	ταπεινῶν	ταπεινῶν
Generate the inflected form for: ταπεινός ADJ;GEN(SG;MASC)	ταπεινοῦ	ταπεινοῦ
Generate the inflected form for: ταπεινός ADJ;GEN(SG;NEUT)	ταπεινοῦ	ταπεινοῦ
Generate the inflected form for: ταπεινός ADJ;NOM(DU;FEM)	ταπεινᾱ́	ταπεινᾱ́
Generate the inflected form for: ταπεινός ADJ;NOM(DU;MASC)	ταπεινώ	ταπεινώ
Generate the inflected form for: ταπεινός ADJ;NOM(DU;NEUT)	ταπεινώ	ταπεινώ
Generate the inflected form for: ταπεινός ADJ;NOM(PL;FEM)	ταπειναί	ταπειναί
Generate the inflected form for: ταπεινός ADJ;NOM(PL;MASC)	ταπεινοί	ταπεινοί
Generate the inflected form for: ταπεινός ADJ;NOM(PL;NEUT)	ταπεινᾰ́	ταπεινᾰ́
Generate the inflected form for: ταπεινός ADJ;NOM(SG;FEM)	ταπεινή	ταπεινή
Generate the inflected form for: ταπεινός ADJ;NOM(SG;MASC)	ταπεινός	ταπεινός
Generate the inflected form for: ταπεινός ADJ;NOM(SG;NEUT)	ταπεινόν	ταπεινόν
Generate the inflected form for: ταπεινός ADJ;VOC(DU;FEM)	ταπεινᾱ́	ταπεινᾱ́
Generate the inflected form for: ταπεινός ADJ;VOC(DU;NEUT)	ταπεινώ	ταπεινώ
Generate the inflected form for: ταπεινός ADJ;VOC(PL;FEM)	ταπειναί	ταπειναί
Generate the inflected form for: ταπεινός ADJ;VOC(PL;MASC)	ταπεινοί	ταπεινοί
Generate the inflected form for: ταπεινός ADJ;VOC(PL;NEUT)	ταπεινᾰ́	ταπεινᾰ́
Generate the inflected form for: ταπεινός ADJ;VOC(SG;FEM)	ταπεινή	ταπεινή
Generate the inflected form for: ταπεινός ADJ;VOC(SG;MASC)	ταπεινέ	ταπεινέ
Generate the inflected form for: ταπεινός ADJ;VOC(SG;NEUT)	ταπεινόν	ταπεινόν
Generate the inflected form for: ἀμέλεια N;ACC(DU)	ἀμελείᾱ	ᾰ̓μελείᾱ
Generate the inflected form for: ἀμέλεια N;ACC(PL)	ἀμελείᾱς	ᾰ̓μελείᾱς
Generate the inflected form for: ἀμέλεια N;ACC(SG)	ἀμέλειᾱν	ᾰ̓μέλειᾰν
Generate the inflected form for: ἀμέλεια N;DAT(DU)	ἀμελείαιν	ᾰ̓μελείαιν
Generate the inflected form for: ἀμέλεια N;DAT(PL)	ἀμελείαις	ᾰ̓μελείαις
Generate the inflected form for: ἀμέλεια N;DAT(SG)	ἀμελείᾳ	ᾰ̓μελείᾳ
Generate the inflected form for: ἀμέλεια N;GEN(DU)	ἀμελείαιν	ᾰ̓μελείαιν
Generate the inflected form for: ἀμέλεια N;GEN(PL)	ἀμελείᾱς	ᾰ̓μελειῶν
Generate the inflected form for: ἀμέλεια N;GEN(SG)	ἀμελείας	ᾰ̓μελείᾱς
Generate the inflected form for: ἀμέλεια N;NOM(DU)	ἀμελείᾱ	ᾰ̓μελείᾱ
Generate the inflected form for: ἀμέλεια N;NOM(PL)	ἀμέλειαι	ᾰ̓μέλειαι
Generate the inflected form for: ἀμέλεια N;NOM(SG)	ἀμέλειᾱ	ᾰ̓μέλειᾰ
Generate the inflected form for: ἀμέλεια N;VOC(DU)	ἀμελείᾱ	ᾰ̓μελείᾱ
Generate the inflected form for: ἀμέλεια N;VOC(PL)	ἀμέλειαι	ᾰ̓μέλειαι
Generate the inflected form for: ἀμέλεια N;VOC(SG)	ἀμέλειᾱ	ᾰ̓μέλειᾰ
Generate the inflected form for: ἀμβλυωπία N;ACC(DU)	ἀμβλῠωπῐ́ᾱ	ᾰ̓μβλῠωπῐ́ᾱ
Generate the inflected form for: ἀμβλυωπία N;ACC(PL)	ἀμβλῠωπῐ́ᾱς	ᾰ̓μβλῠωπῐ́ᾱς
Generate the inflected form for: ἀμβλυωπία N;ACC(SG)	ἀμβλῠωπῐ́ᾱν	ᾰ̓μβλῠωπῐ́ᾱν
Generate the inflected form for: ἀμβλυωπία N;DAT(DU)	ἀμβλῠωπῐ́αιν	ᾰ̓μβλῠωπῐ́αιν
Generate the inflected form for: ἀμβλυωπία N;DAT(PL)	ἀμβλῠωπῐ́αις	ᾰ̓μβλῠωπῐ́αις
Generate the inflected form for: ἀμβλυωπία N;DAT(SG)	ἀμβλῠωπῐ́ᾳ	ᾰ̓μβλῠωπῐ́ᾳ
Generate the inflected form for: ἀμβλυωπία N;GEN(DU)	ἀμβλῠωπῐ́αιν	ᾰ̓μβλῠωπῐ́αιν
Generate the inflected form for: ἀμβλυωπία N;GEN(PL)	ἀμβλῠωπῐ́ᾱς	ᾰ̓μβλῠωπῐῶν
Generate the inflected form for: ἀμβλυωπία N;GEN(SG)	ἀμβλῠωπῐ́ᾱς	ᾰ̓μβλῠωπῐ́ᾱς
Generate the inflected form for: ἀμβλυωπία N;NOM(DU)	ἀμβλῠωπῐ́ᾱ	ᾰ̓μβλῠωπῐ́ᾱ
Generate the inflected form for: ἀμβλυωπία N;NOM(PL)	ἀμβλῠωπῐ́αι	ᾰ̓μβλῠωπῐ́αι
Generate the inflected form for: ἀμβλυωπία N;NOM(SG)	ἀμβλῠωπῐ́ᾱ	ᾰ̓μβλῠωπῐ́ᾱ
Generate the inflected form for: ἀμβλυωπία N;VOC(DU)	ἀμβλῠωπῐ́ᾱ	ᾰ̓μβλῠωπῐ́ᾱ
Generate the inflected form for: ἀμβλυωπία N;VOC(PL)	ἀμβλῠωπῐ́αι	ᾰ̓μβλῠωπῐ́αι
Generate the inflected form for: ἀμβλυωπία N;VOC(SG)	ἀμβλῠωπῐ́ᾱ	ᾰ̓μβλῠωπῐ́ᾱ
Generate the inflected form for: ἀναστροφή N;ACC(DU)	ἀναστροφᾱ́	ᾰ̓νᾰστροφᾱ́
Generate the inflected form for: ἀναστροφή N;ACC(PL)	ἀναστροφᾱ́ς	ᾰ̓νᾰστροφᾱ́ς
Generate the inflected form for: ἀναστροφή N;ACC(SG)	ἀναστροφήν	ᾰ̓νᾰστροφήν
Generate the inflected form for: ἀναστροφή N;DAT(DU)	ᾰ̓νᾰστροφαῖν	ᾰ̓νᾰστροφαῖν
Generate the inflected form for: ἀναστροφή N;DAT(PL)	ᾰ̓νᾰστροφαῖς	ᾰ̓νᾰστροφαῖς
Generate the inflected form for: ἀναστροφή N;DAT(SG)	ᾰ̓νᾰστροφῇ	ᾰ̓νᾰστροφῇ
Generate the inflected form for: ἀναστροφή N;GEN(DU)	ἀναστροφαῖν	ᾰ̓νᾰστροφαῖν
Generate the inflected form for: ἀναστροφή N;GEN(PL)	ἀναστροφῶν	ᾰ̓νᾰστροφῶν
Generate the inflected form for: ἀναστροφή N;GEN(SG)	ἀναστροφοῦ	ᾰ̓νᾰστροφῆς
Generate the inflected form for: ἀναστροφή N;NOM(DU)	ἀναστροφᾱ́	ᾰ̓νᾰστροφᾱ́
Generate the inflected form for: ἀναστροφή N;NOM(PL)	ἀναστροφαί	ᾰ̓νᾰστροφαί
Generate the inflected form for: ἀναστροφή N;NOM(SG)	ἀναστροφή	ᾰ̓νᾰστροφή
Generate the inflected form for: ἀναστροφή N;VOC(DU)	ᾰ̓νᾰστροφᾱ́	ᾰ̓νᾰστροφᾱ́
Generate the inflected form for: ἀναστροφή N;VOC(PL)	ἀναστροφαί	ᾰ̓νᾰστροφαί
Generate the inflected form for: ἀναστροφή N;VOC(SG)	ἀναστροφή	ᾰ̓νᾰστροφή
Generate the inflected form for: ἀντιστοιχία N;ACC(DU)	ἀντῐστοιχῐ́ᾱ	ἀντῐστοιχῐ́ᾱ
Generate the inflected form for: ἀντιστοιχία N;ACC(PL)	ἀντῐστοιχῐ́ᾱς	ἀντῐστοιχῐ́ᾱς
Generate the inflected form for: ἀντιστοιχία N;ACC(SG)	ἀντῐστοιχῐ́ᾱν	ἀντῐστοιχῐ́ᾱν
Generate the inflected form for: ἀντιστοιχία N;DAT(DU)	ἀντῐστοιχῐ́αιν	ἀντῐστοιχῐ́αιν
Generate the inflected form for: ἀντιστοιχία N;DAT(PL)	ἀντῐστοιχῐ́αις	ἀντῐστοιχῐ́αις
Generate the inflected form for: ἀντιστοιχία N;DAT(SG)	ἀντῐστοιχῐ́ᾳ	ἀντῐστοιχῐ́ᾳ
Generate the inflected form for: ἀντιστοιχία N;GEN(DU)	ἀντῐστοιχῐ́αιν	ἀντῐστοιχῐ́αιν
Generate the inflected form for: ἀντιστοιχία N;GEN(PL)	ἀντῐστοιχῐῶν	ἀντῐστοιχῐῶν
Generate the inflected form for: ἀντιστοιχία N;GEN(SG)	ἀντῐστοιχῐ́ᾱς	ἀντῐστοιχῐ́ᾱς
Generate the inflected form for: ἀντιστοιχία N;NOM(DU)	ἀντῐστοιχῐ́ᾱ	ἀντῐστοιχῐ́ᾱ
Generate the inflected form for: ἀντιστοιχία N;NOM(PL)	ἀντῐστοιχῐ́αι	ἀντῐστοιχῐ́αι
Generate the inflected form for: ἀντιστοιχία N;NOM(SG)	ἀντῐστοιχῐ́ᾱ	ἀντῐστοιχῐ́ᾱ
Generate the inflected form for: ἀντιστοιχία N;VOC(DU)	ἀντῐστοιχῐ́ᾱ	ἀντῐστοιχῐ́ᾱ
Generate the inflected form for: ἀντιστοιχία N;VOC(PL)	ἀντῐστοιχῐ́αι	ἀντῐστοιχῐ́αι
Generate the inflected form for: ἀντιστοιχία N;VOC(SG)	ἀντῐστοιχῐ́ᾱ	ἀντῐστοιχῐ́ᾱ
Generate the inflected form for: ἀξίνη N;ACC(DU)	ἀξῐ́νᾱ	ἀξῑ́νᾱ
Generate the inflected form for: ἀξίνη N;ACC(PL)	ἀξῐ́νᾱς	ἀξῑ́νᾱς
Generate the inflected form for: ἀξίνη N;ACC(SG)	ἀξῐ́νην	ἀξῑ́νην
Generate the inflected form for: ἀξίνη N;DAT(DU)	ἀξῐ́ναιν	ἀξῑ́ναιν
Generate the inflected form for: ἀξίνη N;DAT(PL)	ἀξῐ́ναις	ἀξῑ́ναις
Generate the inflected form for: ἀξίνη N;DAT(SG)	ἀξῐ́νῃ	ἀξῑ́νῃ
Generate the inflected form for: ἀξίνη N;GEN(DU)	ἀξῐ́ναιν	ἀξῑ́ναιν
Generate the inflected form for: ἀξίνη N;GEN(PL)	ἀξῐ́νων	ἀξῑνῶν
Generate the inflected form for: ἀξίνη N;GEN(SG)	ἀξῐ́νης	ἀξῑ́νης
Generate the inflected form for: ἀξίνη N;NOM(DU)	ἀξῐ́νᾱ	ἀξῑ́νᾱ
Generate the inflected form for: ἀξίνη N;NOM(PL)	ἀξῐ́ναι	ἀξῖναι
Generate the inflected form for: ἀξίνη N;NOM(SG)	ἀξῐ́νη	ἀξῑ́νη
Generate the inflected form for: ἀξίνη N;VOC(DU)	ἀξῐ́νᾱ	ἀξῑ́νᾱ
Generate the inflected form for: ἀξίνη N;VOC(PL)	ἀξῐ́ναι	ἀξῖναι
Generate the inflected form for: ἀξίνη N;VOC(SG)	ἀξῐ́νη	ἀξῑ́νη
Generate the inflected form for: ἀρχισυνάγωγος N;ACC(DU)	ἀρχισυναγώγω	ἀρχῐσῠνᾰγώγω
Generate the inflected form for: ἀρχισυνάγωγος N;ACC(PL)	ἀρχισυνάγωγους	ἀρχῐσῠνᾰγώγους
Generate the inflected form for: ἀρχισυνάγωγος N;ACC(SG)	ἀρχισυνάγωγον	ἀρχῐσῠνᾰ́γωγον
Generate the inflected form for: ἀρχισυνάγωγος N;DAT(DU)	ἀρχισυναγώγοιν	ἀρχῐσῠνᾰγώγοιν
Generate the inflected form for: ἀρχισυνάγωγος N;DAT(PL)	ἀρχισυναγώγοις	ἀρχῐσῠνᾰγώγοις
Generate the inflected form for: ἀρχισυνάγωγος N;DAT(SG)	ἀρχισυναγώγῳ	ἀρχῐσῠνᾰγώγῳ
Generate the inflected form for: ἀρχισυνάγωγος N;GEN(DU)	ἀρχισυναγώγοιν	ἀρχῐσῠνᾰγώγοιν
Generate the inflected form for: ἀρχισυνάγωγος N;GEN(PL)	ἀρχισυναγώγων	ἀρχῐσῠνᾰγώγων
Generate the inflected form for: ἀρχισυνάγωγος N;GEN(SG)	ἀρχισυναγώγου	ἀρχῐσῠνᾰγώγου
Generate the inflected form for: ἀρχισυνάγωγος N;NOM(DU)	ἀρχισυναγώγω	ἀρχῐσῠνᾰγώγω
Generate the inflected form for: ἀρχισυνάγωγος N;NOM(PL)	ἀρχισυνάγωγοι	ἀρχῐσῠνᾰ́γωγοι
Generate the inflected form for: ἀρχισυνάγωγος N;NOM(SG)	ἀρχισυνάγωγος	ἀρχῐσῠνᾰ́γωγος
Generate the inflected form for: ἀρχισυνάγωγος N;VOC(DU)	ἀρχισυναγώγω	ἀρχῐσῠνᾰγώγω
Generate the inflected form for: ἀρχισυνάγωγος N;VOC(PL)	ἀρχισυνάγωγοι	ἀρχῐσῠνᾰ́γωγοι
Generate the inflected form for: ἀρχισυνάγωγος N;VOC(SG)	ἀρχισυνάγωγε	ἀρχῐσῠνᾰ́γωγε
Generate the inflected form for: ἄφωνος ADJ;ACC(PL;FEM)	ἄφωνους	ἀφώνους
Generate the inflected form for: ἄφωνος ADJ;ACC(PL;MASC)	ἄφωνους	ἀφώνους
Generate the inflected form for: ἄφωνος ADJ;ACC(PL;NEUT)	ἄφωνα	ἄφωνα
Generate the inflected form for: ἄφωνος ADJ;ACC(SG;FEM)	ἄφωνον	ἄφωνον
Generate the inflected form for: ἄφωνος ADJ;ACC(SG;NEUT)	ἄφωνον	ἄφωνον
Generate the inflected form for: ἄφωνος ADJ;DAT(DU;FEM)	ἀφώνοιν	ἀφώνοιν
Generate the inflected form for: ἄφωνος ADJ;DAT(DU;MASC)	ἀφώνοιν	ἀφώνοιν
Generate the inflected form for: ἄφωνος ADJ;DAT(DU;NEUT)	ἀφώνοιν	ἀφώνοιν
Generate the inflected form for: ἄφωνος ADJ;DAT(PL;FEM)	ἀφώνοις	ἀφώνοις
Generate the inflected form for: ἄφωνος ADJ;DAT(PL;MASC)	ἀφώνοις	ἀφώνοις
Generate the inflected form for: ἄφωνος ADJ;DAT(PL;NEUT)	ἀφώνοις	ἀφώνοις
Generate the inflected form for: ἄφωνος ADJ;DAT(SG;FEM)	ἀφώνῳ	ἀφώνῳ
Generate the inflected form for: ἄφωνος ADJ;DAT(SG;MASC)	ἀφώνῳ	ἀφώνῳ
Generate the inflected form for: ἄφωνος ADJ;DAT(SG;NEUT)	ἀφώνῳ	ἀφώνῳ
Generate the inflected form for: ἄφωνος ADJ;GEN(DU;FEM)	ἀφώνοιν	ἀφώνοιν
Generate the inflected form for: ἄφωνος ADJ;GEN(PL;FEM)	ἀφώνων	ἀφώνων
Generate the inflected form for: ἄφωνος ADJ;GEN(PL;MASC)	ἀφώνων	ἀφώνων
Generate the inflected form for: ἄφωνος ADJ;GEN(PL;NEUT)	ἀφώνων	ἀφώνων
Generate the inflected form for: ἄφωνος ADJ;GEN(SG;FEM)	ἀφώνου	ἀφώνου
Generate the inflected form for: ἄφωνος ADJ;GEN(SG;MASC)	ἀφώνου	ἀφώνου
Generate the inflected form for: ἄφωνος ADJ;NOM(DU;MASC)	ἀφώνω	ἀφώνω
Generate the inflected form for: ἄφωνος ADJ;NOM(PL;FEM)	ἄφωνοι	ἄφωνοι
Generate the inflected form for: ἄφωνος ADJ;NOM(PL;MASC)	ἄφωνοι	ἄφωνοι
Generate the inflected form for: ἄφωνος ADJ;NOM(PL;NEUT)	ἄφωνα	ἄφωνα
Generate the inflected form for: ἄφωνος ADJ;NOM(SG;FEM)	ἄφωνος	ἄφωνος
Generate the inflected form for: ἄφωνος ADJ;NOM(SG;MASC)	ἄφωνος	ἄφωνος
Generate the inflected form for: ἄφωνος ADJ;VOC(DU;FEM)	ἀφώνω	ἀφώνω
Generate the inflected form for: ἄφωνος ADJ;VOC(DU;MASC)	ἀφώνω	ἀφώνω
Generate the inflected form for: ἄφωνος ADJ;VOC(DU;NEUT)	ἀφώνω	ἀφώνω
Generate the inflected form for: ἄφωνος ADJ;VOC(PL;MASC)	ἄφωνοι	ἄφωνοι
Generate the inflected form for: ἄφωνος ADJ;VOC(PL;NEUT)	ἄφωνα	ἄφωνα
Generate the inflected form for: ἄφωνος ADJ;VOC(SG;MASC)	ἄφωνε	ἄφωνε
Generate the inflected form for: ἄφωνος ADJ;VOC(SG;NEUT)	ἄφωνον	ἄφωνον
Generate the inflected form for: Ἀβδηρίτης N;ACC(DU)	Ἀβδηρῑ́τᾱ	Ἀβδηρῑ́τᾱ
Generate the inflected form for: Ἀβδηρίτης N;ACC(PL)	Ἀβδηρῑ́τᾱς	Ἀβδηρῑ́τᾱς
Generate the inflected form for: Ἀβδηρίτης N;ACC(SG)	Ἀβδηρῑ́την	Ἀβδηρῑ́την
Generate the inflected form for: Ἀβδηρίτης N;DAT(DU)	Ἀβδηρῑ́ταιν	Ἀβδηρῑ́ταιν
Generate the inflected form for: Ἀβδηρίτης N;DAT(PL)	Ἀβδηρῑ́ταις	Ἀβδηρῑ́ταις
Generate the inflected form for: Ἀβδηρίτης N;DAT(SG)	Ἀβδηρῑ́τῃ	Ἀβδηρῑ́τῃ
Generate the inflected form for: Ἀβδηρίτης N;GEN(DU)	Ἀβδηρῑ́ταιν	Ἀβδηρῑ́ταιν
Generate the inflected form for: Ἀβδηρίτης N;GEN(PL)	Ἀβδηρῑ́των	Ἀβδηρῑτῶν
Generate the inflected form for: Ἀβδηρίτης N;GEN(SG)	Ἀβδηρῑ́του	Ἀβδηρῑ́του
Generate the inflected form for: Ἀβδηρίτης N;NOM(DU)	Ἀβδηρῑ́τᾱ	Ἀβδηρῑ́τᾱ
Generate the inflected form for: Ἀβδηρίτης N;NOM(PL)	Ἀβδηρῑ́ται	Ἀβδηρῖται
Generate the inflected form for: Ἀβδηρίτης N;NOM(SG)	Ἀβδηρῑ́της	Ἀβδηρῑ́της
Generate the inflected form for: Ἀβδηρίτης N;VOC(DU)	Ἀβδηρῑ́τᾱ	Ἀβδηρῑ́τᾱ
Generate the inflected form for: Ἀβδηρίτης N;VOC(PL)	Ἀβδηρῑ́ται	Ἀβδηρῖται
Generate the inflected form for: Ἀβδηρίτης N;VOC(SG)	Ἀβδηρῑ́τη	Ἀβδηρῖτᾰ
Generate the inflected form for: Ἀσεάτης N;ACC(DU)	Ἀσεᾱ́τᾱ	Ἀσεᾱ́τᾱ
Generate the inflected form for: Ἀσεάτης N;ACC(PL)	Ἀσεᾱ́τᾱς	Ἀσεᾱ́τᾱς
Generate the inflected form for: Ἀσεάτης N;ACC(SG)	Ἀσεᾱ́την	Ἀσεᾱ́την
Generate the inflected form for: Ἀσεάτης N;DAT(DU)	Ἀσεᾱ́ταιν	Ἀσεᾱ́ταιν
Generate the inflected form for: Ἀσεάτης N;DAT(PL)	Ἀσεᾱ́ταις	Ἀσεᾱ́ταις
Generate the inflected form for: Ἀσεάτης N;DAT(SG)	Ἀσεᾱ́τῃ	Ἀσεᾱ́τῃ
Generate the inflected form for: Ἀσεάτης N;GEN(PL)	Ἀσεᾱ́των	Ἀσεᾱτῶν
Generate the inflected form for: Ἀσεάτης N;GEN(SG)	Ἀσεᾱ́του	Ἀσεᾱ́του
Generate the inflected form for: Ἀσεάτης N;NOM(DU)	Ἀσεᾱ́τᾱ	Ἀσεᾱ́τᾱ
Generate the inflected form for: Ἀσεάτης N;NOM(PL)	Ἀσεᾱ́ται	Ἀσεᾶται
Generate the inflected form for: Ἀσεάτης N;NOM(SG)	Ἀσεᾱ́της	Ἀσεᾱ́της
Generate the inflected form for: Ἀσεάτης N;VOC(DU)	Ἀσεᾱ́τᾱ	Ἀσεᾱ́τᾱ
Generate the inflected form for: Ἀσεάτης N;VOC(PL)	Ἀσεᾱ́ται	Ἀσεᾶται
Generate the inflected form for: Ἀσεάτης N;VOC(SG)	Ἀσεᾱ́τη	Ἀσεᾶτᾰ
Generate the inflected form for: ἐμπρακτικός ADJ;ACC(DU;FEM)	ἐμπρακτικᾱ́	ἐμπρακτικᾱ́
Generate the inflected form for: ἐμπρακτικός ADJ;ACC(DU;MASC)	ἐμπρακτικώ	ἐμπρακτικώ
Generate the inflected form for: ἐμπρακτικός ADJ;ACC(DU;NEUT)	ἐμπρακτικώ	ἐμπρακτικώ
Generate the inflected form for: ἐμπρακτικός ADJ;ACC(PL;FEM)	ἐμπρακτικᾱ́ς	ἐμπρακτικᾱ́ς
Generate the inflected form for: ἐμπρακτικός ADJ;ACC(PL;MASC)	ἐμπρακτικούς	ἐμπρακτικούς
Generate the inflected form for: ἐμπρακτικός ADJ;ACC(PL;NEUT)	ἐμπρακτικᾰ́	ἐμπρακτικᾰ́
Generate the inflected form for: ἐμπρακτικός ADJ;ACC(SG;FEM)	ἐμπρακτικήν	ἐμπρακτικήν
Generate the inflected form for: ἐμπρακτικός ADJ;ACC(SG;MASC)	ἐμπρακτικόν	ἐμπρακτικόν
Generate the inflected form for: ἐμπρακτικός ADJ;DAT(DU;MASC)	ἐμπρακτικοῖν	ἐμπρακτικοῖν
Generate the inflected form for: ἐμπρακτικός ADJ;DAT(DU;NEUT)	ἐμπρακτικοῖν	ἐμπρακτικοῖν
Generate the inflected form for: ἐμπρακτικός ADJ;DAT(SG;FEM)	ἐμπρακτικῇ	ἐμπρακτικῇ
Generate the inflected form for: ἐμπρακτικός ADJ;DAT(SG;MASC)	ἐμπρακτικῷ	ἐμπρακτικῷ
Generate the inflected form for: ἐμπρακτικός ADJ;DAT(SG;NEUT)	ἐμπρακτικῷ	ἐμπρακτικῷ
Generate the inflected form for: ἐμπρακτικός ADJ;GEN(DU;FEM)	ἐμπρακτικαῖν	ἐμπρακτικαῖν
Generate the inflected form for: ἐμπρακτικός ADJ;GEN(DU;MASC)	ἐμπρακτικοῖν	ἐμπρακτικοῖν
Generate the inflected form for: ἐμπρακτικός ADJ;GEN(DU;NEUT)	ἐμπρακτικοῖν	ἐμπρακτικοῖν
Generate the inflected form for: ἐμπρακτικός ADJ;GEN(PL;FEM)	ἐμπρακτικῶν	ἐμπρακτικῶν
Generate the inflected form for: ἐμπρακτικός ADJ;GEN(PL;MASC)	ἐμπρακτικῶν	ἐμπρακτικῶν
Generate the inflected form for: ἐμπρακτικός ADJ;GEN(SG;MASC)	ἐμπρακτικοῦ	ἐμπρακτικοῦ
Generate the inflected form for: ἐμπρακτικός ADJ;GEN(SG;NEUT)	ἐμπρακτικοῦ	ἐμπρακτικοῦ
Generate the inflected form for: ἐμπρακτικός ADJ;NOM(DU;FEM)	ἐμπρακτικᾱ́	ἐμπρακτικᾱ́
Generate the inflected form for: ἐμπρακτικός ADJ;NOM(DU;MASC)	ἐμπρακτικώ	ἐμπρακτικώ
Generate the inflected form for: ἐμπρακτικός ADJ;NOM(PL;FEM)	ἐμπρακτικαί	ἐμπρακτικαί
Generate the inflected form for: ἐμπρακτικός ADJ;NOM(PL;MASC)	ἐμπρακτικοί	ἐμπρακτικοί
Generate the inflected form for: ἐμπρακτικός ADJ;NOM(PL;NEUT)	ἐμπρακτικᾰ́	ἐμπρακτικᾰ́
Generate the inflected form for: ἐμπρακτικός ADJ;NOM(SG;FEM)	ἐμπρακτική	ἐμπρακτική
Generate the inflected form for: ἐμπρακτικός ADJ;VOC(DU;FEM)	ἐμπρακτικᾱ́	ἐμπρακτικᾱ́
Generate the inflected form for: ἐμπρακτικός ADJ;VOC(DU;MASC)	ἐμπρακτικώ	ἐμπρακτικώ
Generate the inflected form for: ἐμπρακτικός ADJ;VOC(DU;NEUT)	ἐμπρακτικώ	ἐμπρακτικώ
Generate the inflected form for: ἐμπρακτικός ADJ;VOC(PL;MASC)	ἐμπρακτικοί	ἐμπρακτικοί
Generate the inflected form for: ἐμπρακτικός ADJ;VOC(PL;NEUT)	ἐμπρακτικᾰ́	ἐμπρακτικᾰ́
Generate the inflected form for: ἐμπρακτικός ADJ;VOC(SG;MASC)	ἐμπρακτικέ	ἐμπρακτικέ
Generate the inflected form for: ἐμπρακτικός ADJ;VOC(SG;NEUT)	ἐμπρακτικόν	ἐμπρακτικόν
Generate the inflected form for: ἐξομολογητικός ADJ;ACC(DU;MASC)	ἐξομολογητῐκώ	ἐξομολογητῐκώ
Generate the inflected form for: ἐξομολογητικός ADJ;ACC(DU;NEUT)	ἐξομολογητῐκώ	ἐξομολογητῐκώ
Generate the inflected form for: ἐξομολογητικός ADJ;ACC(PL;MASC)	ἐξομολογητῐκού	ἐξομολογητῐκούς
Generate the inflected form for: ἐξομολογητικός ADJ;ACC(PL;NEUT)	ἐξομολογητῐκᾰ́	ἐξομολογητῐκᾰ́
Generate the inflected form for: ἐξομολογητικός ADJ;ACC(SG;FEM)	ἐξομολογητῐκήν	ἐξομολογητῐκήν
Generate the inflected form for: ἐξομολογητικός ADJ;ACC(SG;MASC)	ἐξομολογητῐκόν	ἐξομολογητῐκόν
Generate the inflected form for: ἐξομολογητικός ADJ;DAT(DU;MASC)	ἐξομολογητῐκοῖ	ἐξομολογητῐκοῖν
Generate the inflected form for: ἐξομολογητικός ADJ;DAT(DU;NEUT)	ἐξομολογητῐκοῖ	ἐξομολογητῐκοῖν
Generate the inflected form for: ἐξομολογητικός ADJ;DAT(PL;FEM)	ἐξομολογητῐκαῖ	ἐξομολογητῐκαῖς
Generate the inflected form for: ἐξομολογητικός ADJ;DAT(PL;MASC)	ἐξομολογητῐκοῖ	ἐξομολογητῐκοῖς
Generate the inflected form for: ἐξομολογητικός ADJ;DAT(PL;NEUT)	ἐξομολογητῐκοῖ	ἐξομολογητῐκοῖς
Generate the inflected form for: ἐξομολογητικός ADJ;DAT(SG;FEM)	ἐξομολογητῐκῇ	ἐξομολογητῐκῇ
Generate the inflected form for: ἐξομολογητικός ADJ;DAT(SG;MASC)	ἐξομολογητῐκῷ	ἐξομολογητῐκῷ
Generate the inflected form for: ἐξομολογητικός ADJ;DAT(SG;NEUT)	ἐξομολογητῐκῷ	ἐξομολογητῐκῷ
Generate the inflected form for: ἐξομολογητικός ADJ;GEN(DU;MASC)	ἐξομολογητῐκοῖ	ἐξομολογητῐκοῖν
Generate the inflected form for: ἐξομολογητικός ADJ;GEN(DU;NEUT)	ἐξομολογητῐκοῖ	ἐξομολογητῐκοῖν
Generate the inflected form for: ἐξομολογητικός ADJ;GEN(PL;MASC)	ἐξομολογητῐκῶν	ἐξομολογητῐκῶν
Generate the inflected form for: ἐξομολογητικός ADJ;GEN(PL;NEUT)	ἐξομολογητῐκῶν	ἐξομολογητῐκῶν
Generate the inflected form for: ἐξομολογητικός ADJ;GEN(SG;FEM)	ἐξομολογητῐκῆς	ἐξομολογητῐκῆς
Generate the inflected form for: ἐξομολογητικός ADJ;GEN(SG;MASC)	ἐξομολογητῐκοῦ	ἐξομολογητῐκοῦ
Generate the inflected form for: ἐξομολογητικός ADJ;NOM(DU;FEM)	ἐξομολογητῐκᾱ́	ἐξομολογητῐκᾱ́
Generate the inflected form for: ἐξομολογητικός ADJ;NOM(DU;MASC)	ἐξομολογητῐκώ	ἐξομολογητῐκώ
Generate the inflected form for: ἐξομολογητικός ADJ;NOM(DU;NEUT)	ἐξομολογητῐκώ	ἐξομολογητῐκώ
Generate the inflected form for: ἐξομολογητικός ADJ;NOM(PL;FEM)	ἐξομολογητῐκαί	ἐξομολογητῐκαί
Generate the inflected form for: ἐξομολογητικός ADJ;NOM(PL;NEUT)	ἐξομολογητῐκᾰ́	ἐξομολογητῐκᾰ́
Generate the inflected form for: ἐξομολογητικός ADJ;NOM(SG;NEUT)	ἐξομολογητῐκόν	ἐξομολογητῐκόν
Generate the inflected form for: ἐξομολογητικός ADJ;VOC(DU;FEM)	ἐξομολογητῐκᾱ́	ἐξομολογητῐκᾱ́
Generate the inflected form for: ἐξομολογητικός ADJ;VOC(DU;MASC)	ἐξομολογητῐκώ	ἐξομολογητῐκώ
Generate the inflected form for: ἐξομολογητικός ADJ;VOC(PL;FEM)	ἐξομολογητῐκαί	ἐξομολογητῐκαί
Generate the inflected form for: ἐξομολογητικός ADJ;VOC(PL;MASC)	ἐξομολογητῐκοί	ἐξομολογητῐκοί
Generate the inflected form for: ἐξομολογητικός ADJ;VOC(SG;FEM)	ἐξομολογητῐκή	ἐξομολογητῐκή
Generate the inflected form for: ἐξομολογητικός ADJ;VOC(SG;MASC)	ἐξομολογητῐκέ	ἐξομολογητῐκέ
Generate the inflected form for: ἐξομολογητικός ADJ;VOC(SG;NEUT)	ἐξομολογητῐκόν	ἐξομολογητῐκόν
Generate the inflected form for: Ἑλληνικός ADJ;ACC(DU;FEM)	Ἑλληνικᾱ́	Ἑλληνικᾱ́
Generate the inflected form for: Ἑλληνικός ADJ;ACC(DU;NEUT)	Ἑλληνικώ	Ἑλληνικώ
Generate the inflected form for: Ἑλληνικός ADJ;ACC(PL;FEM)	Ἑλληνικᾱ́ς	Ἑλληνικᾱ́ς
Generate the inflected form for: Ἑλληνικός ADJ;ACC(PL;MASC)	Ἑλληνικούς	Ἑλληνικούς
Generate the inflected form for: Ἑλληνικός ADJ;ACC(SG;MASC)	Ἑλληνικόν	Ἑλληνικόν
Generate the inflected form for: Ἑλληνικός ADJ;ACC(SG;NEUT)	Ἑλληνικόν	Ἑλληνικόν
Generate the inflected form for: Ἑλληνικός ADJ;DAT(DU;FEM)	Ἑλληνικαῖν	Ἑλληνικαῖν
Generate the inflected form for: Ἑλληνικός ADJ;DAT(DU;MASC)	Ἑλληνικοῖν	Ἑλληνικοῖν
Generate the inflected form for: Ἑλληνικός ADJ;DAT(DU;NEUT)	Ἑλληνικοῖν	Ἑλληνικοῖν
Generate the inflected form for: Ἑλληνικός ADJ;DAT(PL;FEM)	Ἑλληνικαῖς	Ἑλληνικαῖς
Generate the inflected form for: Ἑλληνικός ADJ;DAT(SG;NEUT)	Ἑλληνικῷ	Ἑλληνικῷ
Generate the inflected form for: Ἑλληνικός ADJ;GEN(DU;FEM)	Ἑλληνικαῖν	Ἑλληνικαῖν
Generate the inflected form for: Ἑλληνικός ADJ;GEN(DU;MASC)	Ἑλληνικοῖν	Ἑλληνικοῖν
Generate the inflected form for: Ἑλληνικός ADJ;GEN(DU;NEUT)	Ἑλληνικοῖν	Ἑλληνικοῖν
Generate the inflected form for: Ἑλληνικός ADJ;GEN(PL;FEM)	Ἑλληνικῶν	Ἑλληνικῶν
Generate the inflected form for: Ἑλληνικός ADJ;GEN(PL;MASC)	Ἑλληνικῶν	Ἑλληνικῶν
Generate the inflected form for: Ἑλληνικός ADJ;GEN(PL;NEUT)	Ἑλληνικῶν	Ἑλληνικῶν
Generate the inflected form for: Ἑλληνικός ADJ;GEN(SG;MASC)	Ἑλληνικοῦ	Ἑλληνικοῦ
Generate the inflected form for: Ἑλληνικός ADJ;GEN(SG;NEUT)	Ἑλληνικοῦ	Ἑλληνικοῦ
Generate the inflected form for: Ἑλληνικός ADJ;NOM(DU;FEM)	Ἑλληνικᾱ́	Ἑλληνικᾱ́
Generate the inflected form for: Ἑλληνικός ADJ;NOM(DU;MASC)	Ἑλληνικώ	Ἑλληνικώ
Generate the inflected form for: Ἑλληνικός ADJ;NOM(DU;NEUT)	Ἑλληνικώ	Ἑλληνικώ
Generate the inflected form for: Ἑλληνικός ADJ;NOM(PL;FEM)	Ἑλληνικαί	Ἑλληνικαί
Generate the inflected form for: Ἑλληνικός ADJ;NOM(PL;MASC)	Ἑλληνικοί	Ἑλληνικοί
Generate the inflected form for: Ἑλληνικός ADJ;NOM(PL;NEUT)	Ἑλληνικᾰ́	Ἑλληνικᾰ́
Generate the inflected form for: Ἑλληνικός ADJ;NOM(SG;FEM)	Ἑλληνική	Ἑλληνική
Generate the inflected form for: Ἑλληνικός ADJ;NOM(SG;MASC)	Ἑλληνικός	Ἑλληνικός
Generate the inflected form for: Ἑλληνικός ADJ;NOM(SG;NEUT)	Ἑλληνικόν	Ἑλληνικόν
Generate the inflected form for: Ἑλληνικός ADJ;VOC(DU;FEM)	Ἑλληνικᾱ́	Ἑλληνικᾱ́
Generate the inflected form for: Ἑλληνικός ADJ;VOC(DU;MASC)	Ἑλληνικώ	Ἑλληνικώ
Generate the inflected form for: Ἑλληνικός ADJ;VOC(DU;NEUT)	Ἑλληνικώ	Ἑλληνικώ
Generate the inflected form for: Ἑλληνικός ADJ;VOC(PL;NEUT)	Ἑλληνικᾰ́	Ἑλληνικᾰ́
Generate the inflected form for: Ἑλληνικός ADJ;VOC(SG;FEM)	Ἑλληνική	Ἑλληνική
Generate the inflected form for: Ἔλυμος N;ACC(DU)	Ἔλυμω	Ἐλύμω
Generate the inflected form for: Ἔλυμος N;ACC(PL)	Ἔλυμους	Ἐλύμους
Generate the inflected form for: Ἔλυμος N;ACC(SG)	Ἔλυμον	Ἔλυμον
Generate the inflected form for: Ἔλυμος N;DAT(DU)	Ἔλυμοιν	Ἐλύμοιν
Generate the inflected form for: Ἔλυμος N;DAT(PL)	Ἔλυμοις	Ἐλύμοις
Generate the inflected form for: Ἔλυμος N;DAT(SG)	Ἔλυμῳ	Ἐλύμῳ
Generate the inflected form for: Ἔλυμος N;GEN(DU)	Ἔλυμοιν	Ἐλύμοιν
Generate the inflected form for: Ἔλυμος N;GEN(PL)	Ἔλυμων	Ἐλύμων
Generate the inflected form for: Ἔλυμος N;GEN(SG)	Ἔλυμου	Ἐλύμου
Generate the inflected form for: Ἔλυμος N;NOM(DU)	Ἔλυμω	Ἐλύμω
Generate the inflected form for: Ἔλυμος N;NOM(PL)	Ἔλυμοι	Ἔλυμοι
Generate the inflected form for: Ἔλυμος N;NOM(SG)	Ἔλυμος	Ἔλυμος
Generate the inflected form for: Ἔλυμος N;VOC(DU)	Ἔλυμω	Ἐλύμω
Generate the inflected form for: Ἔλυμος N;VOC(PL)	Ἔλυμοι	Ἔλυμοι
Generate the inflected form for: Ἔλυμος N;VOC(SG)	Ἔλυμε	Ἔλυμε
Generate the inflected form for: ἡστικός ADJ;ACC(DU;MASC)	ἡστικώ	ἡστικώ
Generate the inflected form for: ἡστικός ADJ;ACC(PL;FEM)	ἡστικᾱ́ς	ἡστικᾱ́ς
Generate the inflected form for: ἡστικός ADJ;ACC(PL;NEUT)	ἡστικᾰ́	ἡστικᾰ́
Generate the inflected form for: ἡστικός ADJ;ACC(SG;FEM)	ἡστικήν	ἡστικήν
Generate the inflected form for: ἡστικός ADJ;ACC(SG;MASC)	ἡστικόν	ἡστικόν
Generate the inflected form for: ἡστικός ADJ;ACC(SG;NEUT)	ἡστικόν	ἡστικόν
Generate the inflected form for: ἡστικός ADJ;DAT(DU;FEM)	ἡστικαῖν	ἡστικαῖν
Generate the inflected form for: ἡστικός ADJ;DAT(DU;MASC)	ἡστικοῖν	ἡστικοῖν
Generate the inflected form for: ἡστικός ADJ;DAT(DU;NEUT)	ἡστικοῖν	ἡστικοῖν
Generate the inflected form for: ἡστικός ADJ;DAT(PL;FEM)	ἡστικαῖς	ἡστικαῖς
Generate the inflected form for: ἡστικός ADJ;DAT(PL;MASC)	ἡστικοῖς	ἡστικοῖς
Generate the inflected form for: ἡστικός ADJ;DAT(PL;NEUT)	ἡστικοῖς	ἡστικοῖς
Generate the inflected form for: ἡστικός ADJ;DAT(SG;FEM)	ἡστικῇ	ἡστικῇ
Generate the inflected form for: ἡστικός ADJ;DAT(SG;NEUT)	ἡστικῷ	ἡστικῷ
Generate the inflected form for: ἡστικός ADJ;GEN(DU;MASC)	ἡστικοῖν	ἡστικοῖν
Generate the inflected form for: ἡστικός ADJ;GEN(DU;NEUT)	ἡστικοῖν	ἡστικοῖν
Generate the inflected form for: ἡστικός ADJ;GEN(PL;FEM)	ἡστικῶν	ἡστικῶν
Generate the inflected form for: ἡστικός ADJ;GEN(PL;NEUT)	ἡστικῶν	ἡστικῶν
Generate the inflected form for: ἡστικός ADJ;GEN(SG;MASC)	ἡστικοῦ	ἡστικοῦ
Generate the inflected form for: ἡστικός ADJ;NOM(DU;FEM)	ἡστικᾱ́	ἡστικᾱ́
Generate the inflected form for: ἡστικός ADJ;NOM(DU;MASC)	ἡστικώ	ἡστικώ
Generate the inflected form for: ἡστικός ADJ;NOM(DU;NEUT)	ἡστικώ	ἡστικώ
Generate the inflected form for: ἡστικός ADJ;NOM(PL;FEM)	ἡστικαί	ἡστικαί
Generate the inflected form for: ἡστικός ADJ;NOM(PL;MASC)	ἡστικοί	ἡστικοί
Generate the inflected form for: ἡστικός ADJ;NOM(PL;NEUT)	ἡστικᾰ́	ἡστικᾰ́
Generate the inflected form for: ἡστικός ADJ;NOM(SG;FEM)	ἡστική	ἡστική
Generate the inflected form for: ἡστικός ADJ;NOM(SG;NEUT)	ἡστικόν	ἡστικόν
Generate the inflected form for: ἡστικός ADJ;VOC(DU;MASC)	ἡστικώ	ἡστικώ
Generate the inflected form for: ἡστικός ADJ;VOC(DU;NEUT)	ἡστικώ	ἡστικώ
Generate the inflected form for: ἡστικός ADJ;VOC(PL;MASC)	ἡστικοί	ἡστικοί
Generate the inflected form for: ἡστικός ADJ;VOC(PL;NEUT)	ἡστικᾰ́	ἡστικᾰ́
Generate the inflected form for: ἡστικός ADJ;VOC(SG;MASC)	ἡστικέ	ἡστικέ
Generate the inflected form for: ἡστικός ADJ;VOC(SG;NEUT)	ἡστικόν	ἡστικόν
Generate the inflected form for: Ἠπειρώτης N;ACC(DU)	Ἠπειρώτᾱ	Ἠπειρώτᾱ
Generate the inflected form for: Ἠπειρώτης N;ACC(PL)	Ἠπειρώτᾱς	Ἠπειρώτᾱς
Generate the inflected form for: Ἠπειρώτης N;ACC(SG)	Ἠπειρώτην	Ἠπειρώτην
Generate the inflected form for: Ἠπειρώτης N;DAT(DU)	Ἠπειρώταιν	Ἠπειρώταιν
Generate the inflected form for: Ἠπειρώτης N;DAT(PL)	Ἠπειρώταις	Ἠπειρώταις
Generate the inflected form for: Ἠπειρώτης N;DAT(SG)	Ἠπειρώτῃ	Ἠπειρώτῃ
Generate the inflected form for: Ἠπειρώτης N;GEN(DU)	Ἠπειρώταιν	Ἠπειρώταιν
Generate the inflected form for: Ἠπειρώτης N;GEN(PL)	Ἠπειρώτων	Ἠπειρωτῶν
Generate the inflected form for: Ἠπειρώτης N;GEN(SG)	Ἠπειρώτου	Ἠπειρώτου
Generate the inflected form for: Ἠπειρώτης N;NOM(DU)	Ἠπειρώτᾱ	Ἠπειρώτᾱ
Generate the inflected form for: Ἠπειρώτης N;NOM(PL)	Ἠπειρώται	Ἠπειρῶται
Generate the inflected form for: Ἠπειρώτης N;NOM(SG)	Ἠπειρώτης	Ἠπειρώτης
Generate the inflected form for: Ἠπειρώτης N;VOC(DU)	Ἠπειρώτᾱ	Ἠπειρώτᾱ
Generate the inflected form for: Ἠπειρώτης N;VOC(PL)	Ἠπειρώται	Ἠπειρῶται
Generate the inflected form for: Ἠπειρώτης N;VOC(SG)	Ἠπειρώτη	Ἠπειρῶτᾰ
Generate the inflected form for: ὀνοματοποιία N;ACC(DU)	ὀνοματοποιῐ́ᾱ	ὀνομᾰτοποιῐ́ᾱ
Generate the inflected form for: ὀνοματοποιία N;ACC(PL)	ὀνοματοποιῐ́ᾱς	ὀνομᾰτοποιῐ́ᾱς
Generate the inflected form for: ὀνοματοποιία N;ACC(SG)	ὀνοματοποιῐ́ᾱν	ὀνομᾰτοποιῐ́ᾱν
Generate the inflected form for: ὀνοματοποιία N;DAT(DU)	ὀνοματοποιῐ́αι	ὀνομᾰτοποιῐ́αιν
Generate the inflected form for: ὀνοματοποιία N;DAT(PL)	ὀνοματοποιῐ́αι	ὀνομᾰτοποιῐ́αις
Generate the inflected form for: ὀνοματοποιία N;DAT(SG)	ὀνοματοποιῐ́ᾳ	ὀνομᾰτοποιῐ́ᾳ
Generate the inflected form for: ὀνοματοποιία N;GEN(DU)	ὀνοματοποιῐ́αι	ὀνομᾰτοποιῐ́αιν
Generate the inflected form for: ὀνοματοποιία N;GEN(PL)	ὀνοματοποιῐῶν	ὀνομᾰτοποιῐῶν
Generate the inflected form for: ὀνοματοποιία N;GEN(SG)	ὀνοματοποιῐ́ᾱς	ὀνομᾰτοποιῐ́ᾱς
Generate the inflected form for: ὀνοματοποιία N;NOM(DU)	ὀνοματοποιῐ́ᾱ	ὀνομᾰτοποιῐ́ᾱ
Generate the inflected form for: ὀνοματοποιία N;NOM(PL)	ὀνοματοποιῐ́αι	ὀνομᾰτοποιῐ́αι
Generate the inflected form for: ὀνοματοποιία N;NOM(SG)	ὀνοματοποιῐ́ᾱ	ὀνομᾰτοποιῐ́ᾱ
Generate the inflected form for: ὀνοματοποιία N;VOC(DU)	ὀνοματοποιῐ́ᾱ	ὀνομᾰτοποιῐ́ᾱ
Generate the inflected form for: ὀνοματοποιία N;VOC(PL)	ὀνοματοποιῐ́αι	ὀνομᾰτοποιῐ́αι
Generate the inflected form for: ὀνοματοποιία N;VOC(SG)	ὀνοματοποιῐ́ᾱ	ὀνομᾰτοποιῐ́ᾱ
Generate the inflected form for: ὀστοῦν N;ACC(DU)	ὀστοῖν	ὀστώ
Generate the inflected form for: ὀστοῦν N;ACC(PL)	ὀστοῦντᾰς	ὀστᾶ
Generate the inflected form for: ὀστοῦν N;ACC(SG)	ὀστοῦν	ὀστοῦν
Generate the inflected form for: ὀστοῦν N;DAT(DU)	ὀστούνοιν	ὀστοῖν
Generate the inflected form for: ὀστοῦν N;DAT(PL)	ὀστοῖσῐ(ν)	ὀστοῖς
Generate the inflected form for: ὀστοῦν N;DAT(SG)	ὀστοῦν	ὀστῷ
Generate the inflected form for: ὀστοῦν N;GEN(DU)	ὀστούνοιν	ὀστοῖν
Generate the inflected form for: ὀστοῦν N;GEN(PL)	ὀστοῖνων	ὀστῶν
Generate the inflected form for: ὀστοῦν N;GEN(SG)	ὀστοῦν	ὀστοῦ
Generate the inflected form for: ὀστοῦν N;NOM(DU)	ὀστοῖν	ὀστώ
Generate the inflected form for: ὀστοῦν N;NOM(PL)	ὀστοῦν	ὀστᾶ
Generate the inflected form for: ὀστοῦν N;NOM(SG)	ὀστοῦν	ὀστοῦν
Generate the inflected form for: ὀστοῦν N;VOC(DU)	ὀστοῖν	ὀστώ
Generate the inflected form for: ὀστοῦν N;VOC(PL)	ὀστοῦν	ὀστᾶ
Generate the inflected form for: ὀστοῦν N;VOC(SG)	ὀστοῦν	ὀστοῦν
Generate the inflected form for: ὁμόγραφος ADJ;ACC(DU;FEM)	ὁμογράφω	ὁμογράφω
Generate the inflected form for: ὁμόγραφος ADJ;ACC(DU;NEUT)	ὁμογράφω	ὁμογράφω
Generate the inflected form for: ὁμόγραφος ADJ;ACC(PL;MASC)	ὁμογράφους	ὁμογράφους
Generate the inflected form for: ὁμόγραφος ADJ;ACC(PL;NEUT)	ὁμόγραφα	ὁμόγραφα
Generate the inflected form for: ὁμόγραφος ADJ;ACC(SG;MASC)	ὁμόγραφον	ὁμόγραφον
Generate the inflected form for: ὁμόγραφος ADJ;ACC(SG;NEUT)	ὁμόγραφον	ὁμόγραφον
Generate the inflected form for: ὁμόγραφος ADJ;DAT(DU;FEM)	ὁμογράφοιν	ὁμογράφοιν
Generate the inflected form for: ὁμόγραφος ADJ;DAT(DU;MASC)	ὁμογράφοιν	ὁμογράφοιν
Generate the inflected form for: ὁμόγραφος ADJ;DAT(DU;NEUT)	ὁμογράφοιν	ὁμογράφοιν
Generate the inflected form for: ὁμόγραφος ADJ;DAT(PL;FEM)	ὁμογράφοις	ὁμογράφοις
Generate the inflected form for: ὁμόγραφος ADJ;DAT(PL;MASC)	ὁμογράφοις	ὁμογράφοις
Generate the inflected form for: ὁμόγραφος ADJ;DAT(PL;NEUT)	ὁμογράφοις	ὁμογράφοις
Generate the inflected form for: ὁμόγραφος ADJ;DAT(SG;FEM)	ὁμογράφῳ	ὁμογράφῳ
Generate the inflected form for: ὁμόγραφος ADJ;DAT(SG;MASC)	ὁμογράφῳ	ὁμογράφῳ
Generate the inflected form for: ὁμόγραφος ADJ;GEN(DU;MASC)	ὁμογράφοιν	ὁμογράφοιν
Generate the inflected form for: ὁμόγραφος ADJ;GEN(DU;NEUT)	ὁμογράφοιν	ὁμογράφοιν
Generate the inflected form for: ὁμόγραφος ADJ;GEN(PL;FEM)	ὁμογράφων	ὁμογράφων
Generate the inflected form for: ὁμόγραφος ADJ;GEN(PL;NEUT)	ὁμογράφων	ὁμογράφων
Generate the inflected form for: ὁμόγραφος ADJ;GEN(SG;FEM)	ὁμογράφου	ὁμογράφου
Generate the inflected form for: ὁμόγραφος ADJ;GEN(SG;NEUT)	ὁμογράφου	ὁμογράφου
Generate the inflected form for: ὁμόγραφος ADJ;NOM(DU;FEM)	ὁμογράφω	ὁμογράφω
Generate the inflected form for: ὁμόγραφος ADJ;NOM(DU;MASC)	ὁμογράφω	ὁμογράφω
Generate the inflected form for: ὁμόγραφος ADJ;NOM(DU;NEUT)	ὁμογράφω	ὁμογράφω
Generate the inflected form for: ὁμόγραφος ADJ;NOM(PL;MASC)	ὁμόγραφοι	ὁμόγραφοι
Generate the inflected form for: ὁμόγραφος ADJ;NOM(SG;NEUT)	ὁμόγραφον	ὁμόγραφον
Generate the inflected form for: ὁμόγραφος ADJ;VOC(DU;FEM)	ὁμογράφω	ὁμογράφω
Generate the inflected form for: ὁμόγραφος ADJ;VOC(DU;MASC)	ὁμογράφω	ὁμογράφω
Generate the inflected form for: ὁμόγραφος ADJ;VOC(DU;NEUT)	ὁμογράφω	ὁμογράφω
Generate the inflected form for: ὁμόγραφος ADJ;VOC(PL;FEM)	ὁμόγραφοι	ὁμόγραφοι
Generate the inflected form for: ὁμόγραφος ADJ;VOC(PL;MASC)	ὁμόγραφοι	ὁμόγραφοι
Generate the inflected form for: ὁμόγραφος ADJ;VOC(PL;NEUT)	ὁμόγραφα	ὁμόγραφα
Generate the inflected form for: ὁμόγραφος ADJ;VOC(SG;FEM)	ὁμόγραφε	ὁμόγραφε
Generate the inflected form for: ὁμόγραφος ADJ;VOC(SG;MASC)	ὁμόγραφε	ὁμόγραφε
Generate the inflected form for: ὅμιλος N;ACC(DU)	ὅμίλω	ὁμῑ́λω
Generate the inflected form for: ὅμιλος N;ACC(PL)	ὅμίλους	ὁμῑ́λους
Generate the inflected form for: ὅμιλος N;ACC(SG)	ὅμίλον	ὅμῑλον
Generate the inflected form for: ὅμιλος N;DAT(DU)	ὅμίλοιν	ὁμῑ́λοιν
Generate the inflected form for: ὅμιλος N;DAT(PL)	ὅμίλοις	ὁμῑ́λοις
Generate the inflected form for: ὅμιλος N;DAT(SG)	ὅμίλῳ	ὁμῑ́λῳ
Generate the inflected form for: ὅμιλος N;GEN(DU)	ὅμίλοιν	ὁμῑ́λοιν
Generate the inflected form for: ὅμιλος N;GEN(PL)	ὅμίλων	ὁμῑ́λων
Generate the inflected form for: ὅμιλος N;GEN(SG)	ὅμίλου	ὁμῑ́λου
Generate the inflected form for: ὅμιλος N;NOM(DU)	ὅμίλω	ὁμῑ́λω
Generate the inflected form for: ὅμιλος N;NOM(PL)	ὅμίλοι	ὅμῑλοι
Generate the inflected form for: ὅμιλος N;NOM(SG)	ὅμίλος	ὅμῑλος
Generate the inflected form for: ὅμιλος N;VOC(DU)	ὅμίλω	ὁμῑ́λω
Generate the inflected form for: ὅμιλος N;VOC(PL)	ὅμίλοι	ὅμῑλοι
Generate the inflected form for: ὅμιλος N;VOC(SG)	ὅμίλε	ὅμῑλε
Generate the inflected form for: ῥάδιξ N;ACC(DU)	ῥᾰδῐκε	ῥᾱδῖκε
Generate the inflected form for: ῥάδιξ N;ACC(PL)	ῥᾰ́δῐκᾰς	ῥᾱδῖκᾰς
Generate the inflected form for: ῥάδιξ N;ACC(SG)	ῥᾰ́δῐξν	ῥᾱδῖκᾰ
Generate the inflected form for: ῥάδιξ N;DAT(DU)	ῥᾰδῐκοῖν	ῥᾱδῑ́κοιν
Generate the inflected form for: ῥάδιξ N;DAT(PL)	ῥᾰδῐκοῖς	ῥᾱδῖκῐ(ν)
Generate the inflected form for: ῥάδιξ N;DAT(SG)	ῥᾰδῐκῐ	ῥᾱδῖκῐ
Generate the inflected form for: ῥάδιξ N;GEN(DU)	ῥᾰδῐκοῖν	ῥᾱδῑ́κοιν
Generate the inflected form for: ῥάδιξ N;GEN(PL)	ῥᾰδῐκῶν	ῥᾱδῑ́κων
Generate the inflected form for: ῥάδιξ N;GEN(SG)	ῥᾰδῐκοῦ	ῥᾱδῖκος
Generate the inflected form for: ῥάδιξ N;NOM(DU)	ῥᾰδῐκε	ῥᾱδῖκε
Generate the inflected form for: ῥάδιξ N;NOM(PL)	ῥᾰ́δῐκες	ῥᾱδῖκες
Generate the inflected form for: ῥάδιξ N;NOM(SG)	ῥᾰ́δῐξ	ῥᾱ́δῑξ
Generate the inflected form for: ῥάδιξ N;VOC(DU)	ῥᾰδῐκε	ῥᾱδῖκε
Generate the inflected form for: ῥάδιξ N;VOC(PL)	ῥᾰ́δῐκες	ῥᾱδῖκες
Generate the inflected form for: ῥάδιξ N;VOC(SG)	ῥᾰ́δῐξ	ῥᾱ́δῑξ
Generate the inflected form for: ῥητίνη N;ACC(DU)	ῥητῐ́νᾱ	ῥητῑ́νᾱ
Generate the inflected form for: ῥητίνη N;ACC(PL)	ῥητῐ́νᾱς	ῥητῑ́νᾱς
Generate the inflected form for: ῥητίνη N;ACC(SG)	ῥητῐ́νην	ῥητῑ́νην
Generate the inflected form for: ῥητίνη N;DAT(DU)	ῥητῐ́ναιν	ῥητῑ́ναιν
Generate the inflected form for: ῥητίνη N;DAT(PL)	ῥητῐ́ναις	ῥητῑ́ναις
Generate the inflected form for: ῥητίνη N;DAT(SG)	ῥητῐ́νῃ	ῥητῑ́νῃ
Generate the inflected form for: ῥητίνη N;GEN(DU)	ῥητῐ́ναιν	ῥητῑ́ναιν
Generate the inflected form for: ῥητίνη N;GEN(PL)	ῥητῐ́νων	ῥητῑνῶν
Generate the inflected form for: ῥητίνη N;GEN(SG)	ῥητῐ́νης	ῥητῑ́νης
Generate the inflected form for: ῥητίνη N;NOM(DU)	ῥητῐ́νᾱ	ῥητῑ́νᾱ
Generate the inflected form for: ῥητίνη N;NOM(PL)	ῥητῐ́ναι	ῥητῖναι
Generate the inflected form for: ῥητίνη N;NOM(SG)	ῥητῐ́νη	ῥητῑ́νη
Generate the inflected form for: ῥητίνη N;VOC(DU)	ῥητῐ́νᾱ	ῥητῑ́νᾱ
Generate the inflected form for: ῥητίνη N;VOC(PL)	ῥητῐ́ναι	ῥητῖναι
Generate the inflected form for: ῥητίνη N;VOC(SG)	ῥητῐ́νη	ῥητῑ́νη

Accuracy: 0.6290 (629/1000)
Mismatches (prediction | gold):
Βῐσᾰ́λτων | Βῐσᾰλτῶν
Βῐσᾰ́λτη | Βῐσᾰ́λτᾰ
Μᾰσσαλιώτᾱ | Μασσαλιώτᾱ
Μᾰσσαλιώτᾱς | Μασσαλιώτᾱς
Μᾰσσαλιώτην | Μασσαλιώτην
