accasciare V;COND;NOM(1,SG)	e di accasciare V;COND;NOM(1,S
accasciare V;COND;NOM(3,PL)	correre la pace delle cascate 
accasciare V;IND;FUT;NOM(1,SG)	are V;IND;FUT;NOM(1,SG)are V;I
accasciare V;IND;FUT;NOM(2,SG)	RET;NOM(2,SG)accasciare V;IND;
accasciare V;IND;PRS;NOM(1,PL)	re accasciare V;IND;PRS;NOM(1,
accasciare V;IND;PRS;NOM(1,SG)	e di accasciare V;IND;PRS;NOM(
accasciare V;IND;PRS;NOM(3,PL)	re V;IND;PRS;NOM(3,PL)accascia
accasciare V;IND;PST;IPFV;NOM(1,SG)	are accasciare V;IND;PST;IPFV;
accasciare V;IND;PST;IPFV;NOM(2,PL)	are accasciare accasciare acca
accasciare V;IND;PST;IPFV;NOM(3,PL)	compagnia a scacchi V;IND;PST;
accasciare V;IND;PST;IPFV;NOM(3,SG)	are accasciare V;IND;PST;IPFV;
accasciare V;NFIN	are accasciare accasciare acca
accasciare V;POS;IMP;NOM(1,PL)	e PL accasciare PL accasciare 
accasciare V;POS;IMP;NOM(3,PL)	ARE ARE ARE ARE ARE ARE ARE AR
accasciare V;POS;IMP;NOM(3,SG)	(1,SG)accasciare V;POS;IMP;NOM
accasciare V;SBJV;PRS;NOM(1,SG)	are V;SBJV;PRS;NOM(1,SG)are V;
accasciare V;SBJV;PRS;NOM(3,PL)	accasciare V;SBJV;PRS;NOM(3,PL
accasciare V;SBJV;PRS;NOM(3,SG)	are V;SBJV;PRS;NOM(3,SG)accasc
accasciare V;SBJV;PST;NOM(1,SG)	are V;SBJV;PST;NOM(1,SG)are V;
accasciare V;SBJV;PST;NOM(3,PL)	accasciare V;SBJV;PST;NOM(3,PL
accecare V.CVB;PRS	e V.CVB;PRSe PRSe PRSe PRSe PR
accecare V.PTCP;PRS	a Para Para Para Para Para Par
accecare V.PTCP;PST	e accecare V.PTCP;PST;PST;PST;
accecare V;COND;NOM(1,SG)	e accecare accecare accecare a
accecare V;COND;NOM(2,PL)	are accecare accecare accecare
accecare V;COND;NOM(2,SG)	e accecare accecare accecare a
accecare V;COND;NOM(3,PL)	i accecare V;COND;NOM(3,PL)acc
accecare V;COND;NOM(3,SG)	i accecare accecare accecare a
accecare V;IND;FUT;NOM(3,SG)	accecare V;IND;FUT;NOM(3,SG)ac
accecare V;IND;PRS;NOM(2,PL)	accecare accecare accecare acc
accecare V;IND;PRS;NOM(2,SG)	contare accecare accecare acce
accecare V;IND;PST;IPFV;NOM(1,PL)	accecare V;IND;PST;IPFV;NOM(1,
accecare V;IND;PST;PFV;NOM(1,SG)	 accecare accecare accecare ac
accecare V;IND;PST;PFV;NOM(2,PL)	e accecare V;IND;PST;PFV;NOM(2
accecare V;POS;IMP;NOM(1,PL)	accecare V;POS;IMP;NOM(1,PL)ac
accecare V;POS;IMP;NOM(3,PL)	are accecare accecare accecare
accecare V;POS;IMP;NOM(3,SG)	cecare acecare acecare acecare
accecare V;SBJV;PRS;NOM(1,SG)	comandare accecare accecare ac
accecare V;SBJV;PRS;NOM(2,SG)	controllare accecare accecare 
accecare V;SBJV;PST;NOM(3,SG)	comandare accecare accecare ac
accontentarsi V.PTCP;PRS	re accontarsi V.PTCP;PRSe V.PT
accontentarsi V;COND;NOM(3,PL)	;COND;NOM(3,PL)accontarsi V;CO
accontentarsi V;IND;FUT;NOM(1,PL)	re accontentarsi deve essere a
accontentarsi V;IND;FUT;NOM(1,SG)	re di non accontentarsi di non
accontentarsi V;IND;FUT;NOM(2,PL)	re di non accontentarsi di non
accontentarsi V;IND;FUT;NOM(3,PL)	re di non poter contare se non
accontentarsi V;IND;PRS;NOM(2,SG)	re accontentarsi V;IND;PRS;NOM
accontentarsi V;IND;PRS;NOM(3,PL)	re accontentarsi e accontentar
accontentarsi V;IND;PRS;NOM(3,SG)	re accontentarsi V;IND;PRS;NOM
accontentarsi V;IND;PST;IPFV;NOM(3,SG)	re accontentarsi V;IND;PST;IPF
accontentarsi V;IND;PST;PFV;NOM(1,PL)	re accontentarsi accontentarsi
accontentarsi V;IND;PST;PFV;NOM(2,SG)	re accontentarsi di non accont
accontentarsi V;IND;PST;PFV;NOM(3,PL)	re accontentarsi di non accont
accontentarsi V;IND;PST;PFV;NOM(3,SG)	re accontentarsi di non accont
accontentarsi V;POS;IMP;NOM(1,PL)	;POS;IMP;NOM(1,PL)accontentars
accontentarsi V;POS;IMP;NOM(2,PL)	;POS;IMP;NOM(2,PL)accontentars
accontentarsi V;POS;IMP;NOM(3,SG)	re accontentarsi V;POS;IMP;NOM
accontentarsi V;SBJV;PRS;NOM(3,SG)	re di non accontentarsi V;SBJV
accontentarsi V;SBJV;PST;NOM(1,SG)	re di non accontentarsi V;SBJV
accontentarsi V;SBJV;PST;NOM(2,SG)	re di non accontentarsi V;SBJV
addomandare V.PTCP;PRS	are V.PTCP;PRSe PRSe PRSe PRSe
addomandare V;COND;NOM(3,SG)	addomandare S;COND;NOM(3,SG)ju
addomandare V;IND;FUT;NOM(2,PL)	addomandare IND;FUT;NOM(2,PL)a
addomandare V;IND;FUT;NOM(3,PL)	addomandare V;IND;FUT;NOM(3,PL
addomandare V;IND;PRS;NOM(1,PL)	addomandare I;IND;PRS;NOM(1,PL
addomandare V;IND;PRS;NOM(1,SG)	addomandare IND;PRS;NOM(1,SG)a
addomandare V;IND;PRS;NOM(2,PL)	are I;IND;PRS;NOM(2,PL)are I;I
addomandare V;IND;PRS;NOM(3,PL)	addomandare I;IND;PRS;NOM(3,PL
addomandare V;IND;PST;IPFV;NOM(1,PL)	addomandare V;IND;PST;IPFV;NOM
addomandare V;IND;PST;IPFV;NOM(2,SG)	addomandare V;IND;PST;IPFV;NOM
addomandare V;IND;PST;IPFV;NOM(3,PL)	addomandare V;IND;PST;IPFV;NOM
addomandare V;IND;PST;PFV;NOM(1,PL)	are V;IND;PST;PFV;NOM(1,PL)add
addomandare V;IND;PST;PFV;NOM(1,SG)	addomandare (1,SG)addomandare 
addomandare V;IND;PST;PFV;NOM(2,PL)	are V;IND;PST;PFV;NOM(2,PL)add
addomandare V;IND;PST;PFV;NOM(2,SG)	addomandare addomandare addoma
addomandare V;POS;IMP;NOM(3,PL)	are IMP;NOM(3,PL)andare IMP;NO
addomandare V;SBJV;PRS;NOM(1,SG)	addomandare SBJ 1 SG 1 SG 1 SG
addomandare V;SBJV;PRS;NOM(2,PL)	addomandare V;SBJV;SBJV;SBJV;S
addomandare V;SBJV;PRS;NOM(3,SG)	addomandare SBJ SG 3 SG 3 SG 3
addomandare V;SBJV;PST;NOM(3,SG)	addomandare SBJ SBJ SG V;SBJ S
affascinare V.CVB;PRS	 a a a a a a a a a a a a a a a
affascinare V.PTCP;PST	 affascinare V.PTCP;PST;PST;PS
affascinare V;COND;NOM(2,PL)	ssa con la sua passione e la s
affascinare V;IND;FUT;NOM(1,SG)	asciare la passione e a sensua
affascinare V;IND;FUT;NOM(2,SG)	are e affascinare IND;FUT;NOM(
affascinare V;IND;FUT;NOM(3,PL)	asciare la complessita delle d
affascinare V;IND;FUT;NOM(3,SG)	are e affascinare IND;FUT;NOM(
affascinare V;IND;PRS;NOM(3,PL)	asciare la poesia della storia
affascinare V;IND;PST;IPFV;NOM(1,SG)	 di San Martino di San Martino
affascinare V;IND;PST;IPFV;NOM(2,PL)	a con la storia delle cose del
affascinare V;IND;PST;IPFV;NOM(2,SG)	 V;IND;PST;IPFV;NOM(2,SG)antic
affascinare V;IND;PST;IPFV;NOM(3,PL)	interessi nella pratica della 
affascinare V;IND;PST;IPFV;NOM(3,SG)	 V;IND;PST;IPFV;NOM(3,SG)antic
affascinare V;IND;PST;PFV;NOM(3,SG)	;PST;PFV;NOM(3,SG)antico e sen
affascinare V;POS;IMP;NOM(1,PL)	asciare la carta da visione de
affascinare V;SBJV;PRS;NOM(2,PL)	e di stile per la perfezione d
affascinare V;SBJV;PRS;NOM(3,PL)	e di stile per la pelle di sti
affascinare V;SBJV;PST;NOM(2,SG)	estate 2019 di John Willy Will
affascinare V;SBJV;PST;NOM(3,PL)	e per adulti e per amici di ca
affascinare V;SBJV;PST;NOM(3,SG)	estate 2019 di Video Porno Cas
africanizzare V.PTCP;PRS	africanizzare V.PTCP;PRSe V.PT
africanizzare V;COND;NOM(1,PL)	africanizzare V;COND;NOM(1,PL)
africanizzare V;COND;NOM(2,PL)	africanizzare V;COND;NOM(2,PL)
africanizzare V;COND;NOM(2,SG)	africanizzare africanizzare af
africanizzare V;COND;NOM(3,PL)	africanizzare V;COND;NOM(3,PL)
africanizzare V;COND;NOM(3,SG)	africanizzare V;COND;NOM(3,SG)
africanizzare V;IND;FUT;NOM(1,PL)	africanizzare V;IND;FUT;NOM(1,
africanizzare V;IND;PRS;NOM(1,PL)	africanizzare africanizzare af
africanizzare V;IND;PST;IPFV;NOM(2,SG)	africanizzare africanizzare af
africanizzare V;IND;PST;PFV;NOM(1,PL)	africanizzare V;IND;PST;PFV;NO
africanizzare V;IND;PST;PFV;NOM(3,SG)	africanizzare africanizzare af
africanizzare V;POS;IMP;NOM(2,SG)	africanizzare V;POS;IMP;NOM(2,
africanizzare V;POS;IMP;NOM(3,SG)	africanizzare V;POS;IMP;NOM(3,
africanizzare V;SBJV;PRS;NOM(1,SG)	africanizzare africanizzare af
africanizzare V;SBJV;PRS;NOM(3,PL)	africanizzare V;SBJV;PRS;NOM(3
africanizzare V;SBJV;PRS;NOM(3,SG)	africanizzare africanizzare af
africanizzare V;SBJV;PST;NOM(1,PL)	africanizzare V;SBJV;PST;NOM(1
africanizzare V;SBJV;PST;NOM(2,PL)	africanizzare V;SBJV;PST;NOM(2
africanizzare V;SBJV;PST;NOM(2,SG)	africanizzare V;SBJV;PST;NOM(2
africanizzare V;SBJV;PST;NOM(3,SG)	africanizzare V;SBJV;PST;NOM(3
arraffare V.CVB;PRS	arredare V.CVB;PRSollere V.CVB
arraffare V;COND;NOM(1,SG)	e condizionare condizionare co
arraffare V;COND;NOM(2,PL)	e V;COND;NOM(2,PL)arraffare V;
arraffare V;COND;NOM(2,SG)	a carrellata V;COND;NOM(2,SG)j
arraffare V;COND;NOM(3,SG)	a carrellata V;COND;NOM(3,SG)g
arraffare V;IND;FUT;NOM(2,PL)	are V;IND;FUT;NOM(2,PL)arredar
arraffare V;IND;FUT;NOM(2,SG)	agliarrestare e aggiornare agl
arraffare V;IND;FUT;NOM(3,PL)	a V;IND;FUT;NOM(3,PL)a starrin
arraffare V;IND;PRS;NOM(1,SG)	arrestare e arrestare arrestar
arraffare V;IND;PRS;NOM(2,PL)	e con le spalle con le spalle 
arraffare V;IND;PRS;NOM(3,SG)	arrestare e arrestare arrestar
arraffare V;IND;PST;IPFV;NOM(2,PL)	 di carrellata di carrellata d
arraffare V;IND;PST;IPFV;NOM(2,SG)	 con scarraffare e scarraffare
arraffare V;IND;PST;PFV;NOM(1,SG)	a con la parrucca del carrello
arraffare V;NFIN	arrestare V;NFINless ;NFINless
arraffare V;POS;IMP;NOM(2,SG)	e con le le le le le le le le 
arraffare V;SBJV;PRS;NOM(1,PL)	agliardare e starraffare V;SBJ
arraffare V;SBJV;PST;NOM(1,PL)	re V;SBJV;PST;NOM(1,PL)arraffa
arraffare V;SBJV;PST;NOM(2,SG)	re V;SBJV;PST;NOM(2,SG)g(2,SG)
arraffare V;SBJV;PST;NOM(3,SG)	a carraffare V;SBJV;PST;NOM(3,
asfissiare V.CVB;PRS	 CVB PRS 2017 V.CVB;PRS 2017 V
asfissiare V;COND;NOM(1,PL)	e V;COND;NOM(1,PL)asfissiare V
asfissiare V;COND;NOM(1,SG)	; sensibilis asfissiare V;COND
asfissiare V;COND;NOM(3,SG)	;NOM(3,SG)asfissiare V;COND;NO
asfissiare V;IND;FUT;NOM(1,PL)	a sfissiare V;IND;FUT;NOM;NOM;
asfissiare V;IND;FUT;NOM(1,SG)	ARE V;IND;FUT;NOM(1,SG)asfissi
asfissiare V;IND;FUT;NOM(2,PL)	;ASFISSIARE V;IND;FUT;NOM;ASFI
asfissiare V;IND;PRS;NOM(1,SG)	e S;IND;PRS;NOM(1,SG)asfissiar
asfissiare V;IND;PRS;NOM(2,SG)	e S;NOM; S;NOM; S;NOM; S;NOM; 
asfissiare V;IND;PST;IPFV;NOM(2,PL)	e sfissiare sfissiare sfissiar
asfissiare V;IND;PST;IPFV;NOM(2,SG)	e se se se se se se se se se s
asfissiare V;IND;PST;PFV;NOM(1,PL)	e se se se se se se se se se s
asfissiare V;IND;PST;PFV;NOM(1,SG)	asfissiare V;IND;PST;PFV;NOM(1
asfissiare V;IND;PST;PFV;NOM(2,PL)	e se se se se se se se se se s
asfissiare V;IND;PST;PFV;NOM(2,SG)	e se se se se se se se se se s
asfissiare V;IND;PST;PFV;NOM(3,PL)	 seminale seminale seminale se
asfissiare V;POS;IMP;NOM(2,SG)	; POS;IMP;NOM(2,SG)asfissiare 
asfissiare V;SBJV;PRS;NOM(1,SG)	S;NOM(1,SG)asfissiare V;SBJV;P
asfissiare V;SBJV;PRS;NOM(2,SG)	SG asfissiare asfissiare asfis
asfissiare V;SBJV;PST;NOM(1,PL)	asfissiare V;SBJV;PST;NOM(1,PL
chioccolare V.CVB;PRS	 1900 tardive V.CVB;PRSe 1900 
chioccolare V.PTCP;PRS	 Salmo Salmo Salmo Salmo Salmo
chioccolare V.PTCP;PST	 Parassitifera V.PTCP;PSTa Par
chioccolare V;COND;NOM(1,PL)	 PL anticorpi sui sacchari V;C
chioccolare V;COND;NOM(1,SG)	; SEED; SEED; SEED; SEED; SEED
chioccolare V;COND;NOM(2,PL)	;NOM(2,PL)are V;COND;NOM(2,PL)
chioccolare V;IND;FUT;NOM(2,SG)	OM(2,SG)a state schioccolare V
chioccolare V;IND;PST;IPFV;NOM(1,SG)	1. SG)articolato di struttura 
chioccolare V;IND;PST;PFV;NOM(1,PL)	1,PL)area schioccolare V;IND;P
chioccolare V;IND;PST;PFV;NOM(2,SG)	 SG articolato di struttura ar
chioccolare V;IND;PST;PFV;NOM(3,SG)	(3,SG)genere schioccolare V;IN
chioccolare V;POS;IMP;NOM(2,PL)	; PL PL PL PL PL PL PL PL PL P
chioccolare V;POS;IMP;NOM(3,PL)	; POS;IMP;NOM(3,PL)are V;POS;I
chioccolare V;SBJV;PRS;NOM(1,PL)	;NOM(1,PL)are are are are are 
chioccolare V;SBJV;PRS;NOM(3,PL)	; SBJ V;SBJ V;SBJ V;SBJ V;SBJ 
chioccolare V;SBJV;PST;NOM(1,PL)	 State State State State State
chioccolare V;SBJV;PST;NOM(1,SG)	Complemento di struttura schio
chioccolare V;SBJV;PST;NOM(2,PL)	Cl 1.1 1.2 1.3 1.4 1.4 1.4 1.4
chioccolare V;SBJV;PST;NOM(2,SG)	Complemento di struttura schio
chioccolare V;SBJV;PST;NOM(3,SG)	(3,SG)g)g)g)g)g)g)g)g)g)g)g)g)
colludere V.PTCP;PST	is colludere V.PTCP;PST;PST;PS
colludere V;COND;NOM(1,PL)	;COND;NOM(1,PL)annotationes co
colludere V;COND;NOM(2,SG)	;NOM(2,SG)aestimate colludere 
colludere V;IND;FUT;NOM(3,PL)	;SIG;NOM(3,PL)a colludere V;IN
colludere V;IND;FUT;NOM(3,SG)	;FUT;NOM(3,SG)a colludere V;IN
colludere V;IND;PRS;NOM(2,SG)	;PRS;NOM(2,SG)aestimare collud
colludere V;IND;PRS;NOM(3,SG)	;PRS;NOM(3,SG)a colludere coll
colludere V;IND;PST;IPFV;NOM(2,SG)	;IPFV;NOM(2,SG)a colludere V;I
colludere V;IND;PST;PFV;NOM(1,PL)	;PFV;NOM(1,PL)a colludere V;IN
colludere V;IND;PST;PFV;NOM(2,PL)	omini colludere V;IND;PST;PFV;
colludere V;IND;PST;PFV;NOM(2,SG)	;PFV;NOM(2,SG)a colludere a co
colludere V;IND;PST;PFV;NOM(3,PL)	;PFV;NOM(3,PL)a colludere V;IN
colludere V;IND;PST;PFV;NOM(3,SG)	;PFV;NOM(3,SG)a colludere V;IN
colludere V;POS;IMP;NOM(1,PL)	estis colludere colludere coll
colludere V;POS;IMP;NOM(3,SG)	(3,SG)sere colludere colludere
colludere V;SBJV;PRS;NOM(1,PL)	;NOM(1,PL)a colludere V;SBJV;S
colludere V;SBJV;PRS;NOM(1,SG)	;NOM(1,SG)a;NOM(1,SG)a;NOM(1,S
colludere V;SBJV;PST;NOM(1,PL)	ominis colludere V;SBJV;PST;NO
colludere V;SBJV;PST;NOM(2,PL)	ominibus colludere V;SBJV;PST;
colludere V;SBJV;PST;NOM(3,SG)	(1,SG)garriare colludere collu
convenzionare V;COND;NOM(2,PL)	expresie convenzionare convenz
convenzionare V;COND;NOM(3,PL)	convenzionare V;COND;NOM(3,PL)
convenzionare V;COND;NOM(3,SG)	convenzionare convenzionare co
convenzionare V;IND;FUT;NOM(1,SG)	convenienti convenienti conven
convenzionare V;IND;FUT;NOM(2,SG)	convenienti cu convenienti cu 
convenzionare V;IND;FUT;NOM(3,SG)	convenienti cu convenienti cu 
convenzionare V;IND;PRS;NOM(3,SG)	convenienta convenienta conven
convenzionare V;IND;PST;IPFV;NOM(1,PL)	convenienta convenienta conven
convenzionare V;IND;PST;IPFV;NOM(1,SG)	convenientare V;IND;PST;IPFV;N
convenzionare V;IND;PST;IPFV;NOM(2,SG)	convenienta convenienta conven
convenzionare V;IND;PST;IPFV;NOM(3,SG)	 convenienta convenienta conve
convenzionare V;IND;PST;PFV;NOM(1,PL)	convenienta convenienta conven
convenzionare V;IND;PST;PFV;NOM(1,SG)	distribuie convenienta conveni
convenzionare V;IND;PST;PFV;NOM(2,SG)	convenienta convenienta conven
convenzionare V;IND;PST;PFV;NOM(3,PL)	convenienta convenienta conven
convenzionare V;POS;IMP;NOM(3,SG)	are V;POS;IMP;NOM(3,SG)are V;P
convenzionare V;SBJV;PRS;NOM(2,PL)	are V;SBJV;PRS;NOM(2,PL)are V;
convenzionare V;SBJV;PRS;NOM(3,PL)	are V;SBJV;PRS;NOM(3,PL)are V;
convenzionare V;SBJV;PST;NOM(1,PL)	convenienta convenienta conven
convenzionare V;SBJV;PST;NOM(3,PL)	are convenienta convenienta co
dipingere V.CVB;PRS	e V.CVB;PRS.PRS.PRS.PRS.PRS.PR
dipingere V;COND;NOM(2,PL)	e dipingere dipingere dipinger
dipingere V;IND;FUT;NOM(1,SG)	ere V;IND;FUT;NOM(1,SG)gere V;
dipingere V;IND;FUT;NOM(3,SG)	ere V;IND;FUT;NOM(3,SG)gere V;
dipingere V;IND;PRS;NOM(1,PL)	e V;IND;PRS;NOM(1,PL)a dipinge
dipingere V;IND;PRS;NOM(3,SG)	e V;IND;PRS;NOM(3,SG)gere V;IN
dipingere V;IND;PST;IPFV;NOM(1,SG)	e e e e e e e e e e e e e e e 
dipingere V;IND;PST;IPFV;NOM(2,PL)	ere dipingere dipingere diping
dipingere V;IND;PST;IPFV;NOM(2,SG)	e e e e e e e e e e e e e e e 
dipingere V;IND;PST;IPFV;NOM(3,PL)	ere dipingere dipingere diping
dipingere V;IND;PST;IPFV;NOM(3,SG)	e e e e e e e e e e e e e e e 
dipingere V;IND;PST;PFV;NOM(1,PL)	ere dipingere dipingere diping
dipingere V;IND;PST;PFV;NOM(1,SG)	e e e e e e e e e e e e e e e 
dipingere V;IND;PST;PFV;NOM(2,PL)	ere dipingere dipingere diping
dipingere V;IND;PST;PFV;NOM(3,PL)	ere dipingere dipingere diping
dipingere V;POS;IMP;NOM(2,PL)	e dipingere dipingere dipinger
dipingere V;SBJV;PRS;NOM(1,PL)	ere dipingere dipingere diping
dipingere V;SBJV;PRS;NOM(2,PL)	ere dipingere dipingere diping
dipingere V;SBJV;PRS;NOM(2,SG)	ere dipingere dipingere diping
dipingere V;SBJV;PST;NOM(1,PL)	ere V;SBJV;PST;NOM(1,PL)gere V
giostrare V.CVB;PRS	 supra giostrare V.CVB;PRSgios
giostrare V.PTCP;PRS	 are V.PTCP;PRSe V.PTCP;PRSe V
giostrare V;COND;NOM(1,SG)	a strare V;COND;NOM(1,SG)a str
giostrare V;COND;NOM(2,PL)	a V;COND;NOM(2,PL)a,PLa,PLa,PL
giostrare V;COND;NOM(3,SG)	a strare V;COND;NOM(3,SG)giost
giostrare V;IND;FUT;NOM(1,SG)	a strare V;IND;FUT;NOM(1,SG)gi
giostrare V;IND;PRS;NOM(1,PL)	;PRS;NOM(1,PL)are V;IND;PRS;NO
giostrare V;IND;PRS;NOM(1,SG)	are V;IND;PRS;NOM(1,SG)giostra
giostrare V;IND;PRS;NOM(2,PL)	;PRS;NOM(2,PL)are V;IND;PRS;NO
giostrare V;IND;PRS;NOM(3,PL)	;PRS;NOM(3,PL)agiostrare V;IND
giostrare V;IND;PRS;NOM(3,SG)	a strare V;IND;PRS;NOM(3,SG)gi
giostrare V;IND;PST;IPFV;NOM(1,PL)	a artistrare V;IND;PST;IPFV;NO
giostrare V;IND;PST;IPFV;NOM(2,PL)	a maestri de giostrare V;IND;P
giostrare V;IND;PST;PFV;NOM(2,SG)	a ordine de ordine de ordine d
giostrare V;IND;PST;PFV;NOM(3,PL)	a artistrare V;IND;PST;PFV;NOM
giostrare V;IND;PST;PFV;NOM(3,SG)	(3,SG)artista si maestra si ma
giostrare V;POS;IMP;NOM(2,SG)	 a la sua alma mater es alma m
giostrare V;SBJV;PRS;NOM(2,SG)	(2,SG)giostrare V;SBJV;PRS;NOM
giostrare V;SBJV;PRS;NOM(3,SG)	(3,SG)giostrare V;SBJV;PRS;NOM
giostrare V;SBJV;PST;NOM(3,PL)	e V;SBJV;PST;NOM(3,PL)a Maestr
guarnire V.PTCP;PRS	 V.PTCP;PRSe V.PTCP;PRSe V.PTC
guarnire V;COND;NOM(2,PL)	e V;COND;NOM(2,PL)anire V;COND
guarnire V;COND;NOM(2,SG)	a de la Roman V;COND;NOM(2,SG)
guarnire V;COND;NOM(3,SG)	a sub lumina de la sub lumina 
guarnire V;IND;FUT;NOM(1,PL)	estre 2017 - 10 septembrie 201
guarnire V;IND;FUT;NOM(2,PL)	estre de la V;IND;FUT;NOM(2,PL
guarnire V;IND;PRS;NOM(1,PL)	estrada de la sommerse de la s
guarnire V;IND;PRS;NOM(2,PL)	estrada de la sommerse de la s
guarnire V;IND;PRS;NOM(3,PL)	estrada de la sommersion de la
guarnire V;IND;PRS;NOM(3,SG)	re de la sombra del castro de 
guarnire V;IND;PST;IPFV;NOM(3,PL)	estrada de la societate con so
guarnire V;IND;PST;IPFV;NOM(3,SG)	estructura de activitate de ac
guarnire V;IND;PST;PFV;NOM(2,PL)	estre 2017 - 18:00 - Articole 
guarnire V;IND;PST;PFV;NOM(3,SG)	e de la somma de la mucha de l
guarnire V;POS;IMP;NOM(2,PL)	re V;POS;IMP;NOM(2,PL)arnire V
guarnire V;SBJV;PRS;NOM(1,PL)	re de la sombra del capot del 
guarnire V;SBJV;PRS;NOM(2,SG)	re V;SBJV;PRS;NOM(2,SG)guarnir
guarnire V;SBJV;PST;NOM(2,PL)	estre de la serie de camionete
guarnire V;SBJV;PST;NOM(3,PL)	e de la societate con la casa 
guarnire V;SBJV;PST;NOM(3,SG)	re a la societate con la carta
imborghesirsi V.CVB;PRS	 PRS S S S S S S S S S S S S S
imborghesirsi V;COND;NOM(1,PL)	 Simborghesirsi Simborghesirsi
imborghesirsi V;COND;NOM(1,SG)	(1,SG)ghesirsi V;COND;NOM(1,SG
imborghesirsi V;COND;NOM(2,PL)	 Simborghesirsi Simborghesirsi
imborghesirsi V;COND;NOM(2,SG)	 S I M B R I M N I R I R I R I
imborghesirsi V;COND;NOM(3,PL)	 Simborghesirsi Simborghesirsi
imborghesirsi V;IND;FUT;NOM(1,SG)	;STAR;STAR;STAR;STAR;STAR;STAR
imborghesirsi V;IND;PRS;NOM(2,SG)	 SG I M B R G H E S I M B R H 
imborghesirsi V;IND;PST;IPFV;NOM(2,PL)	 (2,PL)ghesirsi (2,PL)ghesirsi
imborghesirsi V;IND;PST;PFV;NOM(1,PL)	 (1,PL)ghesirsi (1,PL)ghesirsi
imborghesirsi V;IND;PST;PFV;NOM(1,SG)	 (1,SG)ghesirsi (1,SG)ghesirsi
imborghesirsi V;POS;IMP;NOM(1,PL)	;NOM(1,PL)ghesirsi V;POS;IMP;N
imborghesirsi V;POS;IMP;NOM(2,SG)	(2,SG)ghesirsi V;POS;IMP;NOM(2
imborghesirsi V;POS;IMP;NOM(3,PL)	(3,PL)ghesirsi V;POS;IMP;NOM(3
imborghesirsi V;POS;IMP;NOM(3,SG)	(3,SG)ghesirsi V;POS;IMP;NOM(3
imborghesirsi V;SBJV;PRS;NOM(1,PL)	;SBJV;PRS;NOM(1,PL)ghesirsi V;
imborghesirsi V;SBJV;PRS;NOM(1,SG)	;NOM(1,SG)ghesirsirsirsirsirsi
imborghesirsi V;SBJV;PRS;NOM(2,SG)	;NOM(2,SG)ghesirsi V;SBJV;PRS;
imborghesirsi V;SBJV;PRS;NOM(3,PL)	 SBJ V;SBJ V;PRS;NOM(3,PL)ghes
imborghesirsi V;SBJV;PST;NOM(3,PL)	 Palatino Palatino Palatino Pa
impadronirsi V.CVB;PRS	 V.CVB;PRSdi V.CVB;PRSdi V.CVB
impadronirsi V.PTCP;PST	 PTCP;PST;PST;PST;PST;PST;PST;
impadronirsi V;COND;NOM(1,PL)	adilan setelah memadranirsi V;
impadronirsi V;COND;NOM(2,SG)	a sa pada padre di mana padre 
impadronirsi V;COND;NOM(3,PL)	adilagi sedia mempadranirsi da
impadronirsi V;IND;FUT;NOM(3,PL)	mpadrinirsi V;IND;FUT;NOM(3,PL
impadronirsi V;IND;FUT;NOM(3,SG)	mana sedang memadranirsi IND;F
impadronirsi V;IND;PRS;NOM(3,PL)	anak perempetan si perempetan 
impadronirsi V;IND;PST;IPFV;NOM(3,PL)	 mengantar perempat gereja (3,
impadronirsi V;IND;PST;PFV;NOM(1,PL)	a bersama saya dan saya dan sa
impadronirsi V;IND;PST;PFV;NOM(1,SG)	a seni berseni berseni berseni
impadronirsi V;IND;PST;PFV;NOM(2,SG)	a seni berseni berseni berseni
impadronirsi V;POS;IMP;NOM(3,SG)	a sa i V;POS;IMP;NOM(3,SG)g g 
impadronirsi V;SBJV;PRS;NOM(2,PL)	impadrenirsi V;SBJV;PRS;NOM(2,
impadronirsi V;SBJV;PRS;NOM(2,SG)	impadronirsi S;NOM(2,SG)gimpad
impadronirsi V;SBJV;PRS;NOM(3,SG)	impadronirsi S;NOM(3,SG)gimpad
impadronirsi V;SBJV;PST;NOM(2,PL)	a dan bersama dengan dengan de
impadronirsi V;SBJV;PST;NOM(2,SG)	ing dari persiapan setelah per
impadronirsi V;SBJV;PST;NOM(3,PL)	a dan bersama dengan dengan de
impadronirsi V;SBJV;PST;NOM(3,SG)	ing dan selama ini semua di at
impermeabilizzare V.CVB;PRS	 impermeabilizzare V.CVB;PRSdi
impermeabilizzare V.PTCP;PST	 impermeabilizzare V.PTCP;PSTa
impermeabilizzare V;COND;NOM(2,PL)	;COND;NOM; impermeabilizzare V
impermeabilizzare V;COND;NOM(2,SG)	impermeabilizzare V;COND;NOM(2
impermeabilizzare V;IND;FUT;NOM(2,PL)	idea di impermeabilizzare V;IN
impermeabilizzare V;IND;FUT;NOM(2,SG)	idea di impermeabilizzare V;IN
impermeabilizzare V;IND;FUT;NOM(3,PL)	idea di impermeabilizzare V;IN
impermeabilizzare V;IND;FUT;NOM(3,SG)	impermeabilizzare V;IND;FUT;NO
impermeabilizzare V;IND;PRS;NOM(1,PL)	impermeabilizzare V;IND;PRS;NO
impermeabilizzare V;IND;PRS;NOM(2,SG)	impermeabilizzare V;IND;PRS;NO
impermeabilizzare V;IND;PST;IPFV;NOM(1,PL)	 impermeabilizzare V;IND;PST;I
impermeabilizzare V;IND;PST;IPFV;NOM(2,SG)	 e resistenza alla carta da st
impermeabilizzare V;IND;PST;PFV;NOM(2,SG)	ricevere e ricevere carta da p
impermeabilizzare V;IND;PST;PFV;NOM(3,PL)	 impermeabilizzare V;IND;PST;P
impermeabilizzare V;IND;PST;PFV;NOM(3,SG)	 impermeabilizzare V;IND;PST;P
impermeabilizzare V;NFIN	impermeabilizzare V;NFINEINEIN
impermeabilizzare V;POS;IMP;NOM(3,PL)	;POS;IMP;NOM;NOM;NOM;NOM;NOM;N
impermeabilizzare V;POS;IMP;NOM(3,SG)	are e riscaldare impermeabiliz
impermeabilizzare V;SBJV;PST;NOM(1,SG)	are ed impermeabilizzare V;SBJ
impermeabilizzare V;SBJV;PST;NOM(3,SG)	 impermeabilizzare V;SBJV;PST;
impingere V.CVB;PRS	ere V.CVB;PRSere V.CVB;PRSere 
impingere V;COND;NOM(2,PL)	e mpingere mpingere mpingere m
impingere V;COND;NOM(3,PL)	e mpingere mpingere mpingere m
impingere V;IND;FUT;NOM(2,PL)	e V;IND;FUT;NOM(2,PL)a pingere
impingere V;IND;FUT;NOM(2,SG)	e V;IND;FUT;NOM(2,SG)a SG a SG
impingere V;IND;PRS;NOM(1,SG)	ere IMPINGERE IMPINGERE IMPING
impingere V;IND;PRS;NOM(3,SG)	ere IMPINGERE IMPINGERE IMPING
impingere V;IND;PST;IPFV;NOM(3,PL)	ere V;IND;PST;IPFV;NOM(3,PL)am
impingere V;IND;PST;PFV;NOM(2,PL)	ere V;IND;PST;PFV;NOM(2,PL)amp
impingere V;IND;PST;PFV;NOM(2,SG)	ere V;IND;PST;PFV;NOM(2,SG)jmp
impingere V;NFIN	impingere V;NFINgere V;NFINger
impingere V;POS;IMP;NOM(2,PL)	e V;POS;IMP;NOM(2,PL)are V;POS
impingere V;SBJV;PRS;NOM(1,PL)	ere V;SBJV;PRS;NOM(1,PL)are V;
impingere V;SBJV;PRS;NOM(2,PL)	ere V;SBJV;PRS;NOM(2,PL)amping
impingere V;SBJV;PRS;NOM(2,SG)	ere V;SBJV;PRS;NOM(2,SG)gere V
impingere V;SBJV;PRS;NOM(3,PL)	ere V;SBJV;PRS;NOM(3,PL)amping
impingere V;SBJV;PST;NOM(1,PL)	ere V;SBJV;PST;NOM(1,PL)amping
impingere V;SBJV;PST;NOM(2,SG)	ere V;SBJV;PST;NOM(2,SG)amping
impingere V;SBJV;PST;NOM(3,PL)	ere V;SBJV;PST;NOM(3,PL)amping
impingere V;SBJV;PST;NOM(3,SG)	ere V;SBJV;PST;NOM(3,SG)gere V
increspare V.CVB;PRS	angerate V.CVB;PRSangerate V.C
increspare V.PTCP;PRS	 P.PTCP;PRSmare P.PTCP;PRSmare
increspare V.PTCP;PST	increspare P.PTCP;PSTstare P.P
increspare V;COND;NOM(1,PL)	erespare COND;NOM(1,PL)and PLa
increspare V;COND;NOM(1,SG)	are increspare increspare incr
increspare V;COND;NOM(3,PL)	erespare COND;NOM(3,PL)arespar
increspare V;COND;NOM(3,SG)	and see the season of the seas
increspare V;IND;FUT;NOM(1,PL)	ended increspare V;IND;FUT;NOM
increspare V;IND;FUT;NOM(1,SG)	 respare IND;FUT;NOM(1,SG)a re
increspare V;IND;FUT;NOM(3,SG)	 IND;FUT;NOM(3,SG)a respare V;
increspare V;IND;PRS;NOM(1,SG)	respare INCRESPARE INCRESPARE 
increspare V;IND;PRS;NOM(2,PL)	erespare I I I I I I I I I I I
increspare V;IND;PRS;NOM(3,SG)	respare INCRESPARE INCRESPARE 
increspare V;IND;PST;IPFV;NOM(1,SG)	e spare V;IND;PST;IPFV;NOM(1,S
increspare V;IND;PST;IPFV;NOM(2,SG)	e spare V;IND;PST;IPFV;NOM(2,S
increspare V;NFIN	increspare Increspare Increspa
increspare V;POS;IMP;NOM(3,PL)	e spare spare spare spare spar
increspare V;SBJV;PRS;NOM(2,PL)	e spare spare spare spare spar
increspare V;SBJV;PST;NOM(2,SG)	erespare Spare Spare Spare Spa
increspare V;SBJV;PST;NOM(3,SG)	erespare SPARE SPARE SPARE SPA
indebolirsi V.PTCP;PST	ebolirsi V.PTCP;PST;PST;PST;PS
indebolirsi V;COND;NOM(2,SG)	indebolirsi Indebolirsi Indebo
indebolirsi V;COND;NOM(3,PL)	ndebolirsi P;COND;NOM(3,PL)deb
indebolirsi V;COND;NOM(3,SG)	indebolirsi Indebolirsi Indebo
indebolirsi V;IND;PRS;NOM(1,SG)	ndebolirsi IND;PRS;NOM(1,SG)in
indebolirsi V;IND;PST;IPFV;NOM(2,SG)	ndebolirsi IND;PST;IPFV;NOM(2,
indebolirsi V;IND;PST;IPFV;NOM(3,PL)	ndebolirsi V;IND;PST;IPFV;NOM(
indebolirsi V;IND;PST;IPFV;NOM(3,SG)	(2,SG)game indebolirsi (3,SG)g
indebolirsi V;IND;PST;PFV;NOM(1,PL)	ndebolirsi IND;PST;PFV;NOM(1,P
indebolirsi V;IND;PST;PFV;NOM(1,SG)	ndebolirsi IND;PST;PFV;NOM(1,S
indebolirsi V;IND;PST;PFV;NOM(3,PL)	indebolirsi IND;PST;PFV;NOM(3,
indebolirsi V;IND;PST;PFV;NOM(3,SG)	ndebolirsi (3,SG)gambar indebo
indebolirsi V;POS;IMP;NOM(1,PL)	E(1,PL)andebolirsi I;POS;IMP;N
indebolirsi V;POS;IMP;NOM(2,PL)	INDEBOLIRSI INDEBOLIRSI INDEBO
indebolirsi V;POS;IMP;NOM(3,PL)	INDEBOLIRSI INDEBOLIRSI INDEBO
indebolirsi V;SBJV;PRS;NOM(1,SG)	indebolirsi SBJV;PRS;NOM(1,SG)
indebolirsi V;SBJV;PRS;NOM(2,SG)	indebolirsi SBJV;PRS;NOM(2,SG)
indebolirsi V;SBJV;PRS;NOM(3,SG)	indebolirsi SBJV;PRS;NOM(3,SG)
indebolirsi V;SBJV;PST;NOM(2,SG)	indebolirsi SBJV;PST;NOM(2,SG)
indebolirsi V;SBJV;PST;NOM(3,PL)	ebolirsi V;SBJV;PST;NOM(3,PL)g
infettare V.PTCP;PRS	ettoriale di sintomatologia pr
infettare V.PTCP;PST	 con antenati anticorpi antich
infettare V;COND;NOM(2,PL)	ettari infettare V;COND;NOM(2,
infettare V;IND;FUT;NOM(1,PL)	allergologia epatica con conta
infettare V;IND;FUT;NOM(2,PL)	e V;IND;FUT;NOM(2,PL)a infetta
infettare V;IND;FUT;NOM(3,PL)	;NOM(3,PL)a con infettare V;IN
infettare V;IND;PRS;NOM(2,SG)	 2,SG 2,SG 2,SG 2,SG 2,SG 2,SG
infettare V;IND;PST;IPFV;NOM(2,SG)	ettardi e differenziare IND;PS
infettare V;IND;PST;PFV;NOM(1,PL)	1,PL)antinfettiva (1,PL)antinf
infettare V;IND;PST;PFV;NOM(2,PL)	 2,PL 2,PL 3,PL 4,PL 5,PL 6,PL
infettare V;IND;PST;PFV;NOM(3,SG)	e sono infettivi e infiammator
infettare V;POS;IMP;NOM(2,SG)	e di contagio con la partecipa
infettare V;POS;IMP;NOM(3,PL)	ettare V;POS;IMP;NOM(3,PL)bett
infettare V;SBJV;PRS;NOM(1,PL)	 1 2 3 4 5 6 7 8 9 10 11 12 13
infettare V;SBJV;PRS;NOM(1,SG)	e di contagesette di acacia di
infettare V;SBJV;PRS;NOM(3,PL)	 2011 1 2 V;SBJV;PRS;NOM(3,PL)
infettare V;SBJV;PRS;NOM(3,SG)	 per la prima infettare V;SBJV
infettare V;SBJV;PST;NOM(1,PL)	 2019 1 2 1 1 1 1 1 1 1 1 1 1 
infettare V;SBJV;PST;NOM(2,PL)	 2014 10 11 12 13 14 15 16 17 
infettare V;SBJV;PST;NOM(3,PL)	 1.1 microbiota che possa esse
lacerarsi V.CVB;PRS	a con la pared de la pared de 
lacerarsi V.PTCP;PRS	is ad lacerarsi V.PTCP;PRSma V
lacerarsi V;COND;NOM(1,SG)	acerarsi V;COND;NOM(1,SG)ganar
lacerarsi V;IND;FUT;NOM(1,PL)	a pilacerarsi V;IND;FUT;NOM(1,
lacerarsi V;IND;FUT;NOM(2,SG)	a para para para para para par
lacerarsi V;IND;FUT;NOM(3,PL)	a para pilacerarsi V;IND;FUT;N
lacerarsi V;IND;FUT;NOM(3,SG)	A(3,SG)arsi V;IND;FUT;NOM(3,SG
lacerarsi V;IND;PRS;NOM(2,SG)	arsi V;IND;PRS;NOM(2,SG)i V;IN
lacerarsi V;IND;PST;IPFV;NOM(2,SG)	alacerarse V;IND;PST;IPFV;NOM(
lacerarsi V;IND;PST;IPFV;NOM(3,SG)	alacerarse V;IND;PST;IPFV;NOM(
lacerarsi V;IND;PST;PFV;NOM(1,SG)	alacerarsi (1,SG)alacerarsi (1
lacerarsi V;IND;PST;PFV;NOM(3,SG)	(2,1,SG)v;ind;pst;pfv;nom(3,1,
lacerarsi V;POS;IMP;NOM(2,SG)	arsi P;POS;IMP;NOM(2,SG)imp;NO
lacerarsi V;POS;IMP;NOM(3,PL)	arsi PL;POS;IMP;NOM(3,PL)acera
lacerarsi V;POS;IMP;NOM(3,SG)	arsi P;POS;IMP;NOM(3,SG)g;NOM(
lacerarsi V;SBJV;PRS;NOM(1,PL)	acerarsi (1,PL)acerarsi (1,PL)
lacerarsi V;SBJV;PRS;NOM(1,SG)	arsi Para la pacerarsi Pacerar
lacerarsi V;SBJV;PRS;NOM(2,PL)	acerarsi PL acerarsi PL acerar
lacerarsi V;SBJV;PST;NOM(1,SG)	a de la parada de la parada de
lacerarsi V;SBJV;PST;NOM(2,SG)	a de la calle de la acalle de 
limitare V.PTCP;PRS	 de la proportionalitate de la
limitare V;COND;NOM(2,PL)	(2,PL)are V;COND;NOM(2,PL)are 
limitare V;COND;NOM(3,PL)	(3,PL)analizare de limitare de
limitare V;COND;NOM(3,SG)	imitare V;COND;NOM(3,SG)are li
limitare V;IND;FUT;NOM(1,PL)	INTERNATIONAL;FUT;NOM(1,PL)ana
limitare V;IND;FUT;NOM(2,PL)	INTERNATIONAL;FUT;NOM(2,PL)ana
limitare V;IND;FUT;NOM(3,PL)	INTERNATIONAL;FUT;NOM(3,PL)ana
limitare V;IND;PRS;NOM(1,PL)	;PRS;NOM(1,PL)ase limitare V;I
limitare V;IND;PRS;NOM(2,PL)	imitare PRS;NOM(2,PL)ase limit
limitare V;IND;PRS;NOM(3,PL)	;PRS;NOM(3,PL)ase limitare V;I
limitare V;IND;PST;IPFV;NOM(3,SG)	 contract contract contract co
limitare V;IND;PST;PFV;NOM(2,SG)	indicatii control limitare si 
limitare V;IND;PST;PFV;NOM(3,PL)	;PST;PFV;NOM(3,PL)a calitate l
limitare V;POS;IMP;NOM(1,PL)	INTEGRALE PL a limitare PL a l
limitare V;POS;IMP;NOM(2,PL)	 limitare PL limitare PL limit
limitare V;POS;IMP;NOM(2,SG)	est considerat un segment de l
limitare V;SBJV;PRS;NOM(1,SG)	imitare limitare limitare limi
limitare V;SBJV;PRS;NOM(3,SG)	imitare V;SBJV;PRS;NOM(3,SG)im
limitare V;SBJV;PST;NOM(2,SG)	imitare V;SBJV;PST;NOM(2,SG)g 
limitare V;SBJV;PST;NOM(3,PL)	;T;NOM(3,PL)amitare V;SBJV;PST
masturbare V.PTCP;PRS	e cu penis masturbare V.PTCP;P
masturbare V.PTCP;PST	 masturbare V.PTCP;PST pare ma
masturbare V;COND;NOM(1,PL)	masturbare masturbare masturba
masturbare V;COND;NOM(2,PL)	masturbare V;COND;NOM(2,PL)mas
masturbare V;COND;NOM(2,SG)	masturbare V;COND;NOM(2,SG)mas
masturbare V;COND;NOM(3,SG)	masturbare V;COND;NOM(3,SG)mas
masturbare V;IND;FUT;NOM(2,SG)	bare V;IND;FUT;NOM(2,SG)asturb
masturbare V;IND;FUT;NOM(3,PL)	bare V;IND;FUT;NOM(3,PL)asturb
masturbare V;IND;FUT;NOM(3,SG)	bare V;IND;FUT;NOM(3,SG)gangba
masturbare V;IND;PST;IPFV;NOM(1,SG)	e V;IND;PST;IPFV;NOM(1,SG)anal
masturbare V;IND;PST;IPFV;NOM(3,PL)	bare V;IND;PST;IPFV;NOM(3,PL)a
masturbare V;IND;PST;PFV;NOM(1,SG)	e masturbare V;IND;PST;PFV;NOM
masturbare V;IND;PST;PFV;NOM(2,SG)	e masturbare V;IND;PST;PFV;NOM
masturbare V;POS;IMP;NOM(2,SG)	i masturbare masturbare mastur
masturbare V;POS;IMP;NOM(3,PL)	e V;POS;IMP;NOM(3,PL)asturbare
masturbare V;SBJV;PRS;NOM(1,SG)	e masturbare masturbare mastur
masturbare V;SBJV;PRS;NOM(2,PL)	e V;SBJV;PRS;NOM(2,PL)ass mast
masturbare V;SBJV;PRS;NOM(2,SG)	e masturbare masturbare mastur
masturbare V;SBJV;PRS;NOM(3,PL)	e V;SBJV;PRS;NOM(3,PL)ass mast
masturbare V;SBJV;PST;NOM(1,PL)	e masturbare V;SBJV;PST;NOM(1,
mercificare V.CVB;PRS	 Comision achizitionare Comisi
mercificare V.PTCP;PRS	 cu acte de comercializare a c
mercificare V.PTCP;PST	 a fost a fost a fost a fost a
mercificare V;COND;NOM(1,SG)	are are trebuie sa comercializ
mercificare V;COND;NOM(2,PL)	are V;COND;NOM(2,PL)are COND;N
mercificare V;COND;NOM(2,SG)	are are de a comercializa are 
mercificare V;COND;NOM(3,PL)	are V;COND;NOM(3,PL)are are a
mercificare V;COND;NOM(3,SG)	are COND;NOM(3,SG)are comercif
mercificare V;IND;FUT;NOM(2,SG)	are V;IND;FUT;NOM(2,SG)are IND
mercificare V;IND;FUT;NOM(3,PL)	;NOM(3,PL)aceste comercifaceri
mercificare V;IND;PRS;NOM(2,PL)	are IND;PRS;NOM(2,PL)agricultu
mercificare V;IND;PST;IPFV;NOM(2,SG)	arta si contact arta si contac
mercificare V;IND;PST;PFV;NOM(2,PL)	are de comercifare V;IND;PST;P
mercificare V;IND;PST;PFV;NOM(3,PL)	arta si comercializare a comer
mercificare V;POS;IMP;NOM(2,SG)	are V;POS;IMP;NOM(2,SG)are V;P
mercificare V;POS;IMP;NOM(3,PL)	are V;POS;IMP;NOM(3,PL)are V;P
mercificare V;SBJV;PRS;NOM(2,SG)	are are de a avea de a avea a 
mercificare V;SBJV;PST;NOM(1,PL)	are a comercificare a comercif
mercificare V;SBJV;PST;NOM(2,SG)	are de comercificare V;SBJV;PS
mercificare V;SBJV;PST;NOM(3,SG)	are de comercificare de comerc
naturalizzarsi V.CVB;PRS	alizzarsi V.CVB;PRS;PRS;PRS;PR
naturalizzarsi V.PTCP;PRS	alizzarsi V.PTCP;PRSE;PRSSE;PR
naturalizzarsi V.PTCP;PST	 V.PTCP;PST;PST;PST;PST;PST;PS
naturalizzarsi V;COND;NOM(2,PL)	alizzarsi V;COND;NOM(2,PL)aliz
naturalizzarsi V;COND;NOM(3,PL)	alizzarsi V;COND;NOM(3,PL)atti
naturalizzarsi V;IND;FUT;NOM(1,PL)	alizzarsi V;IND;FUT;NOM;NAT;NA
naturalizzarsi V;IND;FUT;NOM(3,PL)	alizzarsi V;IND;FUT;NOM;NOM;NO
naturalizzarsi V;IND;FUT;NOM(3,SG)	alizzarsi V;IND;FUT;NOM;NAT;NA
naturalizzarsi V;IND;PRS;NOM(1,PL)	alizzarsi V;IND;PRS;NOM(1,PL)g
naturalizzarsi V;IND;PRS;NOM(2,PL)	alizzarsi V;IND;PRS;NOM(2,PL)g
naturalizzarsi V;IND;PRS;NOM(2,SG)	alizzarsi e distinguere le div
naturalizzarsi V;IND;PRS;NOM(3,SG)	alizzarsi IND;PRS;NOM(3,SG)gen
naturalizzarsi V;IND;PST;IPFV;NOM(2,PL)	alizzarsi V;IND;PST;IPFV;NOM(2
naturalizzarsi V;NFIN	naturalizzarsi V;NFINFINFINFIN
naturalizzarsi V;POS;IMP;NOM(3,PL)	alizzarsi e denaturarsi alizza
naturalizzarsi V;SBJV;PRS;NOM(1,PL)	alizzarsi V;SBJV;PRS;NOM(1,PL)
naturalizzarsi V;SBJV;PRS;NOM(3,PL)	alizzarsi V;SBJV;PRS;NOM(3,PL)
naturalizzarsi V;SBJV;PRS;NOM(3,SG)	alizzarsi V;SBJV;PRS;NOM(3,SG)
naturalizzarsi V;SBJV;PST;NOM(2,SG)	alizzarsi V;SBJV;PST;NOM(2,SG)
naturalizzarsi V;SBJV;PST;NOM(3,SG)	alizzarsi V;SBJV;PST;NOM(3,SG)
oscillare V.CVB;PRS	ae V.CVB;PRSae V.CVB;PRSae V.C
oscillare V.PTCP;PRS	 PTCP;PRSe PTCP PRSe PRSe PRSe
oscillare V;COND;NOM(1,SG)	;COND;NOM(1,SG)ae V;COND;NOM(1
oscillare V;COND;NOM(2,PL)	a continua continua continua c
oscillare V;IND;FUT;NOM(1,SG)	eposcare V;IND;FUT;NOM(1,SG)ge
oscillare V;IND;FUT;NOM(2,PL)	;NOM;NOM;NOM;NOM;NOM;NOM;NOM;N
oscillare V;IND;FUT;NOM(3,PL)	;NOM;NOM;NOM;NOM;NOM;NOM;NOM;N
oscillare V;IND;PRS;NOM(1,PL)	a consonante V;IND;PRS;NOM(1,P
oscillare V;IND;PRS;NOM(1,SG)	epistola ad proscriptam sacram
oscillare V;IND;PRS;NOM(3,PL)	a consonante V;IND;PRS;NOM(3,P
oscillare V;IND;PST;IPFV;NOM(1,PL)	a proscripta seria sur la sua 
oscillare V;IND;PST;IPFV;NOM(3,SG)	a proscripta sensitiva sensiti
oscillare V;IND;PST;PFV;NOM(2,SG)	a proscripta sulla serie V;IND
oscillare V;POS;IMP;NOM(3,PL)	EP;NOM(3,PL)ante poscillare V;
oscillare V;POS;IMP;NOM(3,SG)	INF; POS;IMP;NOM(3,SG)ae V;POS
oscillare V;SBJV;PRS;NOM(1,PL)	 proscripta serie superiore su
oscillare V;SBJV;PRS;NOM(3,PL)	 proscripta serie superiore su
oscillare V;SBJV;PST;NOM(2,PL)	 capite super super super supe
oscillare V;SBJV;PST;NOM(2,SG)	e consectetura sensu libero se
oscillare V;SBJV;PST;NOM(3,PL)	 capite super se poscere V;SBJ
ossequiare V.CVB;PRS	a recta secunda secunda secund
ossequiare V.PTCP;PST	 se se se se se se se se se se
ossequiare V;COND;NOM(2,SG)	aessequiare V;COND;NOM(2,SG)ae
ossequiare V;IND;FUT;NOM(2,PL)	e ssequiare V;IND;FUT;NOM
sseq
ossequiare V;IND;PRS;NOM(1,PL)	ae sussequiare V;IND;PRS;NOM
S
ossequiare V;IND;PRS;NOM(3,SG)	e sensu sensu sensu sensu sens
ossequiare V;IND;PST;IPFV;NOM(1,PL)	;PST;IPFV;NOM
Section allosseq
ossequiare V;IND;PST;IPFV;NOM(1,SG)	 a s a s a s a s a s a s a s a
ossequiare V;IND;PST;IPFV;NOM(2,SG)	 a se alia alia alia alia alia
ossequiare V;IND;PST;IPFV;NOM(3,SG)	a se prossequiare V;IND;PST;IP
ossequiare V;IND;PST;PFV;NOM(1,PL)	 allate sussequiare V;IND;PST;
ossequiare V;IND;PST;PFV;NOM(2,SG)	 a secundum alias ante a secun
ossequiare V;POS;IMP;NOM(3,PL)	e possequiare V;POS;IMP;NOM;NO
ossequiare V;SBJV;PRS;NOM(1,PL)	 secunturiam additam secunturi
ossequiare V;SBJV;PRS;NOM(2,PL)	 secunturiam additam secunturi
ossequiare V;SBJV;PRS;NOM(2,SG)	 2018-07-18 18:00 UT SANE SANE
ossequiare V;SBJV;PRS;NOM(3,SG)	 secundum secundum secundum se
ossequiare V;SBJV;PST;NOM(2,PL)	 2010-02-10 10:00 Uhr : Senatu
ossequiare V;SBJV;PST;NOM(2,SG)	 SBJ V;SBJ V;PST;NOM(2,SG)asse
ossequiare V;SBJV;PST;NOM(3,SG)	 SBJ V;PST;NOM(3,SG)ae SBJ V;S
preludiare V;COND;NOM(3,SG)	est est est est est est est es
preludiare V;IND;FUT;NOM(3,PL)	est preludiare V;IND;FUT;NOM(3
preludiare V;IND;PRS;NOM(1,PL)	e preludiare P;IND;PRS;NOM(1,P
preludiare V;IND;PRS;NOM(2,PL)	est preludiare V;IND;PRS;NOM(2
preludiare V;IND;PRS;NOM(2,SG)	are V;IND;PRS;NOM(2,SG)are V;I
preludiare V;IND;PRS;NOM(3,SG)	est preludiare IND;PRS;NOM(3,S
preludiare V;IND;PST;IPFV;NOM(2,PL)	e preludiare V;IND;PST;IPFV;NO
preludiare V;IND;PST;PFV;NOM(1,PL)	e preludiare V;IND;PST;PFV;NOM
preludiare V;IND;PST;PFV;NOM(1,SG)	e preludiare V;IND;PST;PFV;NOM
preludiare V;IND;PST;PFV;NOM(2,SG)	e preludiare V;IND;PST;PFV;NOM
preludiare V;IND;PST;PFV;NOM(3,PL)	e preludiare V;IND;PST;PFV;NOM
preludiare V;NFIN	 V;NFINMINMINMINMINMINMINMINMI
preludiare V;POS;IMP;NOM(2,PL)	estreludiare P;POS;IMP;NOM(2,P
preludiare V;POS;IMP;NOM(3,PL)	estreludiare P;POS;IMP;NOM(3,P
preludiare V;POS;IMP;NOM(3,SG)	estare e preludiare e preludia
preludiare V;SBJV;PRS;NOM(1,SG)	estare e preludiare e preludia
preludiare V;SBJV;PRS;NOM(2,SG)	estare e preludiare e preludia
preludiare V;SBJV;PST;NOM(1,SG)	e preludiare V;SBJV;PST;NOM(1,
preludiare V;SBJV;PST;NOM(2,PL)	e preludiare V;SBJV;PST;NOM(2,
preludiare V;SBJV;PST;NOM(2,SG)	e preludiare V;SBJV;PST;NOM(2,
rabuffare V.PTCP;PRS	are V.PTCP;PRSe V.PTCP;PRSe V.
rabuffare V.PTCP;PST	abuffare V.PTCP;PST PTCP PTCP 
rabuffare V;COND;NOM(2,PL)	a a a a a a a a a a a a a a a 
rabuffare V;COND;NOM(2,SG)	a rabuffare rabuffare rabuffar
rabuffare V;COND;NOM(3,SG)	a ca ca ca ca ca ca ca ca ca c
rabuffare V;IND;FUT;NOM(2,PL)	are V;IND;FUT;NOM(2,PL)are V;I
rabuffare V;IND;FUT;NOM(2,SG)	are IND;FUT;NOM(2,SG)are V;IND
rabuffare V;IND;PRS;NOM(1,SG)	a capare a capare a capare a c
rabuffare V;IND;PRS;NOM(2,PL)	a a a a a a a a a a a a a a a 
rabuffare V;IND;PRS;NOM(2,SG)	a capare a capare a capare a c
rabuffare V;IND;PRS;NOM(3,SG)	a capare a capare a capare a c
rabuffare V;IND;PST;IPFV;NOM(1,PL)	abuffare V;IND;PST;IPFV;NOM(1,
rabuffare V;IND;PST;IPFV;NOM(2,PL)	abuffare V;IND;PST;IPFV;NOM(2,
rabuffare V;IND;PST;PFV;NOM(1,SG)	are are are are are are are ar
rabuffare V;POS;IMP;NOM(2,SG)	a ca ca ca ca ca ca ca ca ca c
rabuffare V;POS;IMP;NOM(3,SG)	a ca ca ca ca ca ca ca ca ca c
rabuffare V;SBJV;PRS;NOM(1,PL)	abuffare V;SBJV;PRS;NOM(1,PL)a
rabuffare V;SBJV;PRS;NOM(3,PL)	abuffare V;SBJV;PRS;NOM(3,PL)a
rabuffare V;SBJV;PST;NOM(1,SG)	are buffare buffare buffare bu
rabuffare V;SBJV;PST;NOM(2,SG)	are buffare buffare buffare bu
raccostare V.PTCP;PST	are V.PTCP;PST;PST;PST;PST;PST
raccostare V;COND;NOM(2,PL)	a di raccostare V;COND;NOM(2,P
raccostare V;IND;FUT;NOM(1,PL)	accostare V;IND;FUT;NOM
10. IN
raccostare V;IND;FUT;NOM(2,PL)	are V;IND;FUT;NOM
10. IND;FUT;
raccostare V;IND;FUT;NOM(3,PL)	are V;IND;FUT;NOM
10. IND;FUT;
raccostare V;IND;FUT;NOM(3,SG)	are la carta da raccostare V;I
raccostare V;IND;PRS;NOM(2,PL)	a con la statura di a raccosta
raccostare V;IND;PRS;NOM(2,SG)	a costare V;IND;PRS;NOM(2,SG)a
raccostare V;IND;PST;IPFV;NOM(1,PL)	aria correttiva correttiva cor
raccostare V;IND;PST;IPFV;NOM(1,SG)	ario con la strada che si racc
raccostare V;IND;PST;PFV;NOM(1,PL)	aria correttiva correttiva cor
raccostare V;IND;PST;PFV;NOM(1,SG)	ario con la strada che con la 
raccostare V;IND;PST;PFV;NOM(2,PL)	a con la con la con la con la 
raccostare V;NFIN	acostare V;NFINe Ne Ne Ne Ne N
raccostare V;POS;IMP;NOM(1,PL)	are V;POS;IMP;NOM(1,PL)are V;P
raccostare V;POS;IMP;NOM(3,PL)	ARE PL PL PL PL PL PL PL PL PL
raccostare V;SBJV;PRS;NOM(2,PL)	accostare V;SBJV;PRS;NOM(2,PL)
raccostare V;SBJV;PRS;NOM(3,PL)	accostare V;SBJV;PRS;NOM(3,PL)
raccostare V;SBJV;PRS;NOM(3,SG)	are la carta da raccostare V;S
raccostare V;SBJV;PST;NOM(3,PL)	accostare V;SBJV;PST;NOM(3,PL)
riammalarsi V.PTCP;PRS	a PTCP;PRSeesi PTCP;PRSeesi PT
riammalarsi V.PTCP;PST	 1. Ammalarsi V.PTCP;PST;PST;P
riammalarsi V;COND;NOM(2,PL)	ammalarsi V;COND;NOM(2,PL)arsi
riammalarsi V;COND;NOM(2,SG)	ammalarsi ammalarsi ammalarsi 
riammalarsi V;COND;NOM(3,SG)	ammalarsi ammalarsi ammalarsi 
riammalarsi V;IND;FUT;NOM(1,PL)	;FUT;NOM(1,PL)arsi V;IND;FUT;N
riammalarsi V;IND;FUT;NOM(1,SG)	ammalarsi V;IND;FUT;NOM(1,SG)g
riammalarsi V;IND;FUT;NOM(3,PL)	;FUT;NOM(3,PL)arsi V;IND;FUT;N
riammalarsi V;IND;FUT;NOM(3,SG)	ammalarsi V;IND;FUT;NOM(3,SG)g
riammalarsi V;IND;PRS;NOM(1,SG)	ammalarsi V;IND;PRS;NOM(1,SG)g
riammalarsi V;IND;PRS;NOM(3,SG)	ammalarsi IND;PRS;NOM(3,SG)gam
riammalarsi V;IND;PST;IPFV;NOM(1,PL)	ammalarsi ammalarsi ammalarsi 
riammalarsi V;IND;PST;IPFV;NOM(1,SG)	ammalarsi V;IND;PST;IPFV;NOM(1
riammalarsi V;IND;PST;PFV;NOM(1,PL)	ammalarsi V;IND;PST;PFV;NOM(1,
riammalarsi V;IND;PST;PFV;NOM(1,SG)	ammalarsi V;IND;PST;PFV;NOM(1,
riammalarsi V;IND;PST;PFV;NOM(3,SG)	ammalarsi V;IND;PST;PFV;NOM(3,
riammalarsi V;POS;IMP;NOM(1,PL)	;IMP;NOM(1,PL)arsi V;POS;IMP;N
riammalarsi V;SBJV;PRS;NOM(1,SG)	ammalarsi ammalarsi ammalarsi 
riammalarsi V;SBJV;PST;NOM(1,PL)	ammalarsiammalarsiammalarsiamm
riammalarsi V;SBJV;PST;NOM(2,PL)	ammalarsiammalarsiammalarsiamm
rimangiarsi V;COND;NOM(1,PL)	 1 1 1 1 1 1 1 1 1 1 1 1 1 1 1
rimangiarsi V;COND;NOM(2,SG)	 S;COND;NOM(2,SG)giarsi S;COND
rimangiarsi V;IND;FUT;NOM(2,PL)	angiarsi V;IND;FUT;NOM(2,PL)ar
rimangiarsi V;IND;FUT;NOM(2,SG)	(2,2,2,2,2,2,2,2,2,2,2,2,2,2,2
rimangiarsi V;IND;FUT;NOM(3,PL)	IND;FUT;NOM(3,PL)arsi V;IND;FU
rimangiarsi V;IND;PRS;NOM(3,SG)	;IND;PRS;NOM(3,SG)arsi IND;PRS
rimangiarsi V;IND;PST;IPFV;NOM(1,PL)	angiarsi IND;PST;IPFV;NOM(1,PL
rimangiarsi V;IND;PST;IPFV;NOM(3,SG)	arsi IND;PST;IPFV;NOM(2,SG)gia
rimangiarsi V;IND;PST;PFV;NOM(2,SG)	arsi (2,SG)arsi (2,SG)arsi (2,
rimangiarsi V;IND;PST;PFV;NOM(3,PL)	angiarsi IND;PST;PFV;NOM(3,PL)
rimangiarsi V;IND;PST;PFV;NOM(3,SG)	arsi IND;PST;PFV;NOM(2,SG)giar
rimangiarsi V;NFIN	 ; ; ; ; ; ; ; ; ; ; ; ; ; ; ;
rimangiarsi V;POS;IMP;NOM(2,PL)	ARSI PL;POS;IMP;NOM(2,PL)angia
rimangiarsi V;POS;IMP;NOM(3,SG)	(3,SG)g)giarsi I;POS;IMP;NOM(3
rimangiarsi V;SBJV;PRS;NOM(1,PL)	arsi S;NOM(1,PL)arsi S;NOM(1,P
rimangiarsi V;SBJV;PRS;NOM(2,SG)	arsi SBJV;PRS;NOM(2,SG)arsi SB
rimangiarsi V;SBJV;PRS;NOM(3,SG)	arsi SBJ SBJ SBJ SBJ SBJ SBJ S
rimangiarsi V;SBJV;PST;NOM(1,PL)	angiarsi SBJ SBJ SBJ SBJ SBJ S
rimangiarsi V;SBJV;PST;NOM(2,SG)	arsi SBJ SBJ SBJ SBJ SBJ SBJ S
rimangiarsi V;SBJV;PST;NOM(3,PL)	arsi SBJ SBJ SBJ SBJ SBJ SBJ S
rimbeccare V;COND;NOM(1,SG)	imbeccare rimbeccare rimbeccar
rimbeccare V;COND;NOM(3,PL)	imbeccare V;COND;NOM(3,PL)are 
rimbeccare V;IND;FUT;NOM(2,PL)	e V;IND;FUT;NOM(2,PL)are V;IND
rimbeccare V;IND;FUT;NOM(3,PL)	e V;IND;FUT;NOM(3,PL)are V;IND
rimbeccare V;IND;PRS;NOM(3,PL)	eccare V;IND;PRS;NOM
rimbeccar
rimbeccare V;IND;PRS;NOM(3,SG)	eccare V;IND;PRS;NOM(3,SG)are 
rimbeccare V;IND;PST;IPFV;NOM(1,PL)	imbeccare V;IND;PST;IPFV;NOM(1
rimbeccare V;IND;PST;IPFV;NOM(2,SG)	mbeccare mbeccare mbeccare mbe
rimbeccare V;IND;PST;PFV;NOM(2,SG)	mbeccare mbeccare mbeccare mbe
rimbeccare V;IND;PST;PFV;NOM(3,PL)	imbeccare V;IND;PST;PFV;NOM(3,
rimbeccare V;POS;IMP;NOM(1,PL)	(1,PL)are V;POS;IMP;NOM(1,PL)a
rimbeccare V;POS;IMP;NOM(3,SG)	(3,SG)are V;POS;IMP;NOM(3,SG)a
rimbeccare V;SBJV;PRS;NOM(1,SG)	imbeccare V;SBJV;PRS;NOM(1,SG)
rimbeccare V;SBJV;PRS;NOM(2,PL)	mbeccare V;SBJV;PRS;NOM(2,PL)a
rimbeccare V;SBJV;PRS;NOM(2,SG)	mbeccare mbeccare mbeccare mbe
rimbeccare V;SBJV;PRS;NOM(3,PL)	mbeccare V;SBJV;PRS;NOM(3,PL)a
rimbeccare V;SBJV;PRS;NOM(3,SG)	imbeccare V;SBJV;PRS;NOM(3,SG)
rimbeccare V;SBJV;PST;NOM(1,SG)	imbeccare V;SBJV;PST;NOM(1,SG)
rimbeccare V;SBJV;PST;NOM(2,PL)	mbeccare V;SBJV;PST;NOM(2,PL)a
rimbeccare V;SBJV;PST;NOM(3,PL)	mbeccare V;SBJV;PST;NOM(3,PL)a
rintorpidire V.CVB;PRS	intorpidire V.CVB;PRSe V.CVB;P
rintorpidire V.PTCP;PRS	intorpidire V.PTCP;PRSe PRSe P
rintorpidire V;COND;NOM(2,PL)	intorpidire intorpidire intorp
rintorpidire V;COND;NOM(2,SG)	intorpidire intorpidire intorp
rintorpidire V;COND;NOM(3,SG)	intorpidire intorpidire intorp
rintorpidire V;IND;FUT;NOM(1,PL)	intorpidire V;IND;FUT;NOM(1,PL
rintorpidire V;IND;FUT;NOM(1,SG)	intorpidire V;IND;FUT;NOM(1,SG
rintorpidire V;IND;PRS;NOM(2,PL)	;PRS;NOM(2,PL)arintorpidire V;
rintorpidire V;IND;PRS;NOM(3,PL)	intorpidire V;IND;PRS;NOM(3,PL
rintorpidire V;IND;PST;IPFV;NOM(1,SG)	intorpidire V;IND;PST;IPFV;NOM
rintorpidire V;IND;PST;IPFV;NOM(3,PL)	intorpidire V;IND;PST;IPFV;NOM
rintorpidire V;IND;PST;IPFV;NOM(3,SG)	intorpidire V;IND;PST;IPFV;NOM
rintorpidire V;IND;PST;PFV;NOM(1,SG)	intorpidire IND;PST;PFV;NOM(1,
rintorpidire V;IND;PST;PFV;NOM(2,PL)	intorpidire intorpidire intorp
rintorpidire V;IND;PST;PFV;NOM(2,SG)	intorpidire IND;PST;PFV;NOM(2,
rintorpidire V;NFIN	intorpidire V;NFINmintorpidire
rintorpidire V;POS;IMP;NOM(2,SG)	(2,SG)torpidire intorpidire in
rintorpidire V;SBJV;PRS;NOM(1,PL)	;
(1,PL)gallintorpidire V;SBJV
rintorpidire V;SBJV;PRS;NOM(3,SG)	(3,SG)intorpidire V;SBJV;PRS;N
rintorpidire V;SBJV;PST;NOM(1,SG)	(1,1,1,1,1,1,1,1,1,1,1,1,1,1,1
rinvestire V.PTCP;PRS	 PRS;PRS;PRS;PRS;PRS;PRS;PRS;P
rinvestire V.PTCP;PST	 PTCP;PST;PST;PST;PST;PST;PST;
rinvestire V;COND;NOM(3,PL)	est un modele de bankimi de ba
rinvestire V;IND;FUT;NOM(1,PL)	est investire V;IND;FUT;NOM(1,
rinvestire V;IND;FUT;NOM(1,SG)	estimare e aprire la capital h
rinvestire V;IND;FUT;NOM(2,SG)	estimare e acceder al mercato 
rinvestire V;IND;PRS;NOM(1,PL)	 a r i a r i a r i a r i a r i
rinvestire V;IND;PRS;NOM(1,SG)	rendere un pour investire V;IN
rinvestire V;IND;PRS;NOM(2,PL)	  V;IND;PRS;NOM(2,PL)a V;IND;
rinvestire V;IND;PRS;NOM(3,SG)	rendere un pour i proprio prop
rinvestire V;IND;PST;IPFV;NOM(3,PL)	rendita su fondo perde peso e 
rinvestire V;IND;PST;PFV;NOM(1,SG)	re V;IND;PST;PFV;NOM(1,SG)a co
rinvestire V;IND;PST;PFV;NOM(3,PL)	;pst;pfv;nom(3,PL)articolo 1 d
rinvestire V;IND;PST;PFV;NOM(3,SG)	rendimento e capital estendibi
rinvestire V;NFIN	e V;NFINPENSIONE V;NFINPENSION
rinvestire V;SBJV;PRS;NOM(1,PL)	;NOM(1,PL)a;NOM(1,PL)a;NOM(1,P
rinvestire V;SBJV;PRS;NOM(2,PL)	;NOM(2,PL)a;NOM(2,PL)a;NOM(2,P
rinvestire V;SBJV;PRS;NOM(3,PL)	;NOM(3,PL)a;NOM(3,PL)a;NOM(3,P
rinvestire V;SBJV;PST;NOM(3,PL)	estrategies de se focalizar su
rinvestire V;SBJV;PST;NOM(3,SG)	rentarenvestirenvestirenvestir
ripercuotersi V.CVB;PRS	i V.CVB;PRS;PRS;PRS;PRS;PRS;PR
ripercuotersi V.PTCP;PRS	i PTCP;PRSersi PTCP;PRSersi PT
ripercuotersi V.PTCP;PST	ersi V.PTCP;PSTB.PST. PST. PST
ripercuotersi V;COND;NOM(1,SG)	;COM(1,SG)and(1,SG)and(1,SG)an
ripercuotersi V;COND;NOM(3,PL)	(3,PL)antipercuotersi P;COND;N
ripercuotersi V;IND;FUT;NOM(1,PL)	IND;FUT;NOM(1,PL)a IND;FUT;NOM
ripercuotersi V;IND;PRS;NOM(1,PL)	;PRS;NOM(1,PL)andipercuotersi 
ripercuotersi V;IND;PRS;NOM(1,SG)	;PRS;NOM(1,SG)and;PRS;NOM(1,SG
ripercuotersi V;IND;PRS;NOM(2,SG)	;PRS;NOM(2,SG)aripercuotersi I
ripercuotersi V;IND;PRS;NOM(3,PL)	;PRS;NOM(3,PL)aripercuotersi I
ripercuotersi V;IND;PST;IPFV;NOM(1,SG)	IND;PST;IPFV;NOM(1,SG)and PST;
ripercuotersi V;IND;PST;PFV;NOM(1,PL)	index adipercuotersi adipercuo
ripercuotersi V;IND;PST;PFV;NOM(1,SG)	indicatoripercuotersi ndicator
ripercuotersi V;IND;PST;PFV;NOM(3,PL)	;PFV;NOM(3,PL)and PST;PFV;NOM(
ripercuotersi V;POS;IMP;NOM(1,PL)	;IMP;NOM(1,PL)aripercuotersi P
ripercuotersi V;POS;IMP;NOM(3,PL)	(3,PL)aripercuotersi P;POS;IMP
ripercuotersi V;POS;IMP;NOM(3,SG)	(3,SG)percuotersi P;POS;IMP;NO
ripercuotersi V;SBJV;PRS;NOM(2,SG)	;NOM(2,SG)aripercuotersi SBJV;
ripercuotersi V;SBJV;PST;NOM(1,PL)	Percuotersi SBJV;PST;NOM(1,PL)
ripercuotersi V;SBJV;PST;NOM(1,SG)	ipercuotersi SBJV;PST;NOM(1,SG
sbandierare V;COND;NOM(2,SG)	are V;COND;NOM(2,SG)are V;COND
sbandierare V;COND;NOM(3,PL)	 PL a PL a PL a PL a PL a PL a
sbandierare V;COND;NOM(3,SG)	are V;COND;NOM(3,SG)are V;COND
sbandierare V;IND;FUT;NOM(1,PL)	bandierare V;IND;FUT;NOM(1,PL)
sbandierare V;IND;FUT;NOM(1,SG)	bandierare V;IND;FUT;NOM(1,SG)
sbandierare V;IND;FUT;NOM(3,PL)	bandierare V;IND;FUT;NOM(3,PL)
sbandierare V;IND;PRS;NOM(1,PL)	bandierare I;IND;PRS;NOM(1,PL)
sbandierare V;IND;PST;IPFV;NOM(1,SG)	bandierare V;IND;PST;IPFV;NOM(
sbandierare V;IND;PST;IPFV;NOM(3,PL)	are V;IND;PST;IPFV;NOM(3,PL)ar
sbandierare V;IND;PST;PFV;NOM(1,SG)	bandierare V;IND;PST;PFV;NOM(1
sbandierare V;IND;PST;PFV;NOM(3,PL)	are V;IND;PST;PFV;NOM(3,PL)are
sbandierare V;POS;IMP;NOM(2,PL)	(2,PL)andierare V;POS;IMP;NOM(
sbandierare V;POS;IMP;NOM(3,PL)	(3,PL)andierare V;POS;IMP;NOM(
sbandierare V;POS;IMP;NOM(3,SG)	(3,SG)bandierare V;POS;IMP;NOM
sbandierare V;SBJV;PRS;NOM(1,PL)	bandierare V;SBJ V;PRS;NOM(1,P
sbandierare V;SBJV;PRS;NOM(1,SG)	bandierare SBJ SBJ SBJ SBJ SBJ
sbandierare V;SBJV;PRS;NOM(2,SG)	bandierare SBJ SBJ SBJ SBJ SBJ
sbandierare V;SBJV;PRS;NOM(3,PL)	;SBJV;PRS;NOM(3,PL)are V;SBJV;
sbandierare V;SBJV;PST;NOM(3,PL)	bandierare V;SBJV;PST;NOM(3,PL
sbandierare V;SBJV;PST;NOM(3,SG)	bandierare SBJ SBJ SBJ SBJ SBJ
scannare V.CVB;PRS	contenitore di contenitore di 
scannare V.PTCP;PST	cannare V.PTCP;PST;PST;PST;PST
scannare V;COND;NOM(1,SG)	cannare V;COND;NOM(1,SG)approv
scannare V;IND;FUT;NOM(1,PL)	cannare scannare scannare scan
scannare V;IND;FUT;NOM(1,SG)	cannare scannare scannare scan
scannare V;IND;FUT;NOM(3,SG)	cannare scannare scannare scan
scannare V;IND;PRS;NOM(1,PL)	a scannare scannare scannare s
scannare V;IND;PRS;NOM(1,SG)	cannare scannare scannare scan
scannare V;IND;PRS;NOM(2,PL)	a scannare scannare scannare s
scannare V;IND;PRS;NOM(3,SG)	cannare scannare scannare scan
scannare V;IND;PST;IPFV;NOM(2,PL)	cannare V;IND;PST;IPFV;NOM(2,P
scannare V;IND;PST;IPFV;NOM(2,SG)	cannare V;IND;PST;IPFV;NOM(2,S
scannare V;IND;PST;IPFV;NOM(3,SG)	cannare V;IND;PST;IPFV;NOM
Sca
scannare V;IND;PST;PFV;NOM(2,SG)	annare V;IND;PST;PFV;NOM(2,SG)
scannare V;IND;PST;PFV;NOM(3,SG)	cannare V;IND;PST;PFV;NOM(3,SG
scannare V;POS;IMP;NOM(3,SG)	cannare V;POS;IMP;NOM(3,SG)ann
scannare V;SBJV;PRS;NOM(1,SG)	cannare V;SBJV;PRS;NOM(1,SG)ar
scannare V;SBJV;PRS;NOM(2,PL)	comparare scannare scannare sc
scannare V;SBJV;PRS;NOM(3,PL)	comparare scannare scannare sc
scannare V;SBJV;PST;NOM(2,SG)	compatibilit√† delle scannare 
sconcertare V.CVB;PRS	nr. 10000000000000000000000000
sconcertare V;COND;NOM(1,PL)	are V;COND;NOM(1,PL)are V;COND
sconcertare V;COND;NOM(2,SG)	are V;COND;NOM(2,SG)are V;COND
sconcertare V;COND;NOM(3,PL)	are V;COND;NOM(3,PL)are V;COND
sconcertare V;IND;FUT;NOM(1,SG)	are V;IND;FUT;NOM(1,SG)are V;I
sconcertare V;IND;FUT;NOM(3,SG)	itare V;IND;FUT;NOM(3,SG)a des
sconcertare V;IND;PRS;NOM(1,SG)	interesconcertare V;IND;PRS;NO
sconcertare V;IND;PRS;NOM(2,SG)	are V;IND;PRS;NOM(2,SG)are V;I
sconcertare V;IND;PRS;NOM(3,SG)	are V;IND;PRS;NOM(3,SG)are V;I
sconcertare V;IND;PST;PFV;NOM(2,PL)	etare disconcertare disconcert
sconcertare V;IND;PST;PFV;NOM(2,SG)	erotica desconcertare V;IND;PS
sconcertare V;IND;PST;PFV;NOM(3,PL)	etica de sconcertare de sconce
sconcertare V;POS;IMP;NOM(2,PL)	;NOM(2,PL)are V;POS;IMP;NOM(2,
sconcertare V;POS;IMP;NOM(2,SG)	itate V;POS;IMP;NOM(2,SG)are V
sconcertare V;SBJV;PRS;NOM(1,PL)	eros concertare V;SBJV;PRS;NOM
sconcertare V;SBJV;PRS;NOM(2,PL)	itare V;SBJV;PRS;NOM(2,PL)are 
sconcertare V;SBJV;PRS;NOM(2,SG)	itare V;SBJV;PRS;NOM(2,SG)are 
sconcertare V;SBJV;PRS;NOM(3,PL)	itare V;SBJV;PRS;NOM(3,PL)are 
sconcertare V;SBJV;PST;NOM(2,SG)	itare V;SBJV;PST;NOM(2,SG)a ca
sconcertare V;SBJV;PST;NOM(3,SG)	itare V;SBJV;PST;NOM(3,SG)gara
seminare V.CVB;PRS	emineare V.CVB;PRStrare V.CVB;
seminare V;COND;NOM(1,SG)	eminare seminare seminare semi
seminare V;COND;NOM(2,PL)	eminemineminemineminemineminem
seminare V;COND;NOM(2,SG)	eminare seminare seminare semi
seminare V;IND;FUT;NOM(1,PL)	eminente seminare V;IND;FUT;NO
seminare V;IND;FUT;NOM(2,SG)	eminare seminare seminare semi
seminare V;IND;FUT;NOM(3,SG)	eminare seminare seminare semi
seminare V;IND;PRS;NOM(1,PL)	eminare seminare seminare semi
seminare V;IND;PRS;NOM(1,SG)	eminare seminare seminare semi
seminare V;IND;PRS;NOM(3,PL)	eminare seminare seminare semi
seminare V;IND;PST;IPFV;NOM(2,PL)	e seminare V;IND;PST;IPFV;NOM(
seminare V;IND;PST;IPFV;NOM(3,PL)	eminare seminare seminare semi
seminare V;IND;PST;PFV;NOM(1,PL)	eminare seminare seminare semi
seminare V;IND;PST;PFV;NOM(2,SG)	e seminare e seminare seminar
seminare V;NFIN	eminare V;NFINginare V;NFINgin
seminare V;POS;IMP;NOM(2,PL)	e V;POS;IMP;NOM(2,PL)are semin
seminare V;POS;IMP;NOM(3,PL)	e V;POS;IMP;NOM(3,PL)are semin
seminare V;SBJV;PRS;NOM(2,PL)	e seminare seminare seminare s
seminare V;SBJV;PST;NOM(3,PL)	eminare seminare seminare semi
seminare V;SBJV;PST;NOM(3,SG)	e seminare seminare seminare s
servire V.CVB;PRS	ervire V.CVB;PRSglm de Prsglm 
servire V.PTCP;PST	e V.PTCP;PSTservire V.PTCP;PST
servire V;COND;NOM(1,SG)	resources de la servire V;COND
servire V;COND;NOM(2,PL)	est le processus de servire V;
servire V;COND;NOM(3,SG)	resources de la servire V;COND
servire V;IND;FUT;NOM(2,SG)	 la servire V;IND;FUT;NOM(2,SG
servire V;IND;FUT;NOM(3,PL)	 la servire V;IND;FUT;NOM(3,PL
servire V;IND;PRS;NOM(1,PL)	est le premier service de la r
servire V;IND;PRS;NOM(2,PL)	 le service de la ressource V;
servire V;IND;PST;IPFV;NOM(2,SG)	est la servire V;IND;PST;IPFV;
servire V;IND;PST;IPFV;NOM(3,PL)	est la servire V;IND;PST;IPFV;
servire V;IND;PST;PFV;NOM(3,PL)	 la conservation de V;IND;PST;
servire V;IND;PST;PFV;NOM(3,SG)	est pas de la servire V;IND;PS
servire V;NFIN	e servire V;NFIN;NFIN;NFIN;NFI
servire V;POS;IMP;NOM(2,PL)	 la derni√®re servire V;POS;IM
servire V;POS;IMP;NOM(3,PL)	RES;IMP;NOM(3,PL)article 1 de 
servire V;SBJV;PRS;NOM(1,SG)	est le present sur le site de 
servire V;SBJV;PRS;NOM(3,SG)	est le present sur le site de 
servire V;SBJV;PST;NOM(1,SG)	est le mesure de la servire V;
servire V;SBJV;PST;NOM(2,SG)	est le mesure de la servire V;
servoassistere V.CVB;PRS	e servoassistenza V.CVB;PRSast
servoassistere V;COND;NOM(1,PL)	e V;COND;NOM(1,PL)assistere V;
servoassistere V;COND;NOM(2,SG)	ervoassistere V;COND;NOM(2,SG)
servoassistere V;COND;NOM(3,PL)	ervoassistere V;COND;NOM(3,PL)
servoassistere V;IND;FUT;NOM(1,PL)	servoassistere V;IND;FUT;NOM(1
servoassistere V;IND;FUT;NOM(2,PL)	servoassistere V;IND;FUT;NOM(2
servoassistere V;IND;FUT;NOM(3,PL)	servoassistere V;IND;FUT;NOM(3
servoassistere V;IND;PRS;NOM(2,SG)	ere V;IND;PRS;NOM(2,SG)assiste
servoassistere V;IND;PST;PFV;NOM(1,PL)	e de radio frequenza e servoas
servoassistere V;IND;PST;PFV;NOM(3,PL)	e de radio e de single port de
servoassistere V;NFIN	assistere V;NFINcistere V;NFIN
servoassistere V;POS;IMP;NOM(1,PL)	ervoassistere V;POS;IMP;NOM(1,
servoassistere V;POS;IMP;NOM(3,PL)	ervoassistere V;POS;IMP;NOM(3,
servoassistere V;POS;IMP;NOM(3,SG)	ervoassistere ervoassistere s
servoassistere V;SBJV;PRS;NOM(1,PL)	ervoassistere servoassistere s
servoassistere V;SBJV;PRS;NOM(2,PL)	ervoassistere servoassistere s
servoassistere V;SBJV;PRS;NOM(3,PL)	ervoassistere servoassistere s
servoassistere V;SBJV;PST;NOM(1,SG)	e servoassemblie servoassembli
servoassistere V;SBJV;PST;NOM(2,PL)	ervoassistere V;SBJV;PST;NOM(2
servoassistere V;SBJV;PST;NOM(2,SG)	e servoassembly servoassembly 
sfaldarsi V.CVB;PRS	 S S S S S S S S S S S S S S S
sfaldarsi V.PTCP;PRS	faldarsi V.PTCP;PRS. PRS. PRS.
sfaldarsi V.PTCP;PST	arsi V.PTCP;PST V.PTCP;PST V.P
sfaldarsi V;COND;NOM(1,PL)	sfaldarsi V;COND;NOM(1,PL)arsi
sfaldarsi V;COND;NOM(2,PL)	sfaldarsi V;COND;NOM(2,PL)alda
sfaldarsi V;COND;NOM(3,PL)	sfaldarsi V;COND;NOM(3,PL)alda
sfaldarsi V;COND;NOM(3,SG)	sfaldarsi SFALDARSI SFALDARSI 
sfaldarsi V;IND;FUT;NOM(2,PL)	arsi V;IND;FUT;NOM(2,PL)arsi V
sfaldarsi V;IND;FUT;NOM(2,SG)	(2,SG)V;IND;FUT;NOM(2,SG)V;IND
sfaldarsi V;IND;FUT;NOM(3,SG)	(2,SG)V;IND;FUT;NOM(3,SG)V;IND
sfaldarsi V;IND;PRS;NOM(3,SG)	;IND;PRS;NOM(3,SG)garsi V;IND;
sfaldarsi V;IND;PST;PFV;NOM(2,PL)	arsi V;IND;PST;PFV;NOM(2,PL)ar
sfaldarsi V;NFIN	arsi V;NFINei Nei Nei Nei Nei 
sfaldarsi V;POS;IMP;NOM(2,PL)	arsi V;POS;IMP;NOM(2,PL)arsi V
sfaldarsi V;SBJV;PRS;NOM(1,SG)	arsi SG SG SG SG SG SG SG SG S
sfaldarsi V;SBJV;PRS;NOM(2,SG)	arsi SBJV;PRS;NOM(2,SG)garsi S
sfaldarsi V;SBJV;PRS;NOM(3,PL)	arsi V;SBJV;PRS;NOM(3,PL)arsi 
sfaldarsi V;SBJV;PRS;NOM(3,SG)	arsi SBJV;PRS;NOM(3,SG)garsi S
sfaldarsi V;SBJV;PST;NOM(2,SG)	i SBJV;PST;NOM(2,SG)g SBJV;PST
sfaldarsi V;SBJV;PST;NOM(3,PL)	sfaldarsi V;SBJV;PST;NOM(3,PL)
sognarsi V.CVB;PRS	en att sognarsi V.CVB;PRSg V.C
sognarsi V;COND;NOM(1,SG)	sognarsi sognarsi sognarsi sog
sognarsi V;COND;NOM(2,PL)	er som helst som helst som hel
sognarsi V;IND;FUT;NOM(2,PL)	en sognarsi V;IND;FUT;NOM(2,PL
sognarsi V;IND;PRS;NOM(1,PL)	er att sognarsi IND;PRS;NOM(1,
sognarsi V;IND;PST;IPFV;NOM(1,PL)	er en stadie att skriva en kan
sognarsi V;IND;PST;IPFV;NOM(3,PL)	et alltid sognarsi V;IND;PST;I
sognarsi V;IND;PST;IPFV;NOM(3,SG)	arsi V;IND;PST;IPFV;NOM(3,SG)g
sognarsi V;IND;PST;PFV;NOM(1,SG)	artiklar om hund og katt sogna
sognarsi V;IND;PST;PFV;NOM(2,SG)	et sognarsi V;IND;PST;PFV;NOM(
sognarsi V;IND;PST;PFV;NOM(3,PL)	et sognarsi V;IND;PST;PFV;NOM(
sognarsi V;IND;PST;PFV;NOM(3,SG)	artiklar om hund og katt sogna
sognarsi V;POS;IMP;NOM(2,SG)	ing a sognarsi ognarsi ognarsi
sognarsi V;POS;IMP;NOM(3,PL)	OM(3,PL)asognarsi V;POS;IMP;NO
sognarsi V;POS;IMP;NOM(3,SG)	OM(3,SG)gentarsi V;POS;IMP;NOM
sognarsi V;SBJV;PRS;NOM(2,SG)	arsi sognarsi sognarsi sognars
sognarsi V;SBJV;PRS;NOM(3,SG)	arsi sognarsi sognarsi sognars
sognarsi V;SBJV;PST;NOM(1,PL)	er sognarsi V;SBJV;PST;NOM(1,P
sognarsi V;SBJV;PST;NOM(3,PL)	er sognarsi V;SBJV;PST;NOM(3,P
sognarsi V;SBJV;PST;NOM(3,SG)	sognarsi V;SBJV;PST;NOM(3,SG)g
strofinarsi V.CVB;PRS	 PRSprs V.CVB;PRSprs V.CVB;PRS
strofinarsi V.PTCP;PRS	 Para la Para la Para la Para 
strofinarsi V;COND;NOM(3,PL)	inarsi V;COND;NOM(3,PL)arsi V;
strofinarsi V;COND;NOM(3,SG)	i Si Si Si Si Si Si Si Si Si S
strofinarsi V;IND;FUT;NOM(1,PL)	T;NOM(1,PL)and fut;nom(1,PL)an
strofinarsi V;IND;FUT;NOM(1,SG)	 SI V;IND;FUT;NOM(1,SG)g g g g
strofinarsi V;IND;FUT;NOM(2,PL)	i V;IND;FUT;NOM(2,PL)a a a a a
strofinarsi V;IND;PRS;NOM(1,SG)	i I I I I I I I I I I I I I I 
strofinarsi V;IND;PRS;NOM(2,PL)	i I I I I I I I I I I I I I I 
strofinarsi V;IND;PST;IPFV;NOM(1,PL)	a strofinarsi V;IND;PST;IPFV;N
strofinarsi V;IND;PST;IPFV;NOM(1,SG)	a strofinarsi V;IND;PST;IPFV;N
strofinarsi V;IND;PST;IPFV;NOM(2,SG)	astrofinarsi V;IND;PST;IPFV;NO
strofinarsi V;IND;PST;IPFV;NOM(3,PL)	a strofinarsi V;IND;PST;IPFV;N
strofinarsi V;POS;IMP;NOM(1,PL)	inarsi V;POS;IMP;NOM(1,PL)arsi
strofinarsi V;POS;IMP;NOM(2,PL)	inarsi V;POS;IMP;NOM(2,PL)arsi
strofinarsi V;POS;IMP;NOM(2,SG)	a strafinarsi V;POS;IMP;NOM(2,
strofinarsi V;SBJV;PRS;NOM(1,SG)	i SG SG SG SG SG SG SG SG SG S
strofinarsi V;SBJV;PRS;NOM(2,SG)	i SBJV;PRS;NOM(2,SG)arsi V;SBJ
strofinarsi V;SBJV;PRS;NOM(3,SG)	i SBJV;PRS;NOM(3,SG)arsi V;SBJ
strofinarsi V;SBJV;PST;NOM(2,SG)	i SBJV;PST;NOM(2,SG)g a s t r 
sussumere V;COND;NOM(2,SG)	e sussumere sussumere sussumer
sussumere V;IND;FUT;NOM(1,SG)	e V;IND;FUT;NOM(1,SG)a sussume
sussumere V;IND;FUT;NOM(3,SG)	e V;IND;FUT;NOM(3,SG)a sussume
sussumere V;IND;PRS;NOM(1,PL)	e sussumere sussumere sussumer
sussumere V;IND;PRS;NOM(1,SG)	e sussumere sussumere sussumer
sussumere V;IND;PRS;NOM(2,PL)	e sussumere sussumere sussumer
sussumere V;IND;PRS;NOM(3,PL)	e sussumere sussumere sussumer
sussumere V;IND;PST;PFV;NOM(1,PL)	ere sussumere sussumere sussum
sussumere V;IND;PST;PFV;NOM(2,SG)	ere V;IND;PST;PFV;NOM(2,SG)aus
sussumere V;IND;PST;PFV;NOM(3,SG)	e sussumere sussumere sussumer
sussumere V;NFIN	ssumere V;NFINssumere V;NFINss
sussumere V;POS;IMP;NOM(3,PL)	E;SENS;SENS;SENS;SENS;SENS;SEN
sussumere V;SBJV;PRS;NOM(1,PL)	e sussumere sussumere sussumer
sussumere V;SBJV;PRS;NOM(1,SG)	ere V;SBJV;PRS;NOM(1,SG)aussum
sussumere V;SBJV;PRS;NOM(2,PL)	e sussumere sussumere sussumer
sussumere V;SBJV;PRS;NOM(2,SG)	ere V;SBJV;PRS;NOM(2,SG)aussum
sussumere V;SBJV;PST;NOM(1,PL)	e sussumere sussumere sussumer
sussumere V;SBJV;PST;NOM(1,SG)	ere V;SBJV;PST;NOM(1,SG)aussum
sussumere V;SBJV;PST;NOM(2,PL)	e sussumere sussumere sussumer
sussumere V;SBJV;PST;NOM(3,PL)	e sussumere sussumere sussumer
sviscerare V;COND;NOM(1,SG)	ae sviscerare V;COND;NOM(1,SG)
sviscerare V;COND;NOM(2,PL)	ae saeculae saeculae saeculae 
sviscerare V;IND;FUT;NOM(1,SG)	;FUT;NOM(1,SG)aestimate V;IND;
sviscerare V;IND;FUT;NOM(2,SG)	;FUT;NOM(2,SG)aestivale V;IND;
sviscerare V;IND;PRS;NOM(1,PL)	a sviscerare V;IND;PRS;NOM(1,P
sviscerare V;IND;PRS;NOM(2,SG)	a sviscerare V;IND;PRS;NOM(2,S
sviscerare V;IND;PRS;NOM(3,PL)	a sviscerare V;IND;PRS;NOM
Svi
sviscerare V;IND;PRS;NOM(3,SG)	a sviscerare V;IND;PRS;NOM(3,S
sviscerare V;IND;PST;IPFV;NOM(2,PL)	;PST;IPFV;NOM(2,PL)are V;IND;P
sviscerare V;IND;PST;IPFV;NOM(3,PL)	;PST;IPFV;NOM(3,PL)asviscerare
sviscerare V;IND;PST;PFV;NOM(2,PL)	;PFV;NOM(2,PL)are V;IND;PST;PF
sviscerare V;IND;PST;PFV;NOM(3,PL)	;PFV;NOM(3,PL)are V;IND;PST;PF
sviscerare V;IND;PST;PFV;NOM(3,SG)	(2,SG)aestiva (2,SG)aestiva (2
sviscerare V;POS;IMP;NOM(1,PL)	ae sviscerare V;POS;IMP;NOM(1,
sviscerare V;POS;IMP;NOM(3,PL)	ARE V;POS;IMP;NOM(3,PL)are V;P
sviscerare V;POS;IMP;NOM(3,SG)	ARCHIVA COMPLETA COMPLETA COMP
sviscerare V;SBJV;PRS;NOM(1,PL)	;NOM(1,PL)ad se contendere V;S
sviscerare V;SBJV;PRS;NOM(3,PL)	 sviscerare V;SBJV;PRS;NOM
V;S
sviscerare V;SBJV;PRS;NOM(3,SG)	(3,SG)ae sviscerare V;SBJV;PRS
sviscerare V;SBJV;PST;NOM(3,SG)	(3,SG)aetatis subsviscerare V;
telefonarsi V.CVB;PRS	 CVB;PRS;PRS;PRS;PRS;PRS;PRS;P
telefonarsi V;COND;NOM(1,PL)	elefonarsi TELEFONARSI TELEFON
telefonarsi V;COND;NOM(1,SG)	en telefonarsi V;COND;NOM(1,SG
telefonarsi V;COND;NOM(2,SG)	elefonarsi V;COND;NOM(2,SG)tel
telefonarsi V;IND;FUT;NOM(1,PL)	efonarsi V;IND;FUT;NOM(1,PL)a 
telefonarsi V;IND;FUT;NOM(3,PL)	en telefonarsi V;IND;FUT;NOM(3
telefonarsi V;IND;PRS;NOM(1,PL)	e telefonarsi V;IND;PRS;NOM(1,
telefonarsi V;IND;PRS;NOM(3,PL)	el telefonarsi V;IND;PRS;NOM(3
telefonarsi V;IND;PST;IPFV;NOM(1,PL)	elfonarsi V;IND;PST;IPFV;NOM(1
telefonarsi V;IND;PST;IPFV;NOM(2,PL)	e contactarsi e contactarsi e 
telefonarsi V;IND;PST;IPFV;NOM(2,SG)	en casa de bankimia de bankimi
telefonarsi V;IND;PST;PFV;NOM(2,SG)	elefonarsi (2,SG)arsi (2,SG)ar
telefonarsi V;IND;PST;PFV;NOM(3,PL)	elfonarsi V;IND;PST;PFV;NOM(3,
telefonarsi V;IND;PST;PFV;NOM(3,SG)	en cara metter telefonarsi (3,
telefonarsi V;SBJV;PRS;NOM(1,PL)	e telefonarsi V;SBJV;PRS;NOM(1
telefonarsi V;SBJV;PRS;NOM(1,SG)	elefonarsi SBJV;PRS;NOM(1,SG)g
telefonarsi V;SBJV;PRS;NOM(2,PL)	e telefonarsi V;SBJV;PRS;NOM(2
telefonarsi V;SBJV;PST;NOM(1,PL)	efonarsi V;SBJV;PST;NOM(1,PL)g
telefonarsi V;SBJV;PST;NOM(1,SG)	en telefonarsi SBJV;PST;NOM(1,
telefonarsi V;SBJV;PST;NOM(2,PL)	efonarsi SBJV;PST;NOM(2,PL)ars
urtacchiare V.CVB;PRS	e V.CVB;PRSe V.CVB;PRSe V.CVB;
urtacchiare V;COND;NOM(1,PL)	e V;COND;NOM(1,PL)are V;COND;N
urtacchiare V;COND;NOM(1,SG)	(1,SG)giare V;COND;NOM(1,SG)gi
urtacchiare V;COND;NOM(2,PL)	e V;COND;NOM(2,PL)ase V;COND;N
urtacchiare V;COND;NOM(2,SG)	(2,SG)giorno Turtacchiare V;CO
urtacchiare V;IND;FUT;NOM(3,SG)	e V;IND;FUT;NOM(3,SG)gambere V
urtacchiare V;IND;PRS;NOM(1,PL)	e V;IND;PRS;NOM
1 Petruzzella 
urtacchiare V;IND;PRS;NOM(2,PL)	e V;IND;PRS;NOM(2,PL)ance V;IN
urtacchiare V;IND;PRS;NOM(2,SG)	e V;IND;PRS;NOM(2,SG)anare V;I
urtacchiare V;IND;PRS;NOM(3,PL)	e V;IND;PRS;NOM
2017-01-17 17:
urtacchiare V;IND;PST;IPFV;NOM(1,PL)	;PST;IPFV;NOM(1,PL)are (1,PL)a
urtacchiare V;IND;PST;PFV;NOM(1,PL)	;PFV;NOM(1,PL)are (1,PL)are (1
urtacchiare V;IND;PST;PFV;NOM(2,SG)	;PFV;NOM(2,SG)are (2,SG)are (2
urtacchiare V;IND;PST;PFV;NOM(3,PL)	
2017 School of Manual Manual 
urtacchiare V;IND;PST;PFV;NOM(3,SG)	;PFV;NOM(3,SG)gradospinosi (3,
urtacchiare V;POS;IMP;NOM(1,PL)	ARE V;POS;IMP;NOM(1,PL)are V;P
urtacchiare V;SBJV;PRS;NOM(2,SG)	e V;SBJV;PRS;NOM(2,SG)are V;SB
urtacchiare V;SBJV;PRS;NOM(3,SG)	(3,SG)are V;SBJV;PRS;NOM(3,SG)
urtacchiare V;SBJV;PST;NOM(2,PL)	
2017 10 Turtacchiare V;SBJV;P
urtacchiare V;SBJV;PST;NOM(2,SG)	
Titolo Ufficiale della statal
