Generate the inflected form for: indiciar V;2;PL;IND;PST;IPFV	indiciáveis	indiciáveis
Generate the inflected form for: adequar V.PTCP;MASC;SG;PST	adequado	adequado
Generate the inflected form for: desdizer V;2;SG;IND;PST;IPFV	desdissias	desdizias
Generate the inflected form for: refogar V.PTCP;PRS	refogando	refogando
Generate the inflected form for: frequentar V;1;PL;IMP;POS	frequentemos	frequentemos
Generate the inflected form for: condimentar V;1;SG;IND;PST;PFV	condimentei	condimentei
Generate the inflected form for: içar V;3;PL;SBJV;FUT	içarem	içarem
Generate the inflected form for: designar V;3;SG;IND;PST;IPFV	designava	designava
Generate the inflected form for: ziguezaguear V;3;PL;IND;PST;PFV	ziguezaguearam	ziguezaguearam
Generate the inflected form for: acortinar V;3;PL;NFIN	acortinarem	acortinarem
Generate the inflected form for: estocar V;2;PL;COND	estocaríeis	estocaríeis
Generate the inflected form for: estimular V;1;PL;IND;PST;PFV	estimulámos	estimulámos
Generate the inflected form for: harmonizar V;1;PL;IMP;NEG	harmonizemos	harmonizemos
Generate the inflected form for: sublinhar V;1;PL;IND;PST;IPFV	sublinhávamos	sublinhávamos
Generate the inflected form for: contra-atacar V;2;PL;NFIN	contra-atacardes	contra-atacardes
Generate the inflected form for: pedalar V;1;PL;SBJV;PRS	pedalemos	pedalemos
Generate the inflected form for: vitimar V;1;PL;COND	vitimaríamos	vitimaríamos
Generate the inflected form for: brincar V;NFIN	brincar	brincar
Generate the inflected form for: latinar V;3;SG;IND;PST;PRF	latinara	latinara
Generate the inflected form for: desdizer V;3;PL;IMP;NEG	desdigam	desdigam
Generate the inflected form for: estipular V;3;PL;SBJV;PRS	estipulem	estipulem
Generate the inflected form for: arquejar V;3;PL;COND	arquejariam	arquejariam
Generate the inflected form for: pregar V;2;PL;IND;PST;IPFV	pregáveis	pregáveis
Generate the inflected form for: redimir V;1;PL;SBJV;FUT	redimirmos	redimirmos
Generate the inflected form for: borrar V;3;PL;SBJV;PST;IPFV	borrassem	borrassem
Generate the inflected form for: surtar V;1;PL;SBJV;FUT	surtarmos	surtarmos
Generate the inflected form for: impregnar V.PTCP;PRS	impregnando	impregnando
Generate the inflected form for: entrar V;2;PL;IND;PRS	entrais	entrais
Generate the inflected form for: cagar V;1;SG;COND	cagaria	cagaria
Generate the inflected form for: apedrejar V;3;SG;IMP;POS	apedreje	apedreje
Generate the inflected form for: enfileirar V;2;SG;SBJV;FUT	enfileirares	enfileirares
Generate the inflected form for: registar V;1;SG;SBJV;FUT	registar	registar
Generate the inflected form for: mutilar V;3;PL;SBJV;FUT	mutilarem	mutilarem
Generate the inflected form for: indiciar V;3;SG;SBJV;FUT	indiciar	indiciar
Generate the inflected form for: limar V;2;SG;SBJV;PST;IPFV	limasses	limasses
Generate the inflected form for: apatetar V;3;SG;SBJV;PST;IPFV	apatetasse	apatetasse
Generate the inflected form for: guardar V;3;PL;IMP;POS	guardem	guardem
Generate the inflected form for: pagar V;1;SG;IND;PRS	pago	pago
Generate the inflected form for: optar V;2;SG;IMP;NEG	optes	optes
Generate the inflected form for: voltar V;1;SG;NFIN	voltar	voltar
Generate the inflected form for: coevoluir V;2;SG;IND;PST;PFV	coevoluiste	coevoluíste
Generate the inflected form for: olear V;2;SG;COND	olearias	olearias
Generate the inflected form for: conjecturar V;2;PL;IMP;POS	conjecturai	conjecturai
Generate the inflected form for: raciocinar V;2;PL;IMP;POS	raciocinai	raciocinai
Generate the inflected form for: secundar V;2;PL;NFIN	secundardes	secundardes
Generate the inflected form for: aluviar V;3;PL;IND;FUT	aluviarão	aluviarão
Generate the inflected form for: aventar V;2;PL;IND;FUT	aventareis	aventareis
Generate the inflected form for: vesguear V;1;PL;SBJV;FUT	vesguearmos	vesguearmos
Generate the inflected form for: relacionar V;1;SG;IND;PRS	relaciono	relaciono
Generate the inflected form for: realçar V;2;PL;IMP;POS	realçai	realçai
Generate the inflected form for: confraternizar V;1;SG;IND;FUT	confraternizarei	confraternizarei
Generate the inflected form for: olear V;3;SG;IMP;POS	oleie	oleie
Generate the inflected form for: sangrar V;1;SG;IND;FUT	sangrarei	sangrarei
Generate the inflected form for: polimerizar V;3;SG;NFIN	polimerizar	polimerizar
Generate the inflected form for: anteceder V;1;SG;IND;FUT	antecederei	antecederei
Generate the inflected form for: delimitar V;1;PL;IMP;POS	delimitemos	delimitemos
Generate the inflected form for: contrabalançar V;2;SG;IMP;POS	contrabalança	contrabalança
Generate the inflected form for: desarrazoar V;1;PL;SBJV;FUT	desarrazoarmos	desarrazoarmos
Generate the inflected form for: fallecer V;2;SG;SBJV;FUT	falleceres	falleceres
Generate the inflected form for: aventar V;2;PL;IND;PST;IPFV	aventáveis	aventáveis
Generate the inflected form for: analisar V;1;PL;SBJV;FUT	analisarmos	analisarmos
Generate the inflected form for: adoecer V.PTCP;PRS	adoecendo	adoecendo
Generate the inflected form for: arrebentar V;1;PL;NFIN	arrebentarmos	arrebentarmos
Generate the inflected form for: extinguir V;3;PL;IND;PST;IPFV	extinguiam	extinguiam
Generate the inflected form for: mastigar V;3;PL;IMP;POS	mastiguem	mastiguem
Generate the inflected form for: constatar V;3;PL;IND;PST;IPFV	constatavam	constatavam
Generate the inflected form for: filtrar V;3;PL;SBJV;FUT	filtrarem	filtrarem
Generate the inflected form for: tosar V;1;PL;IND;FUT	tosaremos	tosaremos
Generate the inflected form for: proliferar V;1;PL;SBJV;PRS	proliferemos	proliferemos
Generate the inflected form for: cumprimentar V;1;SG;NFIN	cumprimentar	cumprimentar
Generate the inflected form for: comendar V;3;SG;IND;FUT	comendará	comendará
Generate the inflected form for: desarrazoar V;1;SG;IND;PST;PFV	desarrazoei	desarrazoei
Generate the inflected form for: sonambular V.PTCP;MASC;SG;PST	sonambulado	sonambulado
Generate the inflected form for: sangrar V;3;PL;IND;PRS	sangram	sangram
Generate the inflected form for: adivinhar V;3;PL;IMP;NEG	adivinhem	adivinhem
Generate the inflected form for: lambujar V.PTCP;FEM;SG;PST	lambujada	lambujada
Generate the inflected form for: registrar V;2;SG;SBJV;FUT	registrares	registrares
Generate the inflected form for: desembalar V;3;SG;IND;PST;IPFV	desembalava	desembalava
Generate the inflected form for: liquefazer V;2;PL;IMP;NEG	liquefiçais	liquefaçais
Generate the inflected form for: sobressair V;1;SG;IND;FUT	sobressairei	sobressairei
Generate the inflected form for: incorporar V;1;PL;IMP;POS	incorporemos	incorporemos
Generate the inflected form for: absceder V;3;SG;NFIN	absceder	absceder
Generate the inflected form for: escassear V;1;SG;SBJV;PRS	escasseie	escasseie
Generate the inflected form for: registrar V;1;PL;IND;PST;IPFV	registrávamos	registrávamos
Generate the inflected form for: retaliar V.PTCP;MASC;SG;PST	retaliado	retaliado
Generate the inflected form for: vomitar V;2;PL;IND;PST;PRF	vomitáreis	vomitáreis
Generate the inflected form for: realçar V;1;PL;SBJV;FUT	realçarmos	realçarmos
Generate the inflected form for: derrapar V;1;PL;IND;PRS	derrapamos	derrapamos
Generate the inflected form for: denotar V;2;PL;IMP;NEG	denoteis	denoteis
Generate the inflected form for: encomendar V;1;SG;SBJV;FUT	encomendar	encomendar
Generate the inflected form for: escalfar V;3;PL;IMP;NEG	escalfem	escalfem
Generate the inflected form for: desentranhar V;3;PL;IND;PST;IPFV	desentranhavam	desentranhavam
Generate the inflected form for: amarrar V;2;SG;SBJV;FUT	amarrares	amarrares
Generate the inflected form for: discar V;3;SG;SBJV;PRS	disque	disque
Generate the inflected form for: teclar V;3;PL;SBJV;PRS	teclem	teclem
Generate the inflected form for: alfabetizar V;1;PL;SBJV;PST;IPFV	alfabetizássemos	alfabetizássemos
Generate the inflected form for: ruir V;1;SG;SBJV;PST;IPFV	ruísse	ruísse
Generate the inflected form for: arquivar V;1;SG;SBJV;FUT	arquivar	arquivar
Generate the inflected form for: terminar V;1;PL;IND;PST;IPFV	terminávamos	terminávamos
Generate the inflected form for: sublinhar V;3;PL;IND;PST;IPFV	sublinhavam	sublinhavam
Generate the inflected form for: resplandecer V;2;PL;IND;PST;PFV	resplandecestes	resplandecestes
Generate the inflected form for: talhar V;3;PL;NFIN	talharem	talharem
Generate the inflected form for: ondular V;3;SG;SBJV;PRS	ondule	ondule
Generate the inflected form for: ensaiar V;2;SG;SBJV;FUT	ensaiares	ensaiares
Generate the inflected form for: prover V;3;SG;COND	proveria	proveria
Generate the inflected form for: tagarelar V.PTCP;MASC;PL;PST	tagarelados	tagarelados
Generate the inflected form for: fallecer V;2;SG;SBJV;PRS	falleças	falleças
Generate the inflected form for: relacionar V;3;PL;IMP;NEG	relacionem	relacionem
Generate the inflected form for: concordar V;3;PL;IND;PST;IPFV	concordavam	concordavam
Generate the inflected form for: assemelhar V;3;PL;COND	assemelhariam	assemelhariam
Generate the inflected form for: filtrar V;2;PL;SBJV;FUT	filtrardes	filtrardes
Generate the inflected form for: engendrar V;1;SG;IND;PRS	engendro	engendro
Generate the inflected form for: proliferar V;3;SG;SBJV;PRS	prolifere	prolifere
Generate the inflected form for: silenciar V;2;PL;IMP;NEG	silencieis	silencieis
Generate the inflected form for: denominar V;1;PL;IND;PRS	denominamos	denominamos
Generate the inflected form for: mumificar V;2;PL;IMP;POS	mumificai	mumificai
Generate the inflected form for: complicar V;2;PL;IND;PST;PFV	complicastes	complicastes
Generate the inflected form for: terminar V;1;PL;IND;PST;PRF	termináramos	termináramos
Generate the inflected form for: bombardear V.PTCP;FEM;PL;PST	bombardeadas	bombardeadas
Generate the inflected form for: desossar V;1;SG;SBJV;PST;IPFV	desossasse	desossasse
Generate the inflected form for: remunerar V;3;SG;IND;PST;PFV	remunerou	remunerou
Generate the inflected form for: recriar V;2;PL;IND;PST;PRF	recriáreis	recriáreis
Generate the inflected form for: enraivecer V;2;PL;COND	enraiveceríeis	enraiveceríeis
Generate the inflected form for: designar V;2;PL;IND;PST;PFV	designastes	designastes
Generate the inflected form for: damnar V;1;PL;IND;PRS	damnamos	damnamos
Generate the inflected form for: adequar V;3;SG;IND;PST;IPFV	adequava	adequava
Generate the inflected form for: complicar V;1;PL;SBJV;FUT	complicarmos	complicarmos
Generate the inflected form for: blasonar V;1;PL;IND;FUT	blasonaremos	blasonaremos
Generate the inflected form for: interpelar V;2;SG;IND;PST;PRF	interpelaras	interpelaras
Generate the inflected form for: gatunar V;3;SG;IND;PRS	gatuna	gatuna
Generate the inflected form for: contrair V;3;PL;IMP;NEG	contraam	contraiam
Generate the inflected form for: engastar V;1;SG;SBJV;PRS	engaste	engaste
Generate the inflected form for: acreditar V;1;PL;IND;PST;PRF	acreditáramos	acreditáramos
Generate the inflected form for: compensar V;1;PL;IND;FUT	compensaremos	compensaremos
Generate the inflected form for: achatar V;NFIN	achatar	achatar
Generate the inflected form for: olhar V;2;PL;IND;PST;PFV	olhastes	olhastes
Generate the inflected form for: talhar V;1;SG;NFIN	talhar	talhar
Generate the inflected form for: redimir V.PTCP;MASC;PL;PST	redimidos	redimidos
Generate the inflected form for: lapidar V;NFIN	lapidar	lapidar
Generate the inflected form for: indiciar V;2;SG;IND;PST;PFV	indiciaste	indiciaste
Generate the inflected form for: arquivar V;3;PL;IND;PST;PFV	arquivaram	arquivaram
Generate the inflected form for: arquejar V;2;PL;COND	arquejaríeis	arquejaríeis
Generate the inflected form for: cumprir V;1;PL;NFIN	cumprirmos	cumprirmos
Generate the inflected form for: estipular V;1;PL;SBJV;PRS	estipulemos	estipulemos
Generate the inflected form for: encetar V.PTCP;MASC;SG;PST	encetado	encetado
Generate the inflected form for: abscindir V;2;SG;SBJV;PRS	abscindas	abscindas
Generate the inflected form for: supurar V;2;SG;SBJV;PST;IPFV	supurasses	supurasses
Generate the inflected form for: ablegar V;1;PL;SBJV;FUT	ablegarmos	ablegarmos
Generate the inflected form for: resplendecer V.PTCP;FEM;SG;PST	resplendecida	resplendecida
Generate the inflected form for: charquear V;2;PL;IND;PST;PRF	charqueáreis	charqueáreis
Generate the inflected form for: enrubescer V;1;SG;IND;PST;PFV	enrubesci	enrubesci
Generate the inflected form for: aclamar V;1;PL;SBJV;FUT	aclamarmos	aclamarmos
Generate the inflected form for: anteceder V;3;SG;SBJV;FUT	anteceder	anteceder
Generate the inflected form for: criticar V;3;SG;IND;FUT	criticará	criticará
Generate the inflected form for: expectorar V;3;SG;IND;PRS	expectora	expectora
Generate the inflected form for: comprehender V;1;SG;IND;FUT	comprehenderei	comprehenderei
Generate the inflected form for: inquirir V;2;PL;SBJV;PST;IPFV	inquirísseis	inquirísseis
Generate the inflected form for: incorporar V;3;SG;IND;PRS	incorpora	incorpora
Generate the inflected form for: sufocar V;2;PL;IND;PST;IPFV	sufocáveis	sufocáveis
Generate the inflected form for: estimar V;2;SG;IND;PRS	estimas	estimas
Generate the inflected form for: desentranhar V;3;SG;COND	desentranharia	desentranharia
Generate the inflected form for: achatar V;3;SG;IMP;NEG	achate	achate
Generate the inflected form for: anteceder V;1;PL;IND;PST;PFV	antecedíamos	antecedemos
Generate the inflected form for: adoecer V.PTCP;FEM;SG;PST	adoecida	adoecida
Generate the inflected form for: interferir V;3;SG;SBJV;PST;IPFV	interferisse	interferisse
Generate the inflected form for: protrair V.PTCP;FEM;PL;PST	protraídas	protraídas
Generate the inflected form for: charquear V;1;PL;IND;PST;PFV	charqueámos	charqueámos
Generate the inflected form for: ousar V;1;SG;NFIN	ousar	ousar
Generate the inflected form for: adequar V.PTCP;FEM;SG;PST	adequada	adequada
Generate the inflected form for: denominar V;1;PL;IND;PST;PRF	denomináramos	denomináramos
Generate the inflected form for: estercar V;3;PL;IND;FUT	estercarão	estercarão
Generate the inflected form for: economizar V.PTCP;MASC;PL;PST	economizados	economizados
Generate the inflected form for: afundir V;3;SG;IND;PST;PFV	afundiu	afundiu
Generate the inflected form for: visitar V;1;SG;IND;PST;IPFV	visitava	visitava
Generate the inflected form for: condecorar V;2;PL;COND	condecoraríeis	condecoraríeis
Generate the inflected form for: adoecer V.PTCP;MASC;PL;PST	adoecidos	adoecidos
Generate the inflected form for: cumprimentar V;1;PL;IND;FUT	cumprimentaremos	cumprimentaremos
Generate the inflected form for: agradar V;2;PL;SBJV;FUT	agradardes	agradardes
Generate the inflected form for: prevalecer V;1;PL;IND;PRS	prevalecemos	prevalecemos
Generate the inflected form for: abafar V.PTCP;MASC;SG;PST	abafado	abafado
Generate the inflected form for: flutuar V;3;SG;IND;FUT	flutuará	flutuará
Generate the inflected form for: objetar V;1;PL;IND;PST;PFV	objetámos	objetámos
Generate the inflected form for: escassear V.PTCP;FEM;SG;PST	escasseada	escasseada
Generate the inflected form for: alojar V;2;PL;IND;FUT	alojareis	alojareis
Generate the inflected form for: pagar V;2;PL;IND;PST;IPFV	pagáveis	pagáveis
Generate the inflected form for: cintar V;1;PL;IND;PST;IPFV	cintávamos	cintávamos
Generate the inflected form for: tanger V;1;PL;IMP;NEG	tanjamos	tanjamos
Generate the inflected form for: consolidar V;3;SG;IND;PST;IPFV	consolidava	consolidava
Generate the inflected form for: amaynar V;1;SG;IND;PRS	amayno	amayno
Generate the inflected form for: condenar V;3;SG;IND;FUT	condenará	condenará
Generate the inflected form for: desistir V;2;SG;SBJV;PRS	desistas	desistas
Generate the inflected form for: frequentar V;3;PL;SBJV;FUT	frequentarem	frequentarem
Generate the inflected form for: brincar V;1;PL;SBJV;PRS	brinquemos	brinquemos
Generate the inflected form for: visitar V;1;PL;SBJV;FUT	visitarmos	visitarmos
Generate the inflected form for: vocalizar V;1;SG;IND;PRS	vocalizo	vocalizo
Generate the inflected form for: safar V;3;PL;IND;PST;PRF	safaram	safaram
Generate the inflected form for: pregar V;3;SG;IND;PST;IPFV	pregava	pregava
Generate the inflected form for: encarcerar V;1;SG;SBJV;FUT	encarcerar	encarcerar
Generate the inflected form for: talhar V;3;SG;IMP;NEG	talhe	talhe
Generate the inflected form for: saturar V;3;PL;IND;PST;PFV	saturaram	saturaram
Generate the inflected form for: remunerar V;2;PL;IND;PRS	remunerais	remunerais
Generate the inflected form for: anotar V;2;SG;IND;PST;PFV	anotaste	anotaste
Generate the inflected form for: apregoar V;1;SG;COND	apregoaria	apregoaria
Generate the inflected form for: sonambular V;2;SG;IMP;NEG	sonambules	sonambules
Generate the inflected form for: marchar V;1;SG;IND;FUT	marcharei	marcharei
Generate the inflected form for: seguir V;3;SG;IND;FUT	seguirá	seguirá
Generate the inflected form for: inquirir V;1;PL;SBJV;FUT	inquirirmos	inquirirmos
Generate the inflected form for: proliferar V;1;PL;IMP;NEG	proliferemos	proliferemos
Generate the inflected form for: desentranhar V;3;PL;IND;FUT	desentranharão	desentranharão
Generate the inflected form for: escavar V;1;PL;SBJV;FUT	escavarmos	escavarmos
Generate the inflected form for: ascender V;3;PL;IND;PST;PFV	ascenderam	ascenderam
Generate the inflected form for: segmentar V;2;SG;IND;PST;IPFV	segmentavas	segmentavas
Generate the inflected form for: desvairar V;3;PL;SBJV;PST;IPFV	desvairassem	desvairassem
Generate the inflected form for: ascender V;2;SG;SBJV;PST;IPFV	ascendesses	ascendesses
Generate the inflected form for: condecorar V;3;PL;IND;PRS	condecoram	condecoram
Generate the inflected form for: afundir V;2;SG;COND	afundirias	afundirias
Generate the inflected form for: escravizar V;1;SG;IND;PRS	escravizo	escravizo
Generate the inflected form for: regularizar V;3;SG;IND;PST;PRF	regularizara	regularizara
Generate the inflected form for: revelar V;1;PL;IND;PST;PFV	revelámos	revelámos
Generate the inflected form for: entrar V.PTCP;PRS	entrando	entrando
Generate the inflected form for: vir V;1;PL;SBJV;PST;IPFV	vissemos	viéssemos
Generate the inflected form for: pescar V;2;SG;NFIN	pescares	pescares
Generate the inflected form for: bombardear V;1;SG;NFIN	bombardear	bombardear
Generate the inflected form for: colorar V;2;PL;SBJV;PRS	coloreis	coloreis
Generate the inflected form for: surtar V;2;SG;SBJV;PRS	surtes	surtes
Generate the inflected form for: arrebentar V;3;PL;IND;PST;PFV	arrebentaram	arrebentaram
Generate the inflected form for: mastigar V;2;PL;SBJV;PRS	mastigeis	mastigueis
Generate the inflected form for: enrubescer V;1;PL;IND;PRS	enrubescemos	enrubescemos
Generate the inflected form for: privilegiar V;2;SG;SBJV;PST;IPFV	privilegiasses	privilegiasses
Generate the inflected form for: desossar V;NFIN	desossar	desossar
Generate the inflected form for: deificar V;3;SG;SBJV;FUT	deificar	deificar
Generate the inflected form for: vesguear V;3;PL;SBJV;PRS	vesgueiem	vesgueiem
Generate the inflected form for: alucinar V;2;PL;IMP;NEG	alucineis	alucineis
Generate the inflected form for: printar V;3;PL;IND;PST;IPFV	printavam	printavam
Generate the inflected form for: simpatizar V;1;SG;IND;FUT	simpatizarei	simpatizarei
Generate the inflected form for: ondular V;2;SG;SBJV;FUT	ondulares	ondulares
Generate the inflected form for: sobressair V;1;SG;SBJV;PRS	sobressea	sobressaia
Generate the inflected form for: escassear V;2;SG;SBJV;PST;IPFV	escasseassesses	escasseasses
Generate the inflected form for: maltar V;2;SG;IMP;NEG	maltes	maltes
Generate the inflected form for: delinear V;1;PL;SBJV;PRS	delineemos	delineemos
Generate the inflected form for: desistir V;2;PL;SBJV;PRS	desistais	desistais
Generate the inflected form for: secundar V;2;PL;SBJV;PRS	secundeis	secundeis
Generate the inflected form for: ensaiar V;2;PL;IND;PST;PRF	ensaiáreis	ensaiáreis
Generate the inflected form for: analisar V;2;SG;IND;PRS	analisas	analisas
Generate the inflected form for: sonambular V;2;PL;COND	sonambularíeis	sonambularíeis
Generate the inflected form for: alucinar V;1;PL;IND;PRS	alucinamos	alucinamos
Generate the inflected form for: comprehender V;2;PL;SBJV;PRS	comprehendais	comprehendais
Generate the inflected form for: molestar V;1;PL;NFIN	molestarmos	molestarmos
Generate the inflected form for: biotransformar V;1;PL;IMP;POS	biotransformemos	biotransformemos
Generate the inflected form for: pagar V;1;PL;COND	pagaríamos	pagaríamos
Generate the inflected form for: designar V;1;PL;IND;PST;PFV	designámos	designámos
Generate the inflected form for: engendrar V;2;SG;IMP;POS	engendra	engendra
Generate the inflected form for: jazer V;3;PL;IND;PRS	jazem	jazem
Generate the inflected form for: tratar V;1;PL;SBJV;PRS	tratemos	tratemos
Generate the inflected form for: instigar V.PTCP;MASC;PL;PST	instigados	instigados
Generate the inflected form for: leiloar V;3;PL;SBJV;FUT	leiloarem	leiloarem
Generate the inflected form for: uivar V;2;PL;IND;PST;PRF	uiváreis	uiváreis
Generate the inflected form for: ludibriar V;2;SG;IMP;NEG	ludibries	ludibries
Generate the inflected form for: complicar V;1;PL;IMP;NEG	compliquemos	compliquemos
Generate the inflected form for: açacalar V.PTCP;FEM;SG;PST	açacalada	açacalada
Generate the inflected form for: escravizar V;1;SG;COND	escravizaria	escravizaria
Generate the inflected form for: colorar V;1;PL;SBJV;PST;IPFV	colorássemos	colorássemos
Generate the inflected form for: cagar V;NFIN	cagar	cagar
Generate the inflected form for: alucinar V.PTCP;FEM;SG;PST	alucinada	alucinada
Generate the inflected form for: blogar V;2;PL;COND	blogaríeis	blogaríeis
Generate the inflected form for: enrubescer V;2;PL;SBJV;FUT	enrubescerdes	enrubescerdes
Generate the inflected form for: cagar V;2;SG;SBJV;PST;IPFV	cagasses	cagasses
Generate the inflected form for: conjecturar V;3;SG;COND	conjecturaria	conjecturaria
Generate the inflected form for: assoprar V;3;PL;IMP;POS	assoprem	assoprem
Generate the inflected form for: destratar V;3;SG;IMP;NEG	destrate	destrate
Generate the inflected form for: crochetar V;2;SG;IND;PST;IPFV	crochetavas	crochetavas
Generate the inflected form for: aquaplanar V;3;PL;IND;PST;IPFV	aquaplanavam	aquaplanavam
Generate the inflected form for: surtar V;1;SG;COND	surtaria	surtaria
Generate the inflected form for: silenciar V;3;PL;SBJV;PRS	silenciem	silenciem
Generate the inflected form for: latir V;3;SG;SBJV;PRS	lata	lata
Generate the inflected form for: frequentar V;NFIN	frequentar	frequentar
Generate the inflected form for: içar V;1;PL;IND;FUT	içaremos	içaremos
Generate the inflected form for: sinterizar V;3;SG;IND;PRS	sinteriza	sinteriza
Generate the inflected form for: flutuar V;2;SG;SBJV;FUT	flutuares	flutuares
Generate the inflected form for: leiloar V;1;SG;IND;PST;IPFV	leiloava	leiloava
Generate the inflected form for: blogar V;3;PL;IND;PST;PFV	blogaram	blogaram
Generate the inflected form for: lambujar V;2;SG;NFIN	lambujares	lambujares
Generate the inflected form for: printar V;2;PL;IND;FUT	printareis	printareis
Generate the inflected form for: impregnar V;2;PL;IMP;POS	impregnai	impregnai
Generate the inflected form for: attentar V;1;SG;IND;PST;PRF	attentara	attentara
Generate the inflected form for: arianizar V;2;PL;IMP;NEG	arianizeis	arianizeis
Generate the inflected form for: marchar V;3;PL;IND;FUT	marcharão	marcharão
Generate the inflected form for: arquejar V;1;PL;IMP;POS	arquejemos	arquejemos
Generate the inflected form for: encriptar V;2;SG;SBJV;PST;IPFV	encriptasses	encriptasses
Generate the inflected form for: manjar V;2;PL;IND;PST;PRF	manjáreis	manjáreis
Generate the inflected form for: alocar V;2;SG;IND;PST;PFV	alocaste	alocaste
Generate the inflected form for: vesguear V;3;PL;SBJV;FUT	vesguearem	vesguearem
Generate the inflected form for: encetar V;3;PL;SBJV;PST;IPFV	encetassem	encetassem
Generate the inflected form for: eliminar V;2;SG;IMP;NEG	elimines	elimines
Generate the inflected form for: ziguezaguear V;1;PL;SBJV;FUT	ziguezaguearmos	ziguezaguearmos
Generate the inflected form for: bombardear V;3;SG;SBJV;PST;IPFV	bombardeasse	bombardeasse
Generate the inflected form for: ladrar V;1;SG;IND;PST;PRF	ladrara	ladrara
Generate the inflected form for: amamentar V.PTCP;MASC;PL;PST	amamentados	amamentados
Generate the inflected form for: protrair V;3;PL;IMP;POS	protrai	protraiam
Generate the inflected form for: menosprezar V;2;SG;IND;FUT	menosprezarás	menosprezarás
Generate the inflected form for: botar V;3;SG;IMP;POS	bote	bote
Generate the inflected form for: ascender V;1;PL;IND;FUT	ascenderemos	ascenderemos
Generate the inflected form for: ruir V;3;PL;NFIN	ruirem	ruírem
Generate the inflected form for: munir V;1;PL;NFIN	munirmos	munirmos
Generate the inflected form for: estimular V;3;PL;SBJV;PRS	estimulem	estimulem
Generate the inflected form for: bombardear V;1;SG;IND;FUT	bombardearei	bombardearei
Generate the inflected form for: escassear V;3;PL;IND;FUT	escassearão	escassearão
Generate the inflected form for: registrar V;2;PL;NFIN	registrardes	registrardes
Generate the inflected form for: maquinar V;2;SG;SBJV;PRS	maquines	maquines
Generate the inflected form for: embasar V;3;SG;IMP;NEG	embase	embase
Generate the inflected form for: sonambular V;2;PL;IMP;POS	sonambulai	sonambulai
Generate the inflected form for: frequentar V;2;SG;SBJV;FUT	frequentares	frequentares
Generate the inflected form for: comprehender V;2;SG;NFIN	comprehenderes	comprehenderes
Generate the inflected form for: lambujar V;1;PL;SBJV;PRS	lambujemos	lambujemos
Generate the inflected form for: crescer V;1;PL;IND;PST;PFV	crescemos	crescemos
Generate the inflected form for: leiloar V;3;SG;IND;FUT	leiloará	leiloará
Generate the inflected form for: antidotar V;NFIN	antidotar	antidotar
Generate the inflected form for: sufocar V;1;SG;COND	sufocaria	sufocaria
Generate the inflected form for: rufar V;2;PL;IND;PST;PFV	rufastes	rufastes
Generate the inflected form for: estrumar V.PTCP;MASC;SG;PST	estrumado	estrumado
Generate the inflected form for: registar V;2;SG;IND;PST;PRF	registaras	registaras
Generate the inflected form for: postular V.PTCP;FEM;SG;PST	postulada	postulada
Generate the inflected form for: anabolizar V;2;PL;SBJV;PRS	anabolizeis	anabolizeis
Generate the inflected form for: printar V;2;SG;COND	printarias	printarias
Generate the inflected form for: desvairar V;NFIN	desvairar	desvairar
Generate the inflected form for: desrespeitar V.PTCP;MASC;SG;PST	desrespeitado	desrespeitado
Generate the inflected form for: prover V;2;SG;SBJV;PST;IPFV	provisses	provesses
Generate the inflected form for: comichar V;1;PL;IND;PST;IPFV	comichávamos	comichávamos
Generate the inflected form for: telhar V;1;PL;IMP;NEG	telhemos	telhemos
Generate the inflected form for: assemelhar V;3;SG;IMP;POS	assemelhe	assemelhe
Generate the inflected form for: simpatizar V;1;SG;SBJV;PST;IPFV	simpatizasse	simpatizasse
Generate the inflected form for: deliciar V;3;PL;COND	deliciariam	deliciariam
Generate the inflected form for: flutuar V;1;SG;SBJV;PST;IPFV	flutuasse	flutuasse
Generate the inflected form for: ladrar V;3;PL;IND;PST;PFV	ladraram	ladraram
Generate the inflected form for: expectorar V;1;SG;NFIN	expectorar	expectorar
Generate the inflected form for: munir V;2;SG;NFIN	munires	munires
Generate the inflected form for: destratar V;3;PL;IND;PST;PFV	destrataram	destrataram
Generate the inflected form for: estocar V;3;SG;IND;PST;PRF	estocara	estocara
Generate the inflected form for: kickar V;1;PL;SBJV;PST;IPFV	kickássemos	kickássemos
Generate the inflected form for: ponderar V;3;PL;SBJV;FUT	ponderarem	ponderarem
Generate the inflected form for: desarmar V;1;SG;IND;PRS	desarmo	desarmo
Generate the inflected form for: terminar V.PTCP;FEM;PL;PST	terminadas	terminadas
Generate the inflected form for: antidotar V;3;SG;IMP;NEG	antidote	antidote
Generate the inflected form for: remunerar V;1;PL;IND;PST;IPFV	remunerávamos	remunerávamos
Generate the inflected form for: vomitar V;1;SG;NFIN	vomitar	vomitar
Generate the inflected form for: ponderar V;2;SG;IMP;NEG	ponderes	ponderes
Generate the inflected form for: vesguear V.PTCP;MASC;PL;PST	vesgueados	vesgueados
Generate the inflected form for: analisar V;2;SG;COND	analisarias	analisarias
Generate the inflected form for: realçar V.PTCP;MASC;PL;PST	realçados	realçados
Generate the inflected form for: arquivar V;1;SG;IND;PST;PFV	arquivei	arquivei
Generate the inflected form for: secundar V;3;SG;IND;PST;PFV	secundou	secundou
Generate the inflected form for: adjudicar V;2;PL;IND;PST;PFV	adjudicastes	adjudicastes
Generate the inflected form for: arianizar V;1;SG;COND	arianizaria	arianiz
Generate the inflected form for: açacalar V;2;SG;IMP;NEG	açacales	açacales
Generate the inflected form for: marchar V;2;SG;NFIN	marchares	marchares
Generate the inflected form for: desrespeitar V;2;PL;IND;PST;PRF	desrespeitáreis	desrespeitáreis
Generate the inflected form for: estimular V;2;PL;SBJV;PST;IPFV	estimulásseis	estimulásseis
Generate the inflected form for: abafar V;2;SG;NFIN	abafares	abafares
Generate the inflected form for: sobressair V;3;PL;COND	sobressairiam	sobressairiam
Generate the inflected form for: desentranhar V;1;PL;IND;FUT	desentranharemos	desentranharemos
Generate the inflected form for: blasonar V;1;PL;IMP;NEG	blasonemos	blasonemos
Generate the inflected form for: arrebentar V;3;SG;SBJV;PRS	arrebente	arrebente
Generate the inflected form for: simbolizar V;3;SG;NFIN	simbolizar	simbolizar
Generate the inflected form for: acortinar V;3;SG;IND;FUT	acortinará	acortinará
Generate the inflected form for: crochetar V;3;SG;IND;PST;PFV	crochetou	crochetou
Generate the inflected form for: açacalar V;2;SG;IND;PRS	açacalas	açacalas
Generate the inflected form for: cumprimentar V;1;SG;IND;FUT	cumprimentarei	cumprimentarei
Generate the inflected form for: vincular V;1;PL;IND;PRS	vinculamos	vinculamos
Generate the inflected form for: latir V;1;SG;SBJV;PST;IPFV	latisse	latisse
Generate the inflected form for: agradar V;2;SG;SBJV;PRS	agrades	agrades
Generate the inflected form for: silenciar V.PTCP;FEM;SG;PST	silenciada	silenciada
Generate the inflected form for: derrapar V;2;SG;COND	derraparias	derraparias
Generate the inflected form for: desentranhar V;2;SG;IND;PST;PFV	desentranhaste	desentranhaste
Generate the inflected form for: botar V;3;SG;IND;PST;PRF	botara	botara
Generate the inflected form for: escavar V;1;SG;IND;PRS	escavo	escavo
Generate the inflected form for: sobressair V;3;SG;COND	sobressairia	sobressairia
Generate the inflected form for: zumbificar V;1;SG;SBJV;PST;IPFV	zumbificasse	zumbificasse
Generate the inflected form for: confraternizar V;2;SG;SBJV;PST;IPFV	confraternizasses	confraternizasses
Generate the inflected form for: parcelar V;3;SG;SBJV;PST;IPFV	parcelasse	parcelasse
Generate the inflected form for: prender V;2;SG;COND	prenderias	prenderias
Generate the inflected form for: sociabilizar V;2;PL;SBJV;PST;IPFV	sociabilizásseis	sociabilizásseis
Generate the inflected form for: alocar V;1;PL;COND	alocaríamos	alocaríamos
Generate the inflected form for: comprehender V;1;SG;SBJV;PRS	comprehenda	comprehenda
Generate the inflected form for: fatorar V;3;PL;NFIN	fatorarem	fatorarem
Generate the inflected form for: terminar V;3;SG;IMP;POS	termine	termine
Generate the inflected form for: adoecer V;2;SG;COND	adoecerias	adoecerias
Generate the inflected form for: agradar V;1;PL;IND;PRS	agradamos	agradamos
Generate the inflected form for: retaliar V;3;SG;NFIN	retaliar	retaliar
Generate the inflected form for: vomitar V;3;SG;IND;PST;PFV	vomitou	vomitou
Generate the inflected form for: resplandecer V;1;PL;COND	resplandeceríamos	resplandeceríamos
Generate the inflected form for: designar V;3;SG;SBJV;FUT	designar	designar
Generate the inflected form for: adjudicar V;1;SG;SBJV;PRS	adjudique	adjudique
Generate the inflected form for: adivinhar V;2;PL;IND;FUT	adivinhareis	adivinhareis
Generate the inflected form for: instigar V;2;SG;SBJV;PRS	instigues	instigues
Generate the inflected form for: inquirir V;3;PL;IMP;POS	inquiram	inquiram
Generate the inflected form for: mutilar V;3;PL;IND;PST;IPFV	mutilavam	mutilavam
Generate the inflected form for: entrar V;1;SG;COND	entraria	entraria
Generate the inflected form for: denominar V;1;SG;IND;FUT	denominarei	denominarei
Generate the inflected form for: guarnecer V;2;SG;IND;PST;PFV	guarneceste	guarneceste
Generate the inflected form for: desentranhar V;2;PL;IND;PST;PRF	desentranháreis	desentranháreis
Generate the inflected form for: desdizer V;1;SG;NFIN	desdir	desdizer
Generate the inflected form for: arquivar V;1;PL;IND;PST;PRF	arquiváramos	arquiváramos
Generate the inflected form for: seguir V;1;SG;SBJV;PRS	seja	siga
Generate the inflected form for: redimir V;3;SG;IND;PST;PFV	redimou	redimiu
Generate the inflected form for: tretar V;2;SG;SBJV;FUT	tretares	tretares
Generate the inflected form for: teorizar V;2;PL;IND;PST;IPFV	teorizáveis	teorizáveis
Generate the inflected form for: escassear V;3;SG;IND;PST;PFV	escasseou	escasseou
Generate the inflected form for: impregnar V;3;SG;IND;PST;PRF	impregnara	impregnara
Generate the inflected form for: açacalar V;1;SG;IND;PST;IPFV	açacalava	açacalava
Generate the inflected form for: encomendar V;2;PL;IND;PST;IPFV	encomendáveis	encomendáveis
Generate the inflected form for: festar V;3;SG;IND;PST;IPFV	festava	festava
Generate the inflected form for: encetar V;3;SG;IND;FUT	encetará	encetará
Generate the inflected form for: tanger V;2;PL;SBJV;PST;IPFV	tangêsseis	tangêsseis
Generate the inflected form for: encetar V;2;PL;IMP;NEG	enceteis	enceteis
Generate the inflected form for: instigar V;3;PL;SBJV;PST;IPFV	instigassem	instigassem
Generate the inflected form for: maltar V;1;SG;SBJV;PST;IPFV	maltasse	maltasse
Generate the inflected form for: entrar V;3;PL;NFIN	entrarem	entrarem
Generate the inflected form for: visar V;3;PL;IND;PST;PRF	visaram	visaram
Generate the inflected form for: consolidar V;3;SG;SBJV;PST;IPFV	consolidasse	consolidasse
Generate the inflected form for: cumprir V;2;SG;NFIN	cumprires	cumprires
Generate the inflected form for: afundir V;3;SG;NFIN	afundir	afundir
Generate the inflected form for: expectorar V.PTCP;MASC;SG;PST	expectorado	expectorado
Generate the inflected form for: criticar V;2;SG;IMP;POS	critica	critica
Generate the inflected form for: desarranjar V.PTCP;FEM;PL;PST	desarranjadas	desarranjadas
Generate the inflected form for: refogar V;2;SG;SBJV;PST;IPFV	refogasses	refogasses
Generate the inflected form for: ziguezaguear V;1;SG;IND;PRS	ziguezagueo	ziguezagueio
Generate the inflected form for: bebericar V;2;SG;SBJV;PRS	beberiques	beberiques
Generate the inflected form for: publicitar V;3;SG;IND;PST;IPFV	publicitava	publicitava
Generate the inflected form for: blasonar V;2;PL;COND	blasonaríeis	blasonaríeis
Generate the inflected form for: inquirir V.PTCP;FEM;PL;PST	inquiridas	inquiridas
Generate the inflected form for: estimar V;2;SG;IND;FUT	estimarás	estimarás
Generate the inflected form for: uivar V;2;SG;SBJV;FUT	uivares	uivares
Generate the inflected form for: cuidar V;2;SG;IND;FUT	cuidarás	cuidarás
Generate the inflected form for: absceder V;2;PL;IND;PST;IPFV	abscedíeis	abscedíeis
Generate the inflected form for: alucinar V;1;SG;IND;FUT	alucinarei	alucinarei
Generate the inflected form for: designar V;3;PL;IND;PRS	designam	designam
Generate the inflected form for: aquaplanar V;3;PL;IND;PRS	aquaplanam	aquaplanam
Generate the inflected form for: deixar V;2;PL;IND;PST;PFV	deixastes	deixastes
Generate the inflected form for: agachar V;1;SG;IND;PST;PFV	agachei	agachei
Generate the inflected form for: simpatizar V;1;PL;IND;PST;IPFV	simpatizávamos	simpatizávamos
Generate the inflected form for: pegar V;2;PL;IND;PST;PFV	pegastes	pegastes
Generate the inflected form for: rufar V;2;PL;IND;PST;PRF	rufáreis	rufáreis
Generate the inflected form for: estercar V.PTCP;PRS	estercando	estercando
Generate the inflected form for: instigar V;3;PL;NFIN	instigarem	instigarem
Generate the inflected form for: citar V.PTCP;MASC;PL;PST	citados	citados
Generate the inflected form for: mumificar V;3;SG;SBJV;PRS	mumifique	mumifique
Generate the inflected form for: antidotar V;3;PL;IND;PST;PRF	antidotaram	antidotaram
Generate the inflected form for: bombardear V;2;PL;SBJV;FUT	bombardeardes	bombardeardes
Generate the inflected form for: predominar V.PTCP;MASC;SG;PST	predominado	predominado
Generate the inflected form for: concordar V;3;PL;NFIN	concordarem	concordarem
Generate the inflected form for: estocar V;1;SG;IND;FUT	estocarei	estocarei
Generate the inflected form for: visitar V;2;SG;IMP;POS	visita	visita
Generate the inflected form for: designar V;3;PL;SBJV;PRS	designem	designem
Generate the inflected form for: proceder V;3;SG;IMP;NEG	proceda	proceda
Generate the inflected form for: safar V;1;SG;COND	safaria	safaria
Generate the inflected form for: enramalhetar V;2;PL;COND	enramalhetaríeis	enramalhetaríeis
Generate the inflected form for: confraternizar V;2;PL;IMP;POS	confraternizai	confraternizai
Generate the inflected form for: impregnar V;2;PL;NFIN	impregnardes	impregnardes
Generate the inflected form for: abafar V;2;PL;IND;PST;PFV	abafastes	abafastes
Generate the inflected form for: deixar V;3;SG;IND;PST;PRF	deixara	deixara
Generate the inflected form for: abafar V;2;SG;IMP;POS	abafa	abafa
Generate the inflected form for: existir V;2;PL;COND	existiríeis	existiríeis
Generate the inflected form for: vir V;3;PL;IND;PST;PRF	viram	vieram
Generate the inflected form for: deliciar V;1;PL;SBJV;PRS	deliciemos	deliciemos
Generate the inflected form for: saturar V;2;PL;IMP;POS	saturai	saturai
Generate the inflected form for: auferir V;3;SG;IND;PRS	auferi	aufere
Generate the inflected form for: regularizar V.PTCP;MASC;SG;PST	regularizado	regularizado
Generate the inflected form for: corroborar V;3;SG;IMP;POS	corrobore	corrobore
Generate the inflected form for: harmonizar V;1;SG;SBJV;PRS	harmonize	harmonize
Generate the inflected form for: auguriar V;2;PL;IND;FUT	auguriareis	auguriareis
Generate the inflected form for: vir V;2;PL;SBJV;PRS	vieis	venhais
Generate the inflected form for: reiterar V;3;PL;IMP;NEG	reiterem	reiterem
Generate the inflected form for: alfabetizar V;3;PL;COND	alfabetizariam	alfabetizariam
Generate the inflected form for: pisotear V;1;PL;NFIN	pisotearmos	pisotearmos
Generate the inflected form for: estipular V;2;SG;SBJV;FUT	estipulares	estipulares
Generate the inflected form for: ensaboar V;2;SG;IND;FUT	ensaboarás	ensaboarás
Generate the inflected form for: talhar V;2;SG;SBJV;FUT	talhares	talhares
Generate the inflected form for: criticar V;2;PL;SBJV;PST;IPFV	criticásseis	criticásseis
Generate the inflected form for: terminar V;2;SG;COND	terminarias	terminarias
Generate the inflected form for: derrapar V;2;PL;IND;PRS	derrapais	derrapais
Generate the inflected form for: brincar V;1;PL;IND;PRS	brincamos	brincamos
Generate the inflected form for: retinir V;2;SG;SBJV;PRS	retinas	retinas
Generate the inflected form for: enramalhetar V;2;SG;SBJV;PST;IPFV	enramalhetasses	enramalhetasses
Generate the inflected form for: estercar V;1;PL;SBJV;PST;IPFV	estercássemos	estercássemos
Generate the inflected form for: maltar V;2;PL;IND;FUT	maltareis	maltareis
Generate the inflected form for: commandar V;NFIN	commandar	commandar
Generate the inflected form for: gatunar V;2;SG;SBJV;PST;IPFV	gatunasses	gatunasses
Generate the inflected form for: amancebar V;3;PL;NFIN	amancebarem	amancebarem
Generate the inflected form for: deixar V;1;PL;SBJV;PRS	deixemos	deixemos
Generate the inflected form for: bombardear V;2;SG;IMP;NEG	bombardeies	bombardeies
Generate the inflected form for: escravizar V;1;SG;SBJV;FUT	escravizar	escravizar
Generate the inflected form for: amaynar V;2;PL;SBJV;PST;IPFV	amaynásseis	amaynásseis
Generate the inflected form for: delimitar V;3;SG;NFIN	delimitar	delimitar
Generate the inflected form for: sociabilizar V;2;PL;IMP;POS	sociabilizai	sociabilizai
Generate the inflected form for: blasonar V;2;PL;SBJV;PST;IPFV	blasonásseis	blasonásseis
Generate the inflected form for: tosar V;2;PL;IND;FUT	tosareis	tosareis
Generate the inflected form for: encriptar V;2;PL;SBJV;PRS	encripteis	encripteis
Generate the inflected form for: administrar V;1;PL;IND;FUT	administraremos	administraremos
Generate the inflected form for: ousar V;2;PL;IND;FUT	ousareis	ousareis
Generate the inflected form for: escassear V;2;PL;SBJV;FUT	escasseardes	escasseardes
Generate the inflected form for: adoecer V;3;SG;IND;PST;PRF	adoecera	adoecera
Generate the inflected form for: existir V;2;PL;SBJV;PST;IPFV	existísseis	existísseis
Generate the inflected form for: escassear V.PTCP;PRS	escasseando	escasseando
Generate the inflected form for: estipular V;3;SG;IMP;POS	estipule	estipule
Generate the inflected form for: estrumar V;3;PL;IND;PRS	estrumam	estrumam
Generate the inflected form for: incorporar V;2;SG;IND;PST;PRF	incorporaras	incorporaras
Generate the inflected form for: contrabalançar V;1;PL;NFIN	contrabalançarmos	contrabalançarmos
Generate the inflected form for: aparafusar V;3;PL;NFIN	aparafusarem	aparafusarem
Generate the inflected form for: contra-atacar V;2;PL;IND;PST;IPFV	contra-atacáveis	contra-atacáveis
Generate the inflected form for: ablegar V;1;PL;NFIN	ablegarmos	ablegarmos
Generate the inflected form for: patentear V;3;SG;IND;PST;IPFV	patenteava	patenteava
Generate the inflected form for: lesmar V;1;SG;IND;PRS	lesmo	lesmo
Generate the inflected form for: adoecer V;1;PL;SBJV;FUT	adoecermos	adoecermos
Generate the inflected form for: tilintar V;3;PL;IND;PRS	tilintam	tilintam
Generate the inflected form for: condenar V;2;PL;IND;PRS	condenais	condenais
Generate the inflected form for: ensaboar V;2;PL;IND;FUT	ensaboareis	ensaboareis
Generate the inflected form for: commandar V;3;SG;COND	commandaria	commandaria
Generate the inflected form for: delinear V;1;PL;IND;PST;PFV	delineámos	delineámos
Generate the inflected form for: ziguezaguear V;3;PL;SBJV;PRS	ziguezagueem	ziguezagueiem
Generate the inflected form for: colorar V;3;PL;SBJV;FUT	colorarem	colorarem
Generate the inflected form for: impregnar V;2;SG;SBJV;PST;IPFV	impregnasses	impregnasses
Generate the inflected form for: sinterizar V;1;PL;SBJV;PST;IPFV	sinterizássemos	sinterizássemos
Generate the inflected form for: atenazar V;2;PL;NFIN	atenazardes	atenazardes
Generate the inflected form for: teorizar V;3;SG;IND;FUT	teorizará	teorizará
Generate the inflected form for: alocar V;2;PL;IMP;POS	alocai	alocai
Generate the inflected form for: sociabilizar V;3;PL;SBJV;FUT	sociabilizarem	sociabilizarem
Generate the inflected form for: antidotar V;1;SG;IND;PST;PFV	antidotei	antidotei
Generate the inflected form for: conjecturar V;3;SG;IND;PRS	conjectura	conjectura
Generate the inflected form for: tilintar V;3;PL;COND	tilintariam	tilintariam
Generate the inflected form for: ascender V;3;SG;NFIN	ascender	ascender
Generate the inflected form for: aquaplanar V;2;PL;IND;PRS	aquaplanais	aquaplanais
Generate the inflected form for: incorporar V;2;PL;IMP;NEG	incorporeis	incorporeis
Generate the inflected form for: talhar V;2;SG;IND;PST;PRF	talharas	talharas
Generate the inflected form for: silenciar V;2;PL;IND;PST;PFV	silenciastes	silenciastes
Generate the inflected form for: reiterar V;1;PL;SBJV;FUT	reiterarmos	reiterarmos
Generate the inflected form for: contrair V;1;SG;IND;PST;PRF	contraíra	contraíra
Generate the inflected form for: privilegiar V;1;PL;SBJV;FUT	privilegiarmos	privilegiarmos
Generate the inflected form for: expectorar V;1;SG;COND	expectoraria	expectoraria
Generate the inflected form for: attentar V;1;PL;SBJV;FUT	attentarmos	attentarmos
Generate the inflected form for: expectorar V;3;PL;IND;PST;PFV	expectoraram	expectoraram
Generate the inflected form for: sinterizar V;3;PL;IND;PST;PRF	sinterizaram	sinterizaram
Generate the inflected form for: desdizer V;1;PL;IND;PRS	desdis	desdizemos
Generate the inflected form for: estimular V;1;SG;COND	estimularia	estimularia
Generate the inflected form for: saturar V;3;PL;NFIN	saturarem	saturarem
Generate the inflected form for: protrair V;3;PL;IND;PST;PFV	protrairam	protraíram
Generate the inflected form for: registar V;3;PL;IND;FUT	registarão	registarão
Generate the inflected form for: ousar V;3;PL;IND;PST;PRF	ousaram	ousaram
Generate the inflected form for: barbear V;1;PL;IND;PRS	barbeamos	barbeamos
Generate the inflected form for: torrar V;3;PL;IND;PRS	torram	torram
Generate the inflected form for: kickar V;3;PL;NFIN	kickarem	kickarem
Generate the inflected form for: liquefazer V;1;SG;IND;PST;PRF	liquefara	liquefizera
Generate the inflected form for: munir V;1;SG;NFIN	munir	munir
Generate the inflected form for: attentar V;1;SG;IND;FUT	attentarei	attentarei
Generate the inflected form for: liderar V.PTCP;FEM;PL;PST	lideradas	lideradas
Generate the inflected form for: grudar V;2;SG;IND;PRS	grudas	grudas
Generate the inflected form for: vesguear V;3;SG;SBJV;PRS	vesgueie	vesgueie
Generate the inflected form for: sortear V;1;SG;IND;PST;IPFV	sorteava	sorteava
Generate the inflected form for: arquejar V;2;SG;IND;PST;IPFV	arquejavas	arquejavas
Generate the inflected form for: arseniar V;3;PL;SBJV;PRS	arseniem	arseniem
Generate the inflected form for: entrar V;1;SG;SBJV;FUT	entrar	entrar
Generate the inflected form for: kickar V;1;PL;COND	kickaríamos	kickaríamos
Generate the inflected form for: recompensar V;1;PL;IND;FUT	recompensaremos	recompensaremos
Generate the inflected form for: vir V;2;SG;SBJV;PST;IPFV	visses	viesses
Generate the inflected form for: implicar V;3;SG;COND	implicaria	implicaria
Generate the inflected form for: apreciar V;2;PL;IND;PST;PRF	apreciáreis	apreciáreis
Generate the inflected form for: enramalhetar V;1;SG;SBJV;FUT	enramalhetar	enramalhetar
Generate the inflected form for: festar V;1;SG;SBJV;PST;IPFV	festasse	festasse
Generate the inflected form for: pescar V;3;SG;IND;PRS	pesca	pesca
Generate the inflected form for: enfileirar V;2;SG;IND;PST;IPFV	enfileiravas	enfileiravas
Generate the inflected form for: aclamar V;1;PL;IMP;NEG	aclamemos	aclamemos
Generate the inflected form for: teclar V;2;PL;IND;PST;PRF	tecláreis	tecláreis
Generate the inflected form for: derrapar V;2;SG;IMP;POS	derrapa	derrapa
Generate the inflected form for: sortear V;3;SG;COND	sortearia	sortearia
Generate the inflected form for: saltear V;3;PL;IND;PST;PFV	saltearam	saltearam
Generate the inflected form for: sufocar V;3;SG;IND;PST;PFV	sufocou	sufocou
Generate the inflected form for: agachar V;2;PL;IMP;NEG	agacheis	agacheis
Generate the inflected form for: arianizar V;3;PL;NFIN	arianizarem	arianizarem
Generate the inflected form for: registrar V;3;PL;IND;PRS	registram	registram
Generate the inflected form for: aparafusar V.PTCP;FEM;SG;PST	aparafusada	aparafusada
Generate the inflected form for: cuidar V;3;SG;COND	cuidaria	cuidaria
Generate the inflected form for: arquejar V;3;SG;IND;PST;PRF	arquejara	arquejara
Generate the inflected form for: vesguear V;1;SG;NFIN	vesguear	vesguear
Generate the inflected form for: estimar V;2;PL;COND	estimaríeis	estimaríeis
Generate the inflected form for: cotejar V;1;PL;SBJV;PST;IPFV	cotejássemos	cotejássemos
Generate the inflected form for: denominar V;2;SG;SBJV;FUT	denominares	denominares
Generate the inflected form for: desentranhar V;3;SG;IND;PST;IPFV	desentranhava	desentranhava
Generate the inflected form for: inflamar V;1;SG;SBJV;PRS	inflame	inflame
Generate the inflected form for: condecorar V;1;PL;IMP;POS	condecoremos	condecoremos
Generate the inflected form for: ascender V;2;SG;NFIN	ascenderes	ascenderes
Generate the inflected form for: acreditar V;2;SG;SBJV;PRS	acredites	acredites
Generate the inflected form for: compensar V;2;PL;IMP;POS	compensai	compensai
Generate the inflected form for: prender V;3;SG;IND;PRS	prende	prende
Generate the inflected form for: tanger V;2;SG;IMP;NEG	tanjas	tanjas
Generate the inflected form for: desiludir V;3;SG;SBJV;PRS	desiluda	desiluda
Generate the inflected form for: discar V;2;SG;IMP;POS	disca	disca
Generate the inflected form for: entabuar V;1;SG;IND;PST;PFV	entabuei	entabuei
Generate the inflected form for: recompensar V.PTCP;FEM;PL;PST	recompensadas	recompensadas
Generate the inflected form for: rimar V;2;PL;IND;PST;PFV	rimastes	rimastes
Generate the inflected form for: crescer V;3;SG;SBJV;PST;IPFV	crescesse	crescesse
Generate the inflected form for: menstruar V;2;PL;IND;PST;IPFV	menstruáveis	menstruáveis
Generate the inflected form for: manjar V;1;PL;IND;PRS	manjamos	manjamos
Generate the inflected form for: comendar V;1;PL;IND;PST;PFV	comendámos	comendámos
Generate the inflected form for: sobresair V;3;SG;IND;FUT	sobresairá	sobresairá
Generate the inflected form for: menosprezar V;1;SG;IND;PST;PRF	menosprezara	menosprezara
Generate the inflected form for: alegar V;3;PL;IMP;NEG	aleguem	aleguem
Generate the inflected form for: alojar V;2;SG;NFIN	alojares	alojares
Generate the inflected form for: estipular V;2;SG;SBJV;PRS	estipules	estipules
Generate the inflected form for: copular V.PTCP;FEM;SG;PST	copulada	copulada
Generate the inflected form for: adivinhar V;2;PL;SBJV;PRS	adivinheis	adivinheis
Generate the inflected form for: arianizar V;1;PL;IMP;NEG	arianizemos	arianizemos
Generate the inflected form for: munir V;3;SG;IND;PST;IPFV	munia	munia
Generate the inflected form for: aclamar V;3;PL;IND;FUT	aclamarão	aclamarão
Generate the inflected form for: sortear V;1;PL;SBJV;FUT	sortearmos	sortearmos
Generate the inflected form for: fluorar V;1;SG;IND;PST;PFV	fluorei	fluorei
Generate the inflected form for: papar V;3;PL;SBJV;FUT	paparem	paparem
Generate the inflected form for: attentar V;1;SG;SBJV;PST;IPFV	attentasse	attentasse
Generate the inflected form for: compensar V;2;PL;SBJV;PST;IPFV	compensásseis	compensásseis
Generate the inflected form for: derrapar V.PTCP;PRS	derrapando	derrapando
Generate the inflected form for: delimitar V;1;SG;IND;FUT	delimitarei	delimitarei
Generate the inflected form for: doar V;1;SG;NFIN	doar	doar
Generate the inflected form for: privilegiar V;2;SG;IMP;POS	privilegia	privilegia
Generate the inflected form for: achatar V;1;PL;SBJV;PRS	achatemos	achatemos
Generate the inflected form for: rimar V;3;SG;IND;PST;PRF	rimara	rimara
Generate the inflected form for: abarcar V;2;SG;IND;PST;PFV	abarcaste	abarcaste
Generate the inflected form for: deliciar V;3;SG;IND;PST;PFV	deliciou	deliciou
Generate the inflected form for: simbolizar V;2;SG;IMP;POS	simboliza	simboliza
Generate the inflected form for: registrar V;3;PL;SBJV;PST;IPFV	registrassem	registrassem
Generate the inflected form for: amancebar V;2;PL;IMP;NEG	amancebeis	amancebeis
Generate the inflected form for: formigar V;3;SG;IND;PST;PFV	formigou	formigou
Generate the inflected form for: guardar V;3;PL;COND	guardariam	guardariam
Generate the inflected form for: safar V;1;PL;IND;FUT	safaremos	safaremos
Generate the inflected form for: depenar V;3;PL;NFIN	depenarem	depenarem
Generate the inflected form for: talhar V;3;PL;SBJV;FUT	talharem	talharem
Generate the inflected form for: expectorar V;3;SG;IND;PST;IPFV	expectorava	expectorava
Generate the inflected form for: vomitar V;1;SG;IND;PST;PFV	vomitei	vomitei
Generate the inflected form for: algemar V;3;SG;IMP;POS	algeme	algeme
Generate the inflected form for: resplandecer V;1;PL;IND;PST;IPFV	resplandecíamos	resplandecíamos
Generate the inflected form for: talhar V.PTCP;MASC;PL;PST	talhados	talhados
Generate the inflected form for: raciocinar V;2;SG;IND;PRS	raciocinas	raciocinas
Generate the inflected form for: estocar V;2;SG;SBJV;PRS	estoques	estoques
Generate the inflected form for: tretar V;3;PL;NFIN	tretarem	tretarem
Generate the inflected form for: atenazar V;2;SG;IMP;POS	atenaza	atenaza
Generate the inflected form for: formigar V;3;PL;IND;PRS	formigam	formigam
Generate the inflected form for: fluorar V;2;PL;SBJV;PRS	fluoreis	fluoreis
Generate the inflected form for: gatunar V;1;SG;IND;PRS	gatuno	gatuno
Generate the inflected form for: arrebentar V;1;SG;IND;PRS	arrebento	arrebento
Generate the inflected form for: postular V;1;SG;SBJV;PST;IPFV	postulasse	postulasse
Generate the inflected form for: indiciar V;3;SG;NFIN	indiciar	indiciar
Generate the inflected form for: saturar V;2;PL;IND;PRS	saturais	saturais
Generate the inflected form for: aclamar V;1;SG;COND	aclamaria	aclamaria
Generate the inflected form for: tratar V;3;SG;IND;PST;PFV	tratou	tratou
Generate the inflected form for: encabular V.PTCP;PRS	encabulando	encabulando
Generate the inflected form for: latinar V;1;SG;IND;PST;PRF	latinara	latinara
Generate the inflected form for: comichar V;1;PL;NFIN	comicharmos	comicharmos
Generate the inflected form for: apedrejar V;3;PL;IND;PST;IPFV	apedrejavam	apedrejavam
Generate the inflected form for: contrabalançar V;2;PL;IMP;NEG	contrabalanceis	contrabalanceis
Generate the inflected form for: ruir V;1;SG;IND;PST;PRF	ruíra	ruíra
Generate the inflected form for: rimar V;NFIN	rimar	rimar
Generate the inflected form for: pagar V;3;PL;NFIN	pagarem	pagarem
Generate the inflected form for: contactar V;3;SG;IND;PST;PFV	contactou	contactou
Generate the inflected form for: depenar V;3;PL;IMP;POS	depenem	depenem
Generate the inflected form for: retardar V;2;SG;IND;PRS	retardas	retardas
Generate the inflected form for: copular V;3;SG;SBJV;PST;IPFV	copulasse	copulasse
Generate the inflected form for: prevalecer V;2;SG;NFIN	prevaleceres	prevaleceres
Generate the inflected form for: commandar V.PTCP;PRS	commandando	commandando
Generate the inflected form for: encabular V;1;SG;SBJV;FUT	encabular	encabular
Generate the inflected form for: condenar V;3;PL;SBJV;FUT	condenarem	condenarem
Generate the inflected form for: simpatizar V;NFIN	simpatizar	simpatizar
Generate the inflected form for: instigar V;1;PL;IMP;POS	instiguemos	instiguemos
Generate the inflected form for: aplainar V;2;SG;IND;FUT	aplainarás	aplainarás
Generate the inflected form for: vesguear V.PTCP;PRS	vesgueando	vesgueando
Generate the inflected form for: deixar V;1;PL;IND;FUT	deixaremos	deixaremos
Generate the inflected form for: pegar V;3;SG;SBJV;FUT	pegar	pegar
Generate the inflected form for: molestar V;1;SG;IND;PST;PRF	molestara	molestara
Generate the inflected form for: antidotar V;2;PL;SBJV;PRS	antidoteis	antidoteis
Generate the inflected form for: desiludir V;2;PL;COND	desiludiríeis	desiludiríeis
Generate the inflected form for: inflamar V;2;SG;SBJV;FUT	inflamares	inflamares
Generate the inflected form for: lambujar V;1;PL;COND	lambujaríamos	lambujaríamos
Generate the inflected form for: proliferar V;2;PL;IND;PRS	proliferais	proliferais
Generate the inflected form for: tosar V;2;PL;IMP;NEG	toseis	toseis
Generate the inflected form for: confraternizar V;2;PL;IND;FUT	confraternizareis	confraternizareis
Generate the inflected form for: torpedear V;2;PL;SBJV;PRS	torpedeeis	torpedeeis
Generate the inflected form for: revelar V;2;SG;IND;PRS	revelas	revelas
Generate the inflected form for: papar V;1;SG;IND;FUT	paparei	paparei
Generate the inflected form for: olear V;2;PL;NFIN	oleardes	oleardes
Generate the inflected form for: publicitar V;3;SG;IND;PRS	publicita	publicita
Generate the inflected form for: tretar V;1;SG;COND	tretaria	tretaria
Generate the inflected form for: proliferar V.PTCP;FEM;PL;PST	proliferadas	proliferadas
Generate the inflected form for: condenar V;2;PL;IND;PST;IPFV	condenáveis	condenáveis
Generate the inflected form for: estocar V;3;PL;SBJV;FUT	estocarem	estocarem
Generate the inflected form for: cagar V;3;SG;IMP;NEG	cague	cague
Generate the inflected form for: derrapar V;2;SG;IND;PST;IPFV	derrapavas	derrapavas
Generate the inflected form for: açacalar V;2;PL;SBJV;PRS	açacaleis	açacaleis
Generate the inflected form for: desvairar V;1;SG;SBJV;PST;IPFV	desvairasse	desvairasse
Generate the inflected form for: sangrar V;2;PL;IND;FUT	sangrareis	sangrareis
Generate the inflected form for: volver V.PTCP;MASC;SG;PST	volvido	volvido
Generate the inflected form for: papar V;2;PL;IND;PRS	papais	papais
Generate the inflected form for: corroborar V;3;SG;SBJV;FUT	corroborar	corroborar
Generate the inflected form for: pisotear V;1;PL;SBJV;PRS	pisoteemos	pisoteemos
Generate the inflected form for: attentar V;3;SG;COND	attentaria	attentaria
Generate the inflected form for: teorizar V;3;PL;SBJV;PST;IPFV	teorizassem	teorizassem
Generate the inflected form for: extinguir V;1;SG;IND;PST;IPFV	extinguia	extinguia
Generate the inflected form for: proliferar V;3;PL;IND;PRS	proliferam	proliferam
Generate the inflected form for: derrapar V;3;PL;COND	derrapariam	derrapariam
Generate the inflected form for: reiterar V;3;SG;IND;PST;IPFV	reiterava	reiterava
Generate the inflected form for: tosar V;1;SG;IND;PST;IPFV	tosava	tosava
Generate the inflected form for: remunerar V;2;SG;IND;PST;PFV	remuneraste	remuneraste
Generate the inflected form for: eliminar V;3;PL;SBJV;PRS	eliminem	eliminem
Generate the inflected form for: rastrejar V;2;SG;NFIN	rastrejares	rastrejares
Generate the inflected form for: supurar V;1;PL;SBJV;PRS	supuremos	supuremos
Generate the inflected form for: estocar V;2;PL;IND;PST;PFV	estocastes	estocastes
Generate the inflected form for: indiciar V;2;PL;IMP;POS	indiciai	indiciai
Generate the inflected form for: ensaboar V;2;SG;IMP;POS	ensaboa	ensaboa
Generate the inflected form for: pegar V;3;PL;IMP;POS	peguem	peguem
Generate the inflected form for: alojar V;1;PL;IND;PST;IPFV	alojávamos	alojávamos
Generate the inflected form for: sonambular V;3;PL;SBJV;PRS	sonambulem	sonambulem
Generate the inflected form for: formigar V;3;SG;SBJV;FUT	formigar	formigar
Generate the inflected form for: engendrar V;3;SG;IND;PST;PFV	engendrou	engendrou
Generate the inflected form for: latinar V;2;PL;IND;FUT	latinareis	latinareis
Generate the inflected form for: vomitar V;3;PL;SBJV;PRS	vomitem	vomitem
Generate the inflected form for: conjecturar V;1;SG;IND;PRS	conjecturo	conjecturo
Generate the inflected form for: excetuar V;2;PL;IMP;NEG	excetueis	excetueis
Generate the inflected form for: desafogar V;2;SG;IMP;POS	desafoga	desafoga
Generate the inflected form for: kickar V;3;PL;SBJV;FUT	kickarem	kickarem
Generate the inflected form for: existir V;1;PL;IMP;NEG	existamos	existamos
Generate the inflected form for: indiciar V;3;PL;COND	indiciariam	indiciariam
Generate the inflected form for: aquaplanar V;2;PL;SBJV;PRS	aquaplaneis	aquaplaneis
Generate the inflected form for: postular V;2;PL;IND;PRS	postulais	postulais
Generate the inflected form for: pregar V;2;SG;IMP;NEG	pregues	pregues
Generate the inflected form for: guarnecer V;2;PL;IND;PRS	guarneceis	guarneceis
Generate the inflected form for: designar V;1;SG;SBJV;PRS	designe	designe
Generate the inflected form for: desafogar V;3;PL;NFIN	desafogarem	desafogarem
Generate the inflected form for: latinar V;3;SG;SBJV;PRS	latine	latine
Generate the inflected form for: pagar V;2;PL;IND;PST;PRF	pagáreis	pagáreis
Generate the inflected form for: alocar V;1;SG;IND;PRS	aloco	aloco
Generate the inflected form for: ostracizar V;1;PL;SBJV;PST;IPFV	ostracizássemos	ostracizássemos
Generate the inflected form for: finalizar V.PTCP;PRS	finalizando	finalizando
Generate the inflected form for: expectorar V;1;SG;IND;PST;PRF	expectorara	expectorara
Generate the inflected form for: rufar V;1;PL;IND;PST;PRF	rufáramos	rufáramos
Generate the inflected form for: extinguir V.PTCP;FEM;PL;PST	extinguídas	extinguidas
Generate the inflected form for: proceder V;2;SG;SBJV;PRS	procedas	procedas
Generate the inflected form for: brunir V;2;SG;SBJV;PRS	brunas	brunas
Generate the inflected form for: bombardear V;1;PL;NFIN	bombardearmos	bombardearmos
Generate the inflected form for: redimir V;3;SG;IND;PRS	redime	redime
Generate the inflected form for: recompensar V;1;PL;COND	recompensaríamos	recompensaríamos
Generate the inflected form for: assemelhar V;1;SG;IND;PST;IPFV	assemelhava	assemelhava
Generate the inflected form for: lesmar V;3;PL;SBJV;PST;IPFV	lesmassem	lesmassem
Generate the inflected form for: arseniar V;3;SG;SBJV;PRS	arsenie	arsenie
Generate the inflected form for: recompensar V;2;PL;IND;PST;PRF	recompensáreis	recompensáreis
Generate the inflected form for: visar V;1;PL;IND;PST;PRF	visáramos	visáramos
Generate the inflected form for: adoecer V;3;SG;SBJV;PST;IPFV	adoecesse	adoecesse
Generate the inflected form for: entabuar V;1;PL;IND;PST;PRF	entabuáramos	entabuáramos
Generate the inflected form for: arseniar V;1;PL;IND;PST;PRF	arseniáramos	arseniáramos
Generate the inflected form for: arquivar V;1;SG;SBJV;PST;IPFV	arquivasse	arquivasse
Generate the inflected form for: remunerar V;NFIN	remunerar	remunerar
Generate the inflected form for: tilintar V;2;PL;IND;FUT	tilintareis	tilintareis
Generate the inflected form for: arquejar V;1;PL;IND;PST;PRF	arquejáramos	arquejáramos
Generate the inflected form for: estimar V;3;PL;IND;PST;PRF	estimaram	estimaram
Generate the inflected form for: amarrar V;3;PL;SBJV;FUT	amarrarem	amarrarem
Generate the inflected form for: entrar V;NFIN	entrar	entrar
Generate the inflected form for: lambujar V;2;PL;COND	lambujaríeis	lambujaríeis
Generate the inflected form for: jazer V;2;SG;IND;PST;PFV	jazeste	jazeste
Generate the inflected form for: contrabalançar V;1;SG;SBJV;PRS	contrabalance	contrabalance
Generate the inflected form for: commandar V;1;SG;COND	commandaria	commandaria
Generate the inflected form for: barbear V;2;PL;IMP;NEG	barbeeis	barbeeis
Generate the inflected form for: cumprimentar V;2;PL;COND	cumprimentaríeis	cumprimentaríeis
Generate the inflected form for: engastar V;1;SG;NFIN	engastar	engastar
Generate the inflected form for: rufar V;3;PL;SBJV;FUT	rufarem	rufarem
Generate the inflected form for: estercar V;3;SG;IND;PST;PFV	estercou	estercou
Generate the inflected form for: luctar V;3;SG;IND;PST;PFV	luctou	luctou
Generate the inflected form for: expectorar V;3;SG;IND;FUT	expectorará	expectorará
Generate the inflected form for: remunerar V;1;PL;IND;FUT	remuneraremos	remuneraremos
Generate the inflected form for: abocanhar V.PTCP;FEM;SG;PST	abocanhada	abocanhada
Generate the inflected form for: abscindir V;2;PL;SBJV;PST;IPFV	abscindísseis	abscindísseis
Generate the inflected form for: revelar V;2;PL;IMP;POS	revelai	revelai
Generate the inflected form for: escavar V;1;SG;IND;PST;PFV	escavei	escavei
Generate the inflected form for: conjecturar V;2;SG;IND;PST;PRF	conjecturaras	conjecturaras
Generate the inflected form for: agachar V;1;PL;IND;PST;PFV	agachámos	agachámos
Generate the inflected form for: maltar V;3;SG;SBJV;PST;IPFV	maltasse	maltasse
Generate the inflected form for: ruir V;1;PL;NFIN	ruirmos	ruirmos
Generate the inflected form for: tosar V;1;SG;COND	tosaria	tosaria
Generate the inflected form for: aventar V;2;SG;IND;PST;PRF	aventaras	aventaras
Generate the inflected form for: abarcar V.PTCP;FEM;SG;PST	abarcada	abarcada
Generate the inflected form for: simpatizar V;2;SG;IND;PST;PFV	simpatizaste	simpatizaste
Generate the inflected form for: deixar V;3;PL;COND	deixariam	deixariam
Generate the inflected form for: desiludir V;3;SG;SBJV;PST;IPFV	desiludisse	desiludisse
Generate the inflected form for: tratar V;2;PL;IND;PST;IPFV	tratáveis	tratáveis
Generate the inflected form for: respirar V;3;PL;SBJV;PST;IPFV	respirassem	respirassem
Generate the inflected form for: vomitar V;3;PL;IND;PST;PRF	vomitaram	vomitaram
Generate the inflected form for: registar V;1;PL;SBJV;PST;IPFV	registássemos	registássemos
Generate the inflected form for: assoprar V;2;SG;IND;FUT	assoprarás	assoprarás
Generate the inflected form for: içar V;3;PL;IND;FUT	içarão	içarão
Generate the inflected form for: inquirir V;1;PL;COND	inquiriríamos	inquiriríamos
Generate the inflected form for: aclamar V;1;PL;SBJV;PST;IPFV	aclamássemos	aclamássemos
Generate the inflected form for: aplainar V;3;PL;SBJV;FUT	aplainarem	aplainarem
Generate the inflected form for: apoteosar V;2;SG;IND;PST;PFV	apoteosaste	apoteosaste
Generate the inflected form for: saltear V;2;SG;IND;PRS	salteas	salteas
Generate the inflected form for: concordar V;1;PL;IND;PRS	concordamos	concordamos
Generate the inflected form for: reiterar V;1;SG;COND	reiteraria	reiteraria
Generate the inflected form for: confraternizar V;3;PL;SBJV;PST;IPFV	confraternizassem	confraternizassem
Generate the inflected form for: afundir V;3;SG;IMP;POS	afunda	afunda
Generate the inflected form for: apreciar V;3;SG;NFIN	apreciar	apreciar
Generate the inflected form for: vomitar V;2;SG;IND;FUT	vomitarás	vomitarás
Generate the inflected form for: arrebentar V;2;SG;IND;PST;PFV	arrebentaste	arrebentaste
Generate the inflected form for: incorporar V;3;PL;IND;FUT	incorporarão	incorporarão
Generate the inflected form for: ligar V;2;PL;SBJV;PST;IPFV	ligásseis	ligásseis
Generate the inflected form for: desdizer V;3;PL;SBJV;PRS	desdigam	desdigam
Generate the inflected form for: objetar V;1;SG;SBJV;PST;IPFV	objetasse	objetasse
Generate the inflected form for: mastigar V;2;PL;IND;PRS	mastigais	mastigais
Generate the inflected form for: desistir V;1;PL;IND;PRS	desistemos	desistimos
Generate the inflected form for: charquear V.PTCP;MASC;PL;PST	charqueados	charqueados
Generate the inflected form for: crescer V;2;SG;IMP;NEG	cresças	cresças
Generate the inflected form for: alucinar V;2;PL;IMP;POS	alucinai	alucinai
Generate the inflected form for: blogar V;3;SG;SBJV;FUT	blogar	blogar
Generate the inflected form for: pegar V;2;SG;IND;FUT	pegarás	pegarás
Generate the inflected form for: talhar V.PTCP;FEM;PL;PST	talhadas	talhadas
Generate the inflected form for: comichar V;1;PL;SBJV;FUT	comicharmos	comicharmos
Generate the inflected form for: destratar V;2;PL;IND;FUT	destratareis	destratareis
Generate the inflected form for: contrabalançar V;NFIN	contrabalançar	contrabalançar
Generate the inflected form for: auguriar V;2;PL;IND;PST;PFV	auguriastes	auguriastes
Generate the inflected form for: desarrazoar V;1;SG;IND;FUT	desarrazoarei	desarrazoarei
Generate the inflected form for: concordar V;2;PL;NFIN	concordardes	concordardes
Generate the inflected form for: objetar V;1;PL;NFIN	objetarmos	objetarmos
Generate the inflected form for: antidotar V.PTCP;FEM;PL;PST	antidotadas	antidotadas
Generate the inflected form for: desarmar V;3;SG;NFIN	desarmar	desarmar
Generate the inflected form for: indiciar V;3;PL;IND;PST;PFV	indiciaram	indiciaram
Generate the inflected form for: delinear V;1;PL;IMP;POS	delineemos	delineemos
Generate the inflected form for: sociabilizar V;3;PL;IMP;POS	sociabilizem	sociabilizem
Generate the inflected form for: copular V;1;SG;SBJV;PRS	copule	copule
Generate the inflected form for: resplandecer V;3;PL;IND;PST;PRF	resplandeceram	resplandeceram
Generate the inflected form for: criticar V;2;SG;IND;PST;PRF	criticaras	criticaras
Generate the inflected form for: direcionar V;1;SG;SBJV;FUT	direcionar	direcionar
Generate the inflected form for: teclar V;3;PL;IMP;POS	teclem	teclem
Generate the inflected form for: desarranjar V;1;SG;IND;PST;PRF	desarranjara	desarranjara
Generate the inflected form for: transitar V;2;SG;IND;FUT	transitarás	transitarás
Generate the inflected form for: protrair V;1;PL;IND;PST;PRF	protraíramos	protraíramos
Generate the inflected form for: commandar V;1;PL;SBJV;PST;IPFV	commandássemos	commandássemos
Generate the inflected form for: decrescer V;1;PL;IND;PST;PFV	decrescemos	decrescemos
Generate the inflected form for: vincular V;2;SG;SBJV;PST;IPFV	vinculasses	vinculasses
Generate the inflected form for: liquefazer V;1;SG;SBJV;FUT	liquefar	liquefizer
Generate the inflected form for: acreditar V;1;PL;IND;PST;IPFV	acreditávamos	acreditávamos
Generate the inflected form for: munir V;NFIN	munir	munir
Generate the inflected form for: punguear V;1;PL;COND	punguearíamos	punguearíamos
Generate the inflected form for: desafogar V;3;SG;IND;PRS	desafoga	desafoga
Generate the inflected form for: telar V;3;PL;IND;PST;IPFV	telavam	telavam
Generate the inflected form for: interferir V;2;SG;SBJV;FUT	interferires	interferires
Generate the inflected form for: consternar V;3;PL;IMP;NEG	consternem	consternem
Generate the inflected form for: polimerizar V;2;SG;SBJV;PST;IPFV	polimerizasses	polimerizasses
Generate the inflected form for: visitar V;1;SG;IND;PST;PRF	visitara	visitara
Generate the inflected form for: assemelhar V;1;SG;SBJV;PRS	assemelhe	assemelhe
Generate the inflected form for: saturar V;1;PL;IMP;POS	saturemos	saturemos
Generate the inflected form for: revelar V;1;SG;IND;PRS	revelo	revelo
Generate the inflected form for: amancebar V;3;PL;IND;FUT	amancebarão	amancebarão
Generate the inflected form for: ablegar V;3;PL;IND;PST;PRF	ablegaram	ablegaram
Generate the inflected form for: agradar V;3;SG;SBJV;PRS	agrade	agrade
Generate the inflected form for: entabuar V;2;SG;SBJV;PST;IPFV	entabuasses	entabuasses
Generate the inflected form for: deixar V;1;SG;SBJV;PRS	deixe	deixe
Generate the inflected form for: eliminar V;3;SG;IND;PST;IPFV	eliminava	eliminava
Generate the inflected form for: encarcerar V;2;PL;COND	encarceraríeis	encarceraríeis
Generate the inflected form for: expedir V.PTCP;FEM;PL;PST	expedidas	expedidas
Generate the inflected form for: surtar V;3;PL;COND	surtariam	surtariam
Generate the inflected form for: barbear V;2;SG;SBJV;FUT	barbeares	barbeares
Generate the inflected form for: ousar V;2;SG;IND;PST;PFV	ousaste	ousaste
Generate the inflected form for: saturar V;3;PL;IND;PST;PRF	saturaram	saturaram
Generate the inflected form for: ensaiar V;1;SG;SBJV;PST;IPFV	ensaiasse	ensaiasse
Generate the inflected form for: analisar V;2;SG;SBJV;PRS	analises	analises
Generate the inflected form for: convencer V;2;SG;COND	convencerias	convencerias
Generate the inflected form for: reconsiderar V;NFIN	reconsiderar	reconsiderar
Generate the inflected form for: aventar V;2;PL;SBJV;PRS	aventeis	aventeis
Generate the inflected form for: comendar V;2;PL;SBJV;FUT	comendardes	comendardes
Generate the inflected form for: zumbificar V.PTCP;MASC;SG;PST	zumbificado	zumbificado
Generate the inflected form for: papar V;3;SG;IND;PST;IPFV	papava	papava
Generate the inflected form for: engendrar V;3;PL;IMP;POS	engendrem	engendrem
Generate the inflected form for: escavar V;1;SG;SBJV;FUT	escavar	escavar
Generate the inflected form for: escravizar V;3;PL;IND;PRS	escravizam	escravizam
Generate the inflected form for: tagarelar V;3;SG;SBJV;FUT	tagarelar	tagarelar
Generate the inflected form for: desarranjar V;3;PL;IND;PST;PFV	desarranjaram	desarranjaram
Generate the inflected form for: desarranjar V;1;PL;NFIN	desarranjarmos	desarranjarmos
Generate the inflected form for: papar V;3;PL;SBJV;PRS	papem	papem
Generate the inflected form for: mastigar V;1;PL;IND;PRS	mastigamos	mastigamos
Generate the inflected form for: ziguezaguear V;2;SG;IND;PST;PFV	ziguezagueaste	ziguezagueaste
Generate the inflected form for: pisotear V;1;PL;SBJV;FUT	pisotearmos	pisotearmos
Generate the inflected form for: eliminar V;2;SG;IND;PST;IPFV	eliminavas	eliminavas
Generate the inflected form for: registar V;1;SG;NFIN	registar	registar
Generate the inflected form for: aquaplanar V;3;PL;NFIN	aquaplanarem	aquaplanarem
Generate the inflected form for: menstruar V;3;PL;IND;PST;PFV	menstruaram	menstruaram
Generate the inflected form for: pretender V;1;PL;IND;PST;PRF	pretendêramos	pretendêramos
Generate the inflected form for: volver V;NFIN	volver	volver
Generate the inflected form for: terminar V;3;PL;SBJV;PRS	terminem	terminem
Generate the inflected form for: teclar V;2;SG;IND;PRS	teclas	teclas
Generate the inflected form for: bombardear V;2;SG;IND;FUT	bombardearás	bombardearás
Generate the inflected form for: enramalhetar V;1;PL;IND;PST;IPFV	enramalhetávamos	enramalhetávamos
Generate the inflected form for: talhar V;1;SG;SBJV;FUT	talhar	talhar
Generate the inflected form for: tilintar V;2;SG;IND;PST;PFV	tilintaste	tilintaste
Generate the inflected form for: menstruar V;3;PL;COND	menstruariam	menstruariam
Generate the inflected form for: recompensar V;3;SG;IND;PST;IPFV	recompensava	recompensava
Generate the inflected form for: expectorar V;2;SG;IMP;POS	expectora	expectora
Generate the inflected form for: vincular V.PTCP;MASC;SG;PST	vinculado	vinculado
Generate the inflected form for: grudar V;1;PL;SBJV;FUT	grudarmos	grudarmos
Generate the inflected form for: içar V;3;SG;IND;FUT	içará	içará
Generate the inflected form for: fatorar V;1;SG;NFIN	fatorar	fatorar
Generate the inflected form for: alocar V;3;SG;SBJV;PST;IPFV	alocasse	alocasse
Generate the inflected form for: inquirir V;3;PL;IMP;NEG	inquiram	inquiram
Generate the inflected form for: amancebar V;1;SG;SBJV;PRS	amancebe	amancebe
Generate the inflected form for: pescar V;1;PL;IMP;NEG	pesquemos	pesquemos
Generate the inflected form for: miscrar V;3;SG;IND;PST;PRF	miscrara	miscrara
Generate the inflected form for: alegar V;3;PL;SBJV;FUT	alegarem	alegarem
Generate the inflected form for: proceder V;2;PL;NFIN	procederdes	procederdes
Generate the inflected form for: festar V.PTCP;PRS	festando	festando
Generate the inflected form for: vesguear V;2;PL;IND;PST;PRF	vesgueáreis	vesgueáreis
Generate the inflected form for: desossar V;3;SG;IMP;NEG	desosse	desosse
Generate the inflected form for: retinir V;NFIN	retinir	retinir
Generate the inflected form for: abocanhar V;2;PL;NFIN	abocanhardes	abocanhardes
Generate the inflected form for: ondular V;1;SG;SBJV;PRS	ondule	ondule
Generate the inflected form for: administrar V;3;SG;IND;PRS	administra	administra
Generate the inflected form for: abarcar V;2;SG;SBJV;FUT	abarcares	abarcares
Generate the inflected form for: decrescer V;3;PL;SBJV;PRS	decresçam	decresçam
Generate the inflected form for: sociabilizar V;1;PL;NFIN	sociabilizarmos	sociabilizarmos
Generate the inflected form for: indiciar V;1;PL;NFIN	indiciarmos	indiciarmos
Generate the inflected form for: maquinar V;3;SG;COND	maquinaria	maquinaria
Generate the inflected form for: entabuar V;2;SG;SBJV;FUT	entabuares	entabuares
Generate the inflected form for: analisar V;2;SG;IND;PST;PFV	analisaste	analisaste
Generate the inflected form for: ruir V;2;PL;SBJV;PRS	ruais	ruais
Generate the inflected form for: sufocar V;3;SG;NFIN	sufocar	sufocar
Generate the inflected form for: attentar V;1;SG;SBJV;FUT	attentar	attentar
Generate the inflected form for: cumprimentar V;2;PL;NFIN	cumprimentardes	cumprimentardes
Generate the inflected form for: complicar V;1;PL;SBJV;PST;IPFV	complicássemos	complicássemos
Generate the inflected form for: registar V;2;PL;IND;PRS	registais	registais
Generate the inflected form for: torrar V;2;PL;SBJV;FUT	torrardes	torrardes
Generate the inflected form for: reiterar V.PTCP;FEM;PL;PST	reiteradas	reiteradas
Generate the inflected form for: miscrar V;2;SG;IMP;POS	miscra	miscra
Generate the inflected form for: inquirir V;1;SG;IND;PRS	inquiro	inquiro
Generate the inflected form for: cuidar V;2;PL;SBJV;PST;IPFV	cuidásseis	cuidásseis
Generate the inflected form for: estrumar V;2;PL;NFIN	estrumardes	estrumardes
Generate the inflected form for: sobressair V;3;PL;IND;PST;PRF	sobressairam	sobressaíram
Generate the inflected form for: apatetar V;2;PL;IMP;POS	apatetai	apatetai
Generate the inflected form for: contrair V;3;SG;COND	contrairia	contrairia
Generate the inflected form for: apoteosar V;3;SG;IMP;NEG	apoteose	apoteose
Generate the inflected form for: escravizar V;2;SG;NFIN	escravizares	escravizares
Generate the inflected form for: flutuar V;3;PL;IND;PST;IPFV	flutuavam	flutuavam
Generate the inflected form for: assignalar V;1;SG;SBJV;PST;IPFV	assignalasse	assignalasse
Generate the inflected form for: munir V;2;SG;IND;PST;IPFV	munias	munias
Generate the inflected form for: zumbificar V;3;SG;SBJV;FUT	zumbificar	zumbificar
Generate the inflected form for: munir V;2;SG;IND;PST;PRF	muniras	muniras
Generate the inflected form for: talhar V;3;PL;IND;PST;IPFV	talhavam	talhavam
Generate the inflected form for: telhar V;3;PL;IND;FUT	telharão	telharão
Generate the inflected form for: designar V;1;PL;IMP;NEG	designemos	designemos
Generate the inflected form for: predominar V;2;PL;SBJV;PST;IPFV	predominásseis	predominásseis
Generate the inflected form for: copular V;2;SG;NFIN	copulares	copulares
Generate the inflected form for: predominar V;3;PL;IND;FUT	predominarão	predominarão
Generate the inflected form for: abscindir V;NFIN	abscindir	abscindir
Generate the inflected form for: contrabalançar V;3;SG;IND;FUT	contrabalançará	contrabalançará
Generate the inflected form for: simpatizar V;2;SG;COND	simpatizarias	simpatizarias
Generate the inflected form for: fluorar V;3;PL;IMP;NEG	fluorem	fluorem
Generate the inflected form for: ocorrer V;1;PL;NFIN	ocorrermos	ocorrermos
Generate the inflected form for: liquefazer V;2;SG;IND;PRS	liquefazes	liquefazes
Generate the inflected form for: ligar V;3;SG;SBJV;PRS	ligue	ligue
Generate the inflected form for: comprehender V;2;PL;IND;PST;PRF	comprehendêreis	comprehendêreis
Generate the inflected form for: desarranjar V;2;PL;IND;PST;PRF	desarranjáreis	desarranjáreis
Generate the inflected form for: mutilar V;2;PL;SBJV;PST;IPFV	mutilásseis	mutilásseis
Generate the inflected form for: visitar V;2;SG;SBJV;FUT	visitares	visitares
Generate the inflected form for: encomendar V.PTCP;MASC;PL;PST	encomendados	encomendados
Generate the inflected form for: alegar V;1;SG;IND;PST;IPFV	alegava	alegava
Generate the inflected form for: jazer V.PTCP;FEM;SG;PST	jazida	jazida
Generate the inflected form for: convencer V;2;PL;IND;PST;PFV	convencestes	convencestes
Generate the inflected form for: escavar V;2;SG;IMP;POS	escava	escava
Generate the inflected form for: vesguear V;1;PL;NFIN	vesguearmos	vesguearmos
Generate the inflected form for: encharcar V.PTCP;PRS	encharcando	encharcando
Generate the inflected form for: copular V;2;PL;IND;FUT	copulareis	copulareis
Generate the inflected form for: achatar V;3;SG;IND;PST;PRF	achatara	achatara
Generate the inflected form for: remunerar V;3;PL;IMP;POS	remunerem	remunerem
Generate the inflected form for: estipular V;1;SG;SBJV;PST;IPFV	estipulasse	estipulasse
Generate the inflected form for: resplendecer V;3;SG;IND;FUT	resplendecerá	resplendecerá
Generate the inflected form for: papar V;3;SG;IND;FUT	papará	papará
Generate the inflected form for: engastar V;3;PL;IND;PST;PFV	engastaram	engastaram
Generate the inflected form for: mutilar V;1;PL;IND;PRS	mutilamos	mutilamos
Generate the inflected form for: nublar V;3;PL;SBJV;FUT	nublarem	nublarem
Generate the inflected form for: capotar V;2;SG;IND;PST;IPFV	capotavas	capotavas
Generate the inflected form for: damnar V;2;PL;NFIN	damnardes	damnardes
Generate the inflected form for: afundir V;3;PL;SBJV;PRS	afundam	afundam
Generate the inflected form for: simbolizar V;3;SG;IMP;POS	simbolize	simbolize
Generate the inflected form for: resplandecer V;3;SG;COND	resplandeceria	resplandeceria
Generate the inflected form for: desenrolar V;2;SG;IMP;POS	desenrola	desenrola
Generate the inflected form for: fluorar V;2;SG;IMP;NEG	fluores	fluores
Generate the inflected form for: denominar V;2;SG;COND	denominarias	denominarias
Generate the inflected form for: anotar V;3;SG;IND;PST;IPFV	anotava	anotava
Generate the inflected form for: crescer V;2;PL;IND;PST;IPFV	crescíeis	crescíeis
Generate the inflected form for: olhar V;NFIN	olhar	olhar
Generate the inflected form for: apedrejar V;2;SG;IMP;NEG	apedrejes	apedrejes
Generate the inflected form for: escravizar V;2;SG;IND;PST;PFV	escravizaste	escravizaste
Generate the inflected form for: pôr V;2;PL;IND;PST;PRF	pôreis	puséreis
Generate the inflected form for: pescar V;3;PL;IND;PST;PFV	pescaram	pescaram
Generate the inflected form for: surtar V;NFIN	surtar	surtar
Generate the inflected form for: pisotear V;3;SG;COND	pisotearia	pisotearia
Generate the inflected form for: agachar V;1;PL;COND	agacharíamos	agacharíamos
Generate the inflected form for: estimular V;2;PL;SBJV;FUT	estimulardes	estimulardes
Generate the inflected form for: optar V;3;PL;IMP;NEG	optem	optem
Generate the inflected form for: polimerizar V;3;PL;IND;FUT	polimerizarão	polimerizarão
Generate the inflected form for: escalfar V.PTCP;FEM;SG;PST	escalfada	escalfada
Generate the inflected form for: instigar V;3;SG;IND;PST;IPFV	instigava	instigava

Accuracy: 0.9700 (970/1000)
Mismatches (prediction | gold):
desdissias | desdizias
coevoluiste | coevoluíste
liquefiçais | liquefaçais
contraam | contraiam
antecedíamos | antecedemos
