Arabize V;PRS;NOM(3,SG)	;PRS;NOM(3,SG)
Arabize V;PRS;N
Arabize V;V.PTCP;PRS	;PTCP;PRS;PRS;PRS;PRS;PRS;PRS;
Arabize V;V.PTCP;PST	;PTCP;PST;PST;PST;PST;PST;PST;
DL V;PST	;PST;DL V;PST;DL V;PST;DL V;PS
DL V;V.PTCP;PST	;V.PTCP;PSTCP;PSTCP;PSTCP;PSTC
GI V;PRS;NOM(3,SG)	 S;PRS;NOM(3,SG)
I V;PRS;NOM(3
GI V;V.PTCP;PRS	;PRS;PRS;PRS;PRS;PRS;PRS;PRS;P
GI V;V.PTCP;PST	;PST;PST;PST;PST;PST;PST;PST;P
Godcast V;PRS;NOM(3,SG)	 S;SG;SG;SG;SG;SG;SG;SG;SG;SG;
Godcast V;V.PTCP;PRS	;PTCP;PRS;PRS;PRS;PRS;PRS;PRS;
Godcast V;V.PTCP;PST	;PTCP;PST;PST;PST;PST;PST;PST;
IRC V;NFIN	;NFINAFINAFINAFINAFINAFINAFINA
IRC V;PRS;NOM(3,SG)	 ;PRS;NOM(3,SG)
IRC V;PRS;NOM(
IRC V;PST	PSTBSTB V;PSTB V;PSTB V;PSTB V
IRC V;V.PTCP;PST	PTCP;PST;PST;PST;PST;PST;PST;P
Muhammadanize V;NFIN	e V;NFINFINFINFINFINFINFINFINF
Muhammadanize V;PRS;NOM(3,SG)	;NOM(3,SG);NOM(3,SG);NOM(3,SG)
Muhammadanize V;V.PTCP;PST	;PTCP;PST;PST;PST;PST;PST;PST;
Salafize V;PRS;NOM(3,SG)	;PRS;NOM(3,SG)
Salafize V;PRS;
Salafize V;PST	 V;PST V;PST V;PST V;PST V;PST
Salafize V;V.PTCP;PST	;PTCP;PST;PST;PST;PST;PST;PST;
Sufize V;PRS;NOM(3,SG)	 V;PRS;NOM(3,SG)
Sufize V;PRS;
Sufize V;V.PTCP;PRS	;PTCP;PRS;PRS;PRS;PRS;PRS;PRS;
Sufize V;V.PTCP;PST	;PTCP;PST;PST;PST;PST;PST;PST;
abode V;NFIN	bode V;NFINYNYNYNYNYNYNYNYNYNY
abode V;PRS;NOM(3,SG)	;PRS;NOM(3,SG) Start of start 
abode V;V.PTCP;PRS	;V.PTCP;PRS;PRS;PRS;PRS;PRS;PR
absolve V;PRS;NOM(3,SG)	 S;SG;SG;SG;SG;SG;SG;SG;SG;SG;
absolve V;PST	bsolve V;PST;PST;PST;PST;PST;P
absolve V;V.PTCP;PRS	;PTCP;PRS;PRS;PRS;PRS;PRS;PRS;
accept V;NFIN	accept V;NFIN;N;N;N;N;N;N;N;N;
accept V;PRS;NOM(3,SG)	;PRS;NOM(3,SG) V;PRS;NOM(3,SG)
accept V;V.PTCP;PRS	pt V;V.PTCP;PRS;PRS;PRS;PRS;PR
accept V;V.PTCP;PST	;PTCP;PST;PST;PST;PST;PST;PST;
accession V;NFIN	;NFIN;NFIN;NFIN;NFIN;NFIN;NFIN
accession V;PRS;NOM(3,SG)	;PRS;NOM(3,SG) V;PRS;NOM(3,SG)
accession V;V.PTCP;PRS	;PTCP;PRS;PRS;PRS;PRS;PRS;PRS;
acetize V;PRS;NOM(3,SG)	;PRS;NOM(3,SG);NOM(3,SG);NOM(3
acetize V;PST	;PST;PST;PST;PST;PST;PST;PST;P
acquire V;NFIN	V;NFINFINFINFINFINFINFINFINFIN
acquire V;PRS;NOM(3,SG)	;PRS;NOM(3,SG) V;PRS;NOM(3,SG)
acquire V;PST	acquire V;PST;PST;PST;PST;PST;
acquire V;V.PTCP;PRS	;PTCP;PRS;PRS;PRS;PRS;PRS;PRS;
adhære V;NFIN	V;NFIN;NFIN;NFIN;NFIN;NFIN;NFI
adhære V;PST	e hære V;PST;PST;PST;PST;PST;
adhære V;V.PTCP;PST	;PTCP;PST;PST;PST;PST;PST;PST;
adipocerate V;PRS;NOM(3,SG)	;PRS;NOM(3,SG);NOM(3,SG);NOM(3
adipocerate V;PST	erate V;PST;PST;PST;PST;PST;PS
adipocerate V;V.PTCP;PRS	;PTCP;PRS;PRS;PRS;PRS;PRS;PRS;
affect V;NFIN	 V;NFIN V;NFIN V;NFIN V;NFIN V
affect V;PST	 V;PST V;PST V;PST V;PST V;PST
affect V;V.PTCP;PRS	;PTCP;PRS;PRS;PRS;PRS;PRS;PRS;
affect V;V.PTCP;PST	;PTCP;PST;PST;PST;PST;PST;PST;
affine V;NFIN	e V;NFIN V;NFIN V;NFIN V;NFIN 
affine V;PRS;NOM(3,SG)	;PRS;NOM(3,SG)
Affine V;PRS;NO
affine V;PST	fine V;PST;PST;PST;PST;PST;PST
anticipate V;NFIN	ipate V;NFINFINFINFINFINFINFIN
anticipate V;PRS;NOM(3,SG)	;PRS;NOM(3,SG);PRS;NOM(3,SG);P
anticipate V;PST	;PST;PST;PST;PST;PST;PST;PST;P
anticipate V;V.PTCP;PRS	;PTCP;PRS;PRS;PRS;PRS;PRS;PRS;
assail V;PRS;NOM(3,SG)	;PRS;NOM(3,SG) V;PRS;NOM(3,SG)
assail V;PST	ssail V;PST;PST;ST;ST;ST;ST;ST
assail V;V.PTCP;PRS	V;V.PTCP;PRS;PRS;PRS;PRS;PRS;P
assail V;V.PTCP;PST	;PTCP;PST;PST;PST;PST;PST;PST;
atsake V;NFIN	V;NFIN;NFIN;NFIN;NFIN;NFIN;NFI
atsake V;PRS;NOM(3,SG)	ake V;PRS;NOM(3,SG);NOM(3,SG);
atsake V;PST	atsake V;PST V;PST V;PST V;PST
aumail V;NFIN	aumail V;NFIN;N;N;N;N;N;N;N;N;
aumail V;PRS;NOM(3,SG)	 S;SG;SG;SG;SG;SG;SG;SG;SG;SG;
aumail V;V.PTCP;PRS	 V;V.PTCP;PRS;PRS;PRS;PRS;PRS;
babify V;NFIN	 V;NFIN NFIN NFIN NFIN NFIN NF
babify V;PRS;NOM(3,SG)	;PRS;NOM(3,SG) V;PRS;NOM(3,SG)
babify V;PST	 V;PST V;PST V;PST V;PST V;PST
babify V;V.PTCP;PST	;PTCP;PST;PST;PST;PST;PST;PST;
barhop V;NFIN	p V;NFINFNFNFNFNFNFNFNFNFNFNFN
barhop V;PRS;NOM(3,SG)	 S;PRS;NOM(3,SG) SG;NOM(3,SG) 
barhop V;V.PTCP;PRS	;PTCP;PRS;PRS;PRS;PRS;PRS;PRS;
base V;NFIN	base V;NFIN;
NFIN;
NFIN;
NFIN;
base V;PRS;NOM(3,SG)	;PRS;NOM(3,SG) State V;PRS;NOM
base V;PST	;PST;PST;PST;PST;PST;PST;PST;P
base V;V.PTCP;PST	;PTCP;PST;PST;PST;PST;PST;PST;
bemaul V;NFIN	FINFINFINFINFINFINFINFINFINFIN
bemaul V;PRS;NOM(3,SG)	;PRS;NOM(3,SG) SG;NOM(3,SG) SG
bemaul V;V.PTCP;PRS	;PTCP;PRS;PRS;PRS;PRS;PRS;PRS;
bemaul V;V.PTCP;PST	;PTCP;PST;PST;PST;PST;PST;PST;
beshape V;NFIN	;NFIN;NFIN;NFIN;NFIN;NFIN;NFIN
beshape V;PRS;NOM(3,SG)	;PRS;NOM(3,SG) V;PRS;NOM(3,SG)
beshape V;V.PTCP;PRS	;PTCP;PRS;PRS;PRS;PRS;PRS;PRS;
beshape V;V.PTCP;PST	;PTCP;PST;PST;PST;PST;PST;PST;
bespirt V;NFIN	NFINNNNNNNNNNNNNNNNNNNNNNNNNNN
bespirt V;PRS;NOM(3,SG)	;NOM(3,SG) V;PRS;NOM(3,SG) V;P
bespirt V;V.PTCP;PRS	;PTCP;PRS;PRS;PRS;PRS;PRS;PRS;
bespirt V;V.PTCP;PST	;PTCP;PST;PST;PST;PST;PST;PST;
bioactivate V;NFIN	activate V;NFININININININININI
bioactivate V;PST	;PST;PST;PST;PST;PST;PST;PST;P
bioactivate V;V.PTCP;PRS	.PTCP;PRS;PRS;PRS;PRS;PRS;PRS;
biodegrade V;NFIN	V;NFINY;NFINY;NFINY;NFINY;NFIN
biodegrade V;PST	V;PST;PST;PST;PST;PST;PST;PST;
biodegrade V;V.PTCP;PRS	PTCP;PRS;PRS;PRS;PRS;PRS;PRS;P
biodegrade V;V.PTCP;PST	PTCP;PST;PST;PST;PST;PST;PST;P
biostimulate V;NFIN	ostimulate V;NFNFNFNFNFNFNFNFN
biostimulate V;PRS;NOM(3,SG)	;NOM(3,SG);NOM(3,SG);NOM(3,SG)
biostimulate V;PST	;PST;PST;PST;PST;PST;PST;PST;P
biostimulate V;V.PTCP;PRS	;PTCP;PRS;PRS;PRS;PRS;PRS;PRS;
bliken V;NFIN	bliken V;NFIN;NFIN;NFIN;NFIN;N
bliken V;PST	bliken V;PST;PST;PST;PST;PST;P
bliken V;V.PTCP;PRS	;PTCP;PRS;PRS;PRS;PRS;PRS;PRS;
bliken V;V.PTCP;PST	P;PST;PST;PST;PST;PST;PST;PST;
bodysurf V;NFIN	f V;NFIN NFIN NFIN NFIN NFIN N
bodysurf V;PST	;PST;PST;PST;PST;PST;PST;PST;P
bodysurf V;V.PTCP;PST	;PTCP;PST;PST;PST;PST;PST;PST;
brickfilm V;PRS;NOM(3,SG)	;NOM(3,SG);NOM(3,SG);NOM(3,SG)
brickfilm V;PST	brickfilm V;PST;PST;PST;PST;PS
brickfilm V;V.PTCP;PRS	.PTCP;PRS;PRS;PRS;PRS;PRS;PRS;
brickfilm V;V.PTCP;PST	P;PST;PST;PST;PST;PST;PST;PST;
bulletize V;NFIN	INININININININININININININININ
bulletize V;PST	etize V;PST;PST;PST;PST;PST;PS
bulletize V;V.PTCP;PRS	;PTCP;PRS;PRS;PRS;PRS;PRS;PRS;
bus V;NFIN	;NFIN
NFIN
NFIN
NFIN
NFIN
NFIN
change V;NFIN	change V;NFIN change v;NFIN ch
change V;PRS;NOM(3,SG)	;PRS;NOM(3,SG);NOM(3,SG);NOM(3
change V;PST	;PST;PST;PST;PST;PST - - - - -
change V;V.PTCP;PST	;PTCP;PST;PST;PST;PST;PST;PST;
chequer V;PRS;NOM(3,SG)	;PRS;NOM(3,SG) V;PRS;NOM(3,SG)
chequer V;PST	equer V;PST;PST;PST;PST;PST;PS
chequer V;V.PTCP;PRS	;PTCP;PRS;PRS;PRS;PRS;PRS;PRS;
chinwag V;NFIN	wag V;NFIN
wag V;NFIN
wag V;NF
chinwag V;V.PTCP;PRS	;PTCP;PRS;PRS;PRS;PRS;PRS;PRS;
chinwag V;V.PTCP;PST	;PTCP;PST;PST;PST;PST;PST;PST;
chirr V;NFIN	chirr V;NFIN;N;N;N;N;N;N;N;N;N
chirr V;PRS;NOM(3,SG)	;PRS;NOM(3,SG)
PRS;NOM(3,SG)
P
chirr V;PST	chirr V;PST;PST;PST;PST;PST;PS
chirr V;V.PTCP;PRS	;PTCP;PRS;PRS;PRS;PRS;PRS;PRS;
co-locate V;PRS;NOM(3,SG)	 V;PRS;NOM(3,SG) V;PRS;NOM(3,S
co-locate V;PST	 V;PST V;PST V;PST V;PST V;PST
co-locate V;V.PTCP;PST	;PTCP;PST;PST;PST;PST;PST;PST;
codeshare V;NFIN	NFIN V;NFIN V;NFIN V;NFIN V;NF
codeshare V;PRS;NOM(3,SG)	;NOM(3,SG);NOM(3,SG);NOM(3,SG)
codeshare V;V.PTCP;PRS	;V.PTCP;PRS;PRS;PRS;PRS;PRS;PR
codeshare V;V.PTCP;PST	PTCP;PST;PST;PST;PST;PST;PST;P
coimmunoprecipitate V;NFIN	;NFIN V;NFIN V;NFIN V;NFIN V;N
coimmunoprecipitate V;PRS;NOM(3,SG)	;NOM(3,SG);NOM(3,SG);NOM(3,SG)
coimmunoprecipitate V;V.PTCP;PRS	;PTCP;PRS;PRS;PRS;PRS;PRS;PRS;
coimmunoprecipitate V;V.PTCP;PST	;PTCP;PST;PST;PST;PST;PST;PST;
comarket V;PRS;NOM(3,SG)	;PRS;NOM(3,SG);NOM(3,SG);NOM(3
comarket V;PST	t V;PST
ST
ST
ST
ST
ST
ST
ST
S
comarket V;V.PTCP;PRS	;PTCP;PRS;PRS;PRS;PRS;PRS;PRS;
comarket V;V.PTCP;PST	PTCP;PST;PST;PST;PST;PST;PST;P
commiserate V;NFIN	rate V;NFININININININININININI
commiserate V;PST	ST;PST;PST;PST;PST;PST;PST;PST
commiserate V;V.PTCP;PRS	PTCP;PRS;PRS;PRS;PRS;PRS;PRS;P
commiserate V;V.PTCP;PST	PTCP;PST;PST;PST;PST;PST;PST;P
compost V;NFIN	;NFIN;NFIN;NFIN;NFIN;NFIN;NFIN
compost V;PRS;NOM(3,SG)	;PRS;NOM(3,SG) V;PRS;NOM(3,SG)
compost V;PST	t ST;PST;PST;PST;PST;PST;PST;P
compost V;V.PTCP;PST	;PTCP;PST;PST;PST;PST;PST;PST;
congest V;NFIN	est V;NFINININININININININININ
congest V;PRS;NOM(3,SG)	;PRS;NOM(3,SG);NOM(3,SG);NOM(3
congest V;V.PTCP;PST	PTCP;PST;PST;PST;PST;PST;PST;P
conquer V;PRS;NOM(3,SG)	;PRS;NOM(3,SG) V;PRS;NOM(3,SG)
conquer V;V.PTCP;PRS	;PTCP;PRS;PRS;PRS;PRS;PRS;PRS;
conversation V;NFIN	ersation V;NFININININININININI
conversation V;PRS;NOM(3,SG)	;NOM(3,SG);NOM(3,SG);NOM(3,SG)
conversation V;V.PTCP;PRS	;PTCP;PRS;PRS;PRS;PRS;PRS;PRS;
conversation V;V.PTCP;PST	;PTCP;PST;PST;PST;PST;PST;PST;
cordon V;PST	ordon V;PST;PST;PST;PST;PST;PS
cordon V;V.PTCP;PRS	;PTCP;PRS;PRS;PRS;PRS;PRS;PRS;
cordon V;V.PTCP;PST	;PTCP;PST;PST;PST;PST;PST;PST;
cosponsor V;NFIN	osponsor V;NFIN;N;N;N;N;N;N;N;
cosponsor V;PRS;NOM(3,SG)	;PRS;NOM(3,SG) The protein V;P
cosponsor V;PST	osponsor V;PST;PST;PST;PST;PST
counterindoctrinate V;NFIN	 V;NFININININININININININININI
counterindoctrinate V;V.PTCP;PST	PTCP;PST;PST;PST;PST;PST;PST;P
crescendo V;NFIN	;NFINFINFINFINFINFINFINFINFINF
crescendo V;PST	;PST;PST;PST;PST;PST;PST;PST;P
crescendo V;V.PTCP;PRS	;V.PTCP;PRS;PRS;PRS;PRS;PRS;PR
crescendo V;V.PTCP;PST	PTCP;PST;PST;PST;PST;PST;PST;P
croggle V;PRS;NOM(3,SG)	(3,SG);NOM(3,SG);NOM(3,SG);NOM
croggle V;PST	croggle V;PST;PST;PST;PST;PST;
croggle V;V.PTCP;PRS	croggle V;V.PTCP;PRS;PRS;PRS;P
declamate V;PRS;NOM(3,SG)	;PRS;NOM(3,SG);PRS;NOM(3,SG);P
declamate V;V.PTCP;PRS	;PTCP;PRS;PRS;PRS;PRS;PRS;PRS;
declamate V;V.PTCP;PST	;PTCP;PST;PST;PST;PST;PST;PST;
decompartmentalize V;NFIN	NFININININININININININININININ
decompartmentalize V;PST	entalize V;PST V;PST V;PST V;P
decompartmentalize V;V.PTCP;PRS	;PTCP;PRS;PRS;PRS;PRS;PRS;PRS;
decompartmentalize V;V.PTCP;PST	;V.PTCP;PST;PST;PST;PST;PST;PS
deconcentrate V;NFIN	;NFINININININININININININININI
deconcentrate V;PST	;PST;PST;PST;PST;PST;PST;PST;P
deconcentrate V;V.PTCP;PST	;PTCP;PST;PST;PST;PST;PST;PST;
defunctionalize V;NFIN	;NFINININININININININININININI
defunctionalize V;PRS;NOM(3,SG)	;PRS;NOM(3,SG) V;PRS;NOM(3,SG)
defunctionalize V;PST	;PST;PST;PST;PST;PST;PST;PST;P
defunctionalize V;V.PTCP;PST	;V.PTCP;PST;PST;PST;PST;PST;PS
degroup V;NFIN	 V;NFINN;NFIN;NFIN;NFIN;NFIN;N
degroup V;PRS;NOM(3,SG)	;PRS;NOM(3,SG);PRS;NOM(3,SG);P
degroup V;PST	egroup V;PST;PST;PST;PST;PST;P
degroup V;V.PTCP;PRS	;PTCP;PRS;PRS;PRS;PRS;PRS;PRS;
deke V;PRS;NOM(3,SG)	;PRS;NOM(3,SG);PRS;NOM(3,SG);P
deke V;PST	;;;;;;;;;;;;;;;;;;;;;;;;;;;;;;
deke V;V.PTCP;PST	PTCP;PST;PST;PST;PST;PST;PST;P
deliberate V;NFIN	;NFINFINFINFINFINFINFINFINFINF
deliberate V;PST	;PST;PST;PST;PST;PST;PST;PST;P
deliberate V;V.PTCP;PRS	.PTCP;PRS;PRS;PRS;PRS;PRS;PRS;
deliberate V;V.PTCP;PST	;PST;PST;PST;PST;PST;PST;PST;P
delve V;PST	elve V;PST;PST;PST;PST;PST;PST
delve V;V.PTCP;PRS	;PTCP;PRS;PRS;PRS;PRS;PRS;PRS;
delve V;V.PTCP;PST	;PTCP;PST;PST;PST;PST;PST;PST;
demorify V;NFIN	;NFIN;NFIN;NFIN;NFIN;NFIN;NFIN
demorify V;PRS;NOM(3,SG)	;PRS;NOM(3,SG);NOM(3,SG);NOM(3
demorify V;PST	emorify V;PST;PST;PST;PST;PST;
demorify V;V.PTCP;PST	;PTCP;PST;PST;PST;PST;PST;PST;
denuclearize V;NFIN	;NFIN;NFIN;NFIN;NFIN;NFIN;NFIN
denuclearize V;PRS;NOM(3,SG)	;PRS;NOM(3,SG);NOM(3,SG);NOM(3
denuclearize V;PST	;PST;PST;PST;PST;PST;PST;PST;P
denuclearize V;V.PTCP;PST	;PTCP;PST;PST;PST;PST;PST;PST;
deraign V;NFIN	;NFIN V;NFIN V;NFIN V;NFIN V;N
deraign V;PRS;NOM(3,SG)	;NOM(3,SG);NOM(3,SG);NOM(3,SG)
deraign V;PST	 V;PST V;PST V;PST V;PST V;PST
deraign V;V.PTCP;PRS	;PTCP;PRS;PRS;PRS;PRS;PRS;PRS;
destruct V;PRS;NOM(3,SG)	;PRS;NOM(3,SG);NOM(3,SG);NOM(3
destruct V;PST	estruct V;PST;PST;PST;PST;PST;
destruct V;V.PTCP;PRS	;PTCP;PRS;PRS;PRS;PRS;PRS;PRS;
detumesce V;NFIN	esce V;NFINNFINNFINNFINNFINNFI
detumesce V;PRS;NOM(3,SG)	;PRS;NOM(3,SG);NOM(3,SG);NOM(3
detumesce V;PST	etumesce V;PST V;PST V;PST V;P
detumesce V;V.PTCP;PST	;V.PTCP;PST;PST;PST;PST;PST;PS
deurbanize V;NFIN	NFININININININININININININININ
deurbanize V;PRS;NOM(3,SG)	;PRS;NOM(3,SG) V;PRS;NOM(3,SG)
deurbanize V;PST	e V;PST;PST;PST;PST;PST;PST;PS
deurbanize V;V.PTCP;PRS	;PTCP;PRS;PRS;PRS;PRS;PRS;PRS;
devenustate V;NFIN	ustate V;NFINFINFINFINFINFINFI
devenustate V;PRS;NOM(3,SG)	;PRS;NOM(3,SG) V;PRS;NOM(3,SG)
devenustate V;PST	ustate V;PST;PST;PST;PST;PST;P
devenustate V;V.PTCP;PRS	ustate V;V.PTCP;PRS;PRS;PRS;PR
dewret V;PRS;NOM(3,SG)	 S;PRS;NOM(3,SG)
Sanders S;PRS
dewret V;V.PTCP;PRS	;PTCP;PRS;PRS;PRS;PRS;PRS;PRS;
dewret V;V.PTCP;PST	;PTCP;PST;PST;PST;PST;PST;PST;
digiscope V;PST	igiscope V;PST;PST;PST;PST;PST
digiscope V;V.PTCP;PRS	;PTCP;PRS;PRS;PRS;PRS;PRS;PRS;
digiscope V;V.PTCP;PST	PTCP;PST;PST;PST;PST;PST;PST;P
dishonnour V;NFIN	nnour V;NFINNOUR V;NFINNOUR V;
dishonnour V;PRS;NOM(3,SG)	;PRS;NOM(3,SG);PRS;NOM(3,SG);P
dishonnour V;V.PTCP;PRS	;PTCP;PRS;PRS;PRS;PRS;PRS;PRS;
dishonnour V;V.PTCP;PST	.PTCP;PST;PST;PST;PST;PST;PST;
dissettle V;PRS;NOM(3,SG)	;PRS;NOM(3,SG);NOM(3,SG);NOM(3
dissettle V;V.PTCP;PRS	;PTCP;PRS;PRS;PRS;PRS;PRS;PRS;
dissettle V;V.PTCP;PST	T;PTCP;PST;PST;PST;PST;PST;PST
dissonate V;NFIN	ate V;NFINININININININININININ
dissonate V;V.PTCP;PRS	PTCP;PRS;PRS;PRS;PRS;PRS;PRS;P
dissonate V;V.PTCP;PST	PTCP;PST;PST;PST;PST;PST;PST;P
disuse V;NFIN	;NFINININININININININININININI
disuse V;PRS;NOM(3,SG)	;NOM(3,SG);NOM(3,SG);NOM(3,SG)
disuse V;V.PTCP;PST	;PTCP;PST;PST;PST;PST;PST;PST;
dodd V;PRS;NOM(3,SG)	 S;SG;SG;SG;SG;SG;SG;SG;SG;SG;
dodd V;PST	dd V;PST;PST;PST;PST;PST;PST;P
dodd V;V.PTCP;PRS	 V;V.PTCP;PRS;PRS;PRS;PRS;PRS;
dodd V;V.PTCP;PST	;PTCP;PST;PST;PST;PST;PST;PST;
douche V;NFIN	ouche V;NFININININININININININ
douche V;PRS;NOM(3,SG)	;PRS;NOM(3,SG);NOM(3,SG);NOM(3
douche V;PST	ouche V;PSTK V;PSTK V;PSTK V;P
douche V;V.PTCP;PRS	;PTCP;PRS;PRS;PRS;PRS;PRS;PRS;
downclock V;PRS;NOM(3,SG)	;PRS;NOM(3,SG);PRS;NOM(3,SG);P
downclock V;PST	ownclock V;PST;PST;PST;PST;PST
downclock V;V.PTCP;PRS	PTCP;PRS;PRS;PRS;PRS;PRS;PRS;P
dram V;NFIN	;nfin ;nfin ;nfin ;nfin ;nfin 
dram V;PRS;NOM(3,SG)	;NOM(3,SG)
Satyam V;PRS;NOM(3,
dram V;PST	;PST;;PST;;PST;;PST;;PST ;;PST
dram V;V.PTCP;PRS	 A;V.PTCP;PRS;PRS;PRS;PRS;PRS;
duress V;NFIN	NFININININININININININININININ
duress V;PRS;NOM(3,SG)	;NOM(3,SG);NOM(3,SG);NOM(3,SG)
earnest V;PRS;NOM(3,SG)	;PRS;NOM(3,SG)
Arnest V;PRS;NO
earnest V;V.PTCP;PST	;PTCP;PST;PST;PST;PST;PST;PST;
empassion V;NFIN	mpassion V;NFIN V;NFIN V;NFIN 
empassion V;PRS;NOM(3,SG)	;PRS;NOM(3,SG) V;PRS;NOM(3,SG)
encoach V;PRS;NOM(3,SG)	;NOM(3,SG) State State State S
encoach V;PST	ach v;pst v;pst v;pst v;pst v;
encoach V;V.PTCP;PRS	;V.PTCP;PRS;PRS;PRS;PRS;PRS;PR
enlace V;NFIN	NFIN;NFIN;NFIN;NFIN;NFIN;NFIN;
enlace V;PRS;NOM(3,SG)	;NOM(3,SG) V;PRS;NOM(3,SG) V;P
enlace V;V.PTCP;PRS	nlace V;V.PTCP;PRS;PRS;PRS;PRS
enlace V;V.PTCP;PST	PTCP;PST;PST;PST;PST;PST;PST;P
enrank V;NFIN	;NFINank V;NFINank V;NFINank V
enring V;PRS;NOM(3,SG)	;PRS;NOM(3,SG)
Startsida V;PRS
enring V;PST	;PST;PST;PST;PST;PST;PST;PST;P
enring V;V.PTCP;PRS	ng V;V.PTCP;PRS;PRS;PRS;PRS;PR
ensky V;NFIN	;NFIN;NFIN;NFIN;NFIN;NFIN;NFIN
ensky V;PRS;NOM(3,SG)	;PRS;NOM(3,SG);NOM(3,SG);NOM(3
ensky V;PST	;PST;PST;PST; Staby V;PST; Sta
ensky V;V.PTCP;PST	;V.PTCP;PST;PST;PST;eneeneenee
enwisen V;NFIN	;NFIN;N;N;N;N;N;N;N;N;N;N;N;N;
enwisen V;PRS;NOM(3,SG)	;NOM(3,SG);NOM(3,SG);NOM(3,SG)
enwisen V;V.PTCP;PRS	enwisen V;V.PTCP;PRS;PRS;PRS;P
exceed V;NFIN	fin V;NFINFINFINFINFINFINFINFI
exceed V;PRS;NOM(3,SG)	;PRS;NOM(3,SG) V;PRS;NOM(3,SG)
exceed V;V.PTCP;PRS	;PTCP;PRS;PRS;PRS;PRS;PRS;PRS;
fainten V;PRS;NOM(3,SG)	;PRS;NOM(3,SG);NOM(3,SG);NOM(3
fainten V;PST	nten V;PST V;PST V;PST V;PST V
fainten V;V.PTCP;PRS	;PTCP;PRS;PRS;PRS;PRS;PRS;PRS;
fainten V;V.PTCP;PST	;PTCP;PST;PST;PST;PST;PST;PST;
fanaticize V;PRS;NOM(3,SG)	 V;PRS;NOM(3,SG) V;PRS;NOM(3,S
fanaticize V;V.PTCP;PRS	;V.PTCP;PRS;PRS;PRS;PRS;PRS;PR
feel V;NFIN	 V;NFININININININININININININI
feel V;PRS;NOM(3,SG)	;PRS;NOM(3,SG) Star V;PRS;NOM(
feel V;V.PTCP;PRS	;PTCP;PRS;PRS;PRS;PRS;PRS;PRS;
flail V;PST	flail V;PST;PST;PST;PST;PST;PS
fluff V;NFIN	fluff V;nfin V;nfin V;nfin V;n
fluff V;V.PTCP;PRS	.PTCP;PRS;PRS;PRS;PRS;PRS;PRS;
flutter V;NFIN	fflutter V;N;N;N;N;N;N;N;N;N;N
flutter V;PRS;NOM(3,SG)	;NOM(3,SG) V;PRS;NOM(3,SG) V;P
flutter V;PST	;PST;ST;ST;ST;ST;ST;ST;ST;ST;S
flutter V;V.PTCP;PST	P;PST;PST;PST;PST;PST;PST;PST;
forestal V;NFIN	estal V;NFINN NFINN NFINN NFIN
forestal V;PRS;NOM(3,SG)	;PRS;NOM(3,SG);NOM(3,SG);NOM(3
forestal V;PST	al V;PST;PST;PST;PST;PST;PST;P
formicate V;NFIN	cate V;NFININININININININININI
formicate V;V.PTCP;PRS	;PTCP;PRS;PRS;PRS;PRS;PRS;PRS;
formicate V;V.PTCP;PST	;PTCP;PST;PST;PST;PST;PST;PST;
forthcast V;NFIN	 V;NFIN V;NFIN V;NFIN V;NFIN V
forthcast V;PRS;NOM(3,SG)	;PRS;NOM(3,SG) V;PRS;NOM(3,SG)
forthcast V;V.PTCP;PRS	;PTCP;PRS;PRS;PRS;PRS;PRS;PRS;
forthcast V;V.PTCP;PST	;PTCP;PST;PST;PST;PST;PST;PST;
forwrap V;PRS;NOM(3,SG)	;PRS;NOM(3,SG) V;PRS;NOM(3,SG)
forwrap V;V.PTCP;PRS	PTCP;PRS;PRS;PRS;PRS;PRS;PRS;P
forwrap V;V.PTCP;PST	;PTCP;PST;PST;PST;PST;PST;PST;
fraternise V;PST	fraternise V;PST;PST;PST;PST;P
fraternise V;V.PTCP;PRS	;PTCP;PRS;PRS;PRS;PRS;PRS;PRS;
fraternise V;V.PTCP;PST	;PTCP;PST;PST;PST;PST;PST;PST;
frustrate V;PST	frustrate V;PST;PST;PST;PST;PS
frustrate V;V.PTCP;PRS	.PTCP;PRSZ;PRSZ;PRSZ;PRSZ;PRSZ
fustigate V;PST	gate V;PST;PST;PST;PST;PST;PST
fustigate V;V.PTCP;PRS	;PTCP;PRS;PRS;PRS;PRS;PRS;PRS;
fustigate V;V.PTCP;PST	;PTCP;PST;PST;PST;PST;PST;PST;
geck V;NFIN	;NFIN;N;N;N;N;N;N;N;N;N;N;N;N;
geck V;PRS;NOM(3,SG)	;PRS;NOM(3,SG);NOM(3,SG);NOM(3
geck V;V.PTCP;PRS	;PTCP;PRS;PRS;PRS;PRS;PRS;PRS;
geck V;V.PTCP;PST	;PTCP;PST;PST;PST;PST;PST;PST;
germinate V;NFIN	NFININININININININININININININ
germinate V;PRS;NOM(3,SG)	;PRS;NOM(3,SG);NOM(3,SG);NOM(3
germinate V;V.PTCP;PST	PTCP;PST;PST;PST;PST;PST;PST;P
glycolyze V;PRS;NOM(3,SG)	;NOM(3,SG) V;PRS;NOM(3,SG) V;P
glycolyze V;V.PTCP;PST	;PTCP;PST;PST;PST;PST;PST;PST;
graffiti V;PRS;NOM(3,SG)	;PRS;NOM(3,SG);NOM(3,SG);NOM(3
graffiti V;PST	fiti V;PST;PST;PST;PST;PST;PST
graffiti V;V.PTCP;PRS	;PRS;PRS;PRS;PRS;PRS;PRS;PRS;P
graffiti V;V.PTCP;PST	;PST;PST;PST;PST;PST;PST;PST;P
grammaticize V;PRS;NOM(3,SG)	 V;PRS;NOM(3,SG) V;PRS;NOM(3,S
grammaticize V;PST	e V;PST;PST;PST;PST;PST;PST;PS
grammaticize V;V.PTCP;PRS	;V.PTCP;PRS;PRS;PRS;PRS;PRS;PR
grammaticize V;V.PTCP;PST	;V.PTCP;PST;PST;PST;PST;PST;PS
grid V;NFIN	NFININININININININININININININ
grid V;PRS;NOM(3,SG)	;PRS;NOM(3,SG)
Stefan V;PRS;NO
grid V;PST	;PST;PST;PST;PST;PST;PST;PST;P
grid V;V.PTCP;PST	;PTCP;PST;PST;PST;PST;PST;PST;
grill V;NFIN	l V;NFININININININININININININ
grill V;PRS;NOM(3,SG)	;NOM(3,SG) Startsida V;PRS;NOM
grill V;PST	l V;PST V;PST V;PST V;PST V;PS
grill V;V.PTCP;PRS	l V;V.PTCP;PRS;PRS;PRS;PRS;PRS
gub V;PRS;NOM(3,SG)	 S;PRS;NOM(3,SG) SG;PRS;NOM(3,
gub V;PST	 V;PST V;PST V;PST V;PST V;PST
gub V;V.PTCP;PRS	;PTCP;PRS;PRS;PRS;PRS;PRS;PRS;
gub V;V.PTCP;PST	;PTCP;PST V;V.PTCP;PST V;V.PTC
hand V;PRS;NOM(3,SG)	;NOM(3,SG) Standard V;PRS;NOM(
hand V;V.PTCP;PRS	;PTCP;PRS;PRS;PRS;PRS;PRS;PRS;
hand V;V.PTCP;PST	;PTCP;PST;PST;PST;PST;PST;PST;
happify V;PRS;NOM(3,SG)	;PRS;NOM(3,SG) V;PRS;NOM(3,SG)
happify V;PST	pify V;PST V;PST V;PST V;PST V
happify V;V.PTCP;PST	;PTCP;PST;PST;PST;PST;PST;PST;
harpoon V;NFIN	NFIN V;NFIN V;NFIN V;NFIN V;NF
harpoon V;PRS;NOM(3,SG)	;PRS;NOM(3,SG);NOM(3,SG);NOM(3
harpoon V;V.PTCP;PST	;PTCP;PST;PST;PST;PST;PST;PST;
heli-ski V;NFIN	-ski V;NFINtintintintintintint
heli-ski V;PST	heli-ski V;PST;PST;PST;PST;PST
heli-ski V;V.PTCP;PRS	i-ski V;V.PTCP;PRS;PRS;PRS;PRS
heli-ski V;V.PTCP;PST	eli-ski V;V.PTCP;PST;PST;PST;P
hickup V;PRS;NOM(3,SG)	;NOM(3,SG);NOM(3,SG);NOM(3,SG)
hickup V;PST	ST;PST;PST;PST;PST;PST;PST;PST
hickup V;V.PTCP;PST	PTCP;PST;PST;PST;PST;PST;PST;P
high-step V;NFIN	FININININININININININININININI
high-step V;PRS;NOM(3,SG)	;PRS;NOM(3,SG) V;PRS;NOM(3,SG)
high-step V;PST	T V;PST V;PST V;PST V;PST V;PS
high-step V;V.PTCP;PST	;PTCP;PST;PST;PST;PST;PST;PST;
hiss V;NFIN	NFINFINFINFINFINFINFINFINFINFI
hiss V;PST	s ST;PST;PST;PST;PST;PST;PST;P
hiss V;V.PTCP;PRS	;PTCP;PRS;PRS;PRS;PRS;PRS;PRS;
hiss V;V.PTCP;PST	;PTCP;PST;PST;PST;PST;PST;PST;
hydrolyze V;NFIN	NFININININININININININININININ
hydrolyze V;PRS;NOM(3,SG)	V;PRS;NOM(3,SG) V;PRS;NOM(3,SG
hydrolyze V;V.PTCP;PRS	;PTCP;PRS;PRS;PRS;PRS;PRS;PRS;
hydrolyze V;V.PTCP;PST	;PTCP;PST;PST;PST;PST;PST;PST;
illure V;V.PTCP;PRS	P;PRS;PRS;PRS;PRS;PRS;PRS;PRS;
imboil V;NFIN	mboil V;NFIN V;NFIN V;NFIN V;N
imboil V;PRS;NOM(3,SG)	;PRS;NOM(3,SG) PRS;NOM(3,SG) P
imboil V;PST	mboil V;PST;PST;PST;PST;PST;PS
imboil V;V.PTCP;PST	;PTCP;PST;PST;PST;PST;PST;PST;
imbower V;NFIN	mbower V;NFIN V;NFIN V;NFIN V;
imbower V;PRS;NOM(3,SG)	;PRS;NOM(3,SG)
Stanford V;PRS;
imbower V;V.PTCP;PRS	;PTCP;PRS;PRS;PRS;PRS;PRS;PRS;
imparl V;PST	 ST;PST;PST;PST;PST;PST;PST;PS
imparl V;V.PTCP;PRS	;PTCP;PRS;PRS;PRS;PRS;PRS;PRS;
imperialize V;NFIN	;NFINZALIZE V;NFINZALIZE V;NFI
imperialize V;PRS;NOM(3,SG)	;PRS;NOM(3,SG) V;PRS;NOM(3,SG)
imperialize V;V.PTCP;PRS	;PTCP;PRS;PRS;PRS;PRS;PRS;PRS;
indorse V;NFIN	V;NF;NF;NF;NF;NF;NF;NF;NF;NF;N
indorse V;PRS;NOM(3,SG)	;PRS;NOM(3,SG);NOM(3,SG);NOM(3
indorse V;PST	;pst;pst;pst;pst;pst;pst;pst;p
infeeble V;PRS;NOM(3,SG)	;PRS;NOM(3,SG) V;PRS;NOM(3,SG)
infeeble V;V.PTCP;PRS	eble V;V.PTCP;PRS;PRS;PRS;PRS;
infumate V;NFIN	fumate V;NFINfumate V;NFINfuma
infumate V;PRS;NOM(3,SG)	;PRS;NOM(3,SG)
PRS;NOM(3,SG)
P
infumate V;PST	infumate V;PST;PST;PST;PST;PST
infumate V;V.PTCP;PRS	.PTCP;PRS;PRS;PRS;PRS;PRS;PRS;
inhere V;NFIN	inhere V;NFIN;NFIN;NFIN;NFIN;N
inhere V;PRS;NOM(3,SG)	;NOM(3,SG) V;PRS;NOM(3,SG) V;P
inhere V;V.PTCP;PST	;V.PTCP;PST;PST;PST;PST;PST;PS
instrengthen V;NFIN	instrengthen V;NFIN;NFIN;NFIN;
instrengthen V;PRS;NOM(3,SG)	;NOM(3,SG);NOM(3,SG);NOM(3,SG)
instrengthen V;PST	;PST;ST;S;S;S;S;S;S;S;S;S;S;S;
instrengthen V;V.PTCP;PRS	 V;V.PTCP;PRS;PRS;PRS;PRS;PRS;
intergrade V;PRS;NOM(3,SG)	;NOM(3,SG);NOM(3,SG);NOM(3,SG)
intergrade V;PST	;;;;;;;;;;;;;;;;;;;;;;;;;;;;;;
intergrade V;V.PTCP;PRS	rade V;V.PTCP;PRS;PRS;PRS;PRS;
internetwork V;PRS;NOM(3,SG)	;PRS;NOM(3,SG);PRS;NOM(3,SG);P
internetwork V;V.PTCP;PRS	.PTCP;PRS;PRS;PRS;PRS;PRS;PRS;
internetwork V;V.PTCP;PST	P;PST;PST;PST;PST.PST.PST.PST.
interplay V;NFIN	interplay V;NFIN;NFIN;N;N;N;N;
interplay V;PRS;NOM(3,SG)	;NOM(3,SG);NOM(3,SG);NOM(3,SG)
interplay V;V.PTCP;PRS	play V;V.PTCP;PRS;PRS;PRS;PRS;
interplay V;V.PTCP;PST	PTCP;PST;PST;PST;PST;PST;PST;P
interpoint V;NFIN	NFIN;NFIN;NFIN;NFIN;NFIN;NFIN;
interpoint V;V.PTCP;PRS	;PTCP;PRS;PRS;PRS;PRS;PRS;PRS;
interpoint V;V.PTCP;PST	PTCP;PST;PST;PST;PST;PST;PST;P
jetski V;NFIN	etski V;NFIN;NFIN;NFIN;NFIN;NF
jetski V;V.PTCP;PRS	PTCP;PRS;PRS;PRS;PRS;PRS;PRS;P
jetski V;V.PTCP;PST	PTCP;PST;PST;PST;PST;PST;PST;P
jockey V;PRS;NOM(3,SG)	;NOM(3,SG);NOM(3,SG);NOM(3,SG)
jockey V;V.PTCP;PRS	;PTCP;PRS;PRS;PRS;PRS;PRS;PRS;
jockey V;V.PTCP;PST	;PTCP;PST;PST;PST;PST;PST;PST;
joke V;NFIN	 V;NFINN V;NFINN V;NFINN V;NFI
joke V;PRS;NOM(3,SG)	;PRS;NOM(3,SG);NOM(3,SG);NOM(3
joke V;PST	e V;PSTY;PSTY;PSTY;PSTY;PSTY;P
juice V;NFIN	;NFIN;N;N;N;N;N;N;N;N;N;N;N;N;
juice V;PRS;NOM(3,SG)	;PRS;NOM(3,SG) V;PRS;NOM(3,SG)
juice V;V.PTCP;PST	;PTCP;PST;PST;PST;PST;PST;PST;
knuckleball V;NFIN	kknuckleball V;NFIN;;;;;;;;;;;
knuckleball V;PRS;NOM(3,SG)	;PRS;NOM(3,SG);NOM(3,SG);NOM(3
knuckleball V;PST	ll V;PST;PST;PST;PST;PST;PST;P
knuckleball V;V.PTCP;PST	;PTCP;PST;PST;PST;PST;PST;PST;
laud V;V.PTCP;PRS	;PTCP;PRS;PRS;PRS;PRS;PRS;PRS;
laud V;V.PTCP;PST	;PTCP;PST;PST;PST;PST;PST;PST;
lave V;NFIN	FINFINFINFINFINFINFINFINFINFIN
lave V;PRS;NOM(3,SG)	;PRS;NOM(3,SG)
PRS;NOM(3,SG)
P
lave V;PST	ST;PST;PST;PST;PST;PST;PST;PST
lave V;V.PTCP;PRS	;PTCP;PRS;PRS;PRS;PRS;PRS;PRS;
lear V;NFIN	 V;NFININININININININININININI
lear V;V.PTCP;PRS	;PTCP;PRS;PRS;PRS;PRS;PRS;PRS;
legislate V;NFIN	egislate V;NFININININININININI
legislate V;PST	;PST;PST;PST;PST;PST;PST;PST;P
legislate V;V.PTCP;PRS	PTCP;PRS;PRS;PRS;PRS;PRS;PRS;P
legislate V;V.PTCP;PST	PTCP;PST;PST;PST;PST;PST;PST;P
livetweet V;NFIN	etweet V;NFIN;NFIN;NFIN;NFIN;N
livetweet V;PRS;NOM(3,SG)	;PRS;NOM(3,SG) V;PRS;NOM(3,SG)
livetweet V;PST	;PST;PST;PST;PST;PST;PST;PST;P
livetweet V;V.PTCP;PST	PTCP;PST;PST;PST;PST;PST;PST;P
loun V;PRS;NOM(3,SG)	;PRS;NOM(3,SG) SG SG SG SG SG 
loun V;PST	STK V;PSTK V;PSTK V;PSTK V;PST
loun V;V.PTCP;PRS	;PTCP;PRS;PRS;PRS;PRS;PRS;PRS;
loun V;V.PTCP;PST	;PTCP;PST;PST;PST;PST;PST;PST;
lush V;NFIN	 V;NFIN NFIN NFIN NFIN NFIN NF
lush V;PRS;NOM(3,SG)	;NOM(3,SG)
PRS;NOM(3,SG)
PRS;N
lush V;V.PTCP;PRS	;PRS;PRS;PRS;PRS;PRS;PRS;PRS;P
machicolate V;PRS;NOM(3,SG)	;PRS;NOM(3,SG);NOM(3,SG);NOM(3
machicolate V;PST	;PST;PST;PST;PST;PST;PST;PST;P
machicolate V;V.PTCP;PRS	;PTCP;PRS;PRS;PRS;PRS;PRS;PRS;
machicolate V;V.PTCP;PST	;PTCP;PST;PST;PST;PST;PST;PST;
mactate V;PRS;NOM(3,SG)	;PRS;NOM(3,SG)
Ate V;PRS;NOM(3
mactate V;PST	te V;PST;PST;PST;PST;PST;PST;P
mactate V;V.PTCP;PRS	.PTCP;PRS;PRS;PRS;PRS;PRS;PRS;
mactate V;V.PTCP;PST	;PTCP;PST;PST;PST;PST;PST;PST;
mand V;NFIN	NFININININININININININININININ
mand V;PST	and V;PSTZTZTZTZTZTZTZTZTZTZTZ
mand V;V.PTCP;PRS	PTCP;PRS;PRS;PRS;PRS;PRS;PRS;P
mand V;V.PTCP;PST	PTCP;PST;PST;PST;PST;PST;PST;P
maternalize V;NFIN	;NFINININININININININININININI
maternalize V;PRS;NOM(3,SG)	;PRS;NOM(3,SG);PRS;NOM(3,SG);P
maternalize V;V.PTCP;PRS	;PTCP;PRS;PRS;PRS;PRS;PRS;PRS;
maternalize V;V.PTCP;PST	;PTCP;PST;PST;PST;PST;PST;PST;
meach V;PRS;NOM(3,SG)	;NOM(3,SG);NOM(3,SG);NOM(3,SG)
meach V;PST	t V;PSTT;PSTT;PSTT;PSTT;PSTT;P
meach V;V.PTCP;PRS	;PTCP;PRS;PRS;PRS;PRS;PRS;PRS;
meach V;V.PTCP;PST	;V.PTCP;PST;PST;PST;PST;PST;PS
mirk V;NFIN	rk V;NFIN;NFIN;NFIN;NFIN;NFIN;
mirk V;PRS;NOM(3,SG)	;PRS;NOM(3,SG);NOM(3,SG);NOM(3
mirk V;PST	pst v;pst | | | | | | | | | | 
mirk V;V.PTCP;PRS	 V;V.PTCP;PRS;PRS;PRS;PRS;PRS;
misken V;NFIN	misken V;NFINbinbinbinbinbinbi
misken V;PST	misken V;PST;PST;PST;PST;PST;P
misken V;V.PTCP;PRS	;PTCP;PRS;PRS;PRS;PRS;PRS;PRS;
misstructure V;NFIN	isstructure V;NFIN;NFIN;NFIN;N
misstructure V;PRS;NOM(3,SG)	;NOM(3,SG);NOM(3,SG);NOM(3,SG)
misstructure V;V.PTCP;PST	;PTCP;PST;PST;PST;PST;PST;PST;
misvalue V;NFIN	;NFINNSINFINNSINFINNSINFINNSIN
misvalue V;PST	;PST;PST;PST;PST;PST;PST;PST;P
misvalue V;V.PTCP;PRS	;PTCP;PRSP;PRSP;PRSP;PRSP;PRSP
misvalue V;V.PTCP;PST	;PTCP;PST;PST;PST;PST;PST;PST;
mold V;PST	T;PST;PST;PST;PST;PST;PST;PST;
mongrelize V;NFIN	elize V;NFININININININININININ
mongrelize V;PRS;NOM(3,SG)	;PRS;NOM(3,SG);NOM(3,SG);NOM(3
mongrelize V;PST	elize V;PST;PST;PST;PST;PST;PS
mongrelize V;V.PTCP;PRS	;PTCP;PRS;PRS;PRS;PRS;PRS;PRS;
mounch V;NFIN	ounch V;NFIN V;NFIN V;NFIN V;N
mounch V;V.PTCP;PST	;PTCP;PST;PST;PST;PST;PST;PST;
nasalise V;NFIN	asalise V;NFINININININININININ
nasalise V;PRS;NOM(3,SG)	;PRS;NOM(3,SG);NOM(3,SG);NOM(3
nasalise V;PST	asalise V;PST;PST;PST;PST;PST;
nasalise V;V.PTCP;PST	;PTCP;PST;PST;PST;PST;PST;PST;
newname V;NFIN	ewname V;NFINININININININININI
newname V;PRS;NOM(3,SG)	;PRS;NOM(3,SG);NOM(3,SG);NOM(3
newname V;PST	ewname V;PST V;PST V;PST V;PST
newname V;V.PTCP;PST	;V.PTCP;PST;PST;PST;PST;PST;PS
obdure V;NFIN	e V;NFIN;NFIN;NFIN;NFIN;NFIN;N
obdure V;PST	;PST;PST;PST;PST;PST;PST;PST;P
obdure V;V.PTCP;PRS	;PTCP;PRS;PRS;PRS;PRS;PRS;PRS;
obdure V;V.PTCP;PST	;PTCP;PST;PST;PST;PST;PST;PST;
obsolete V;NFIN	FINFINFINFINFINFINFINFINFINFIN
obsolete V;PRS;NOM(3,SG)	;PRS;NOM(3,SG) Obsolete V;PRS;
obsolete V;PST	;PST;PST;PST;PST;PST;PST;PST;P
obsolete V;V.PTCP;PRS	PTCP;PRS;PRS;PRS;PRS;PRS;PRS;P
outbud V;NFIN	nfinaloutbud v;nfinaloutbud v;
outbud V;PRS;NOM(3,SG)	 V;PRS;NOM(3,SG) V;PRS;NOM(3,S
outbud V;V.PTCP;PRS	;V.PTCP;PRS;PRS;PRS;PRS;PRS;PR
outbud V;V.PTCP;PST	;PTCP;PST;PST;PST;PST;PST;PST;
outduel V;NFIN	outduel V;NFINFINFINFINFINFINF
outduel V;PRS;NOM(3,SG)	;NOM(3,SG) V;PRS;NOM(3,SG) V;P
outduel V;V.PTCP;PST	;PTCP;PST;PST;PST;PST;PST;PST;
outgush V;PRS;NOM(3,SG)	 S;PRS;NOM(3,SG);NOM(3,SG);NOM
outgush V;PST	V;PST V;PST V;PST V;PST V;PST 
outgush V;V.PTCP;PRS	;PTCP;PRS;PRS;PRS;PRS;PRS;PRS;
outgush V;V.PTCP;PST	;PTCP;PST;PST;PST;PST;PST;PST;
outjuggle V;NFIN	outjuggle V;NFIN;N;N;N;N;N;N;N
outjuggle V;PRS;NOM(3,SG)	(3,SG);NOM(3,SG);NOM(3,SG);NOM
outjuggle V;PST	PST;PST;PST;PST;PST;PST;PST;PS
outjuggle V;V.PTCP;PRS	;V.PTCP;PRS;PRS;PRS;PRS;PRS;PR
outplace V;NFIN	outplace V;NFIN;NFIN;NFIN;NFIN
outplace V;PRS;NOM(3,SG)	;PRS;NOM(3,SG) V;PRS;NOM(3,SG)
outplace V;PST	V;PST;PST;PST;PST;PST;PST;PST;
outplace V;V.PTCP;PRS	place V;V.PTCP;PRS;PRS;PRS;PRS
outwin V;NFIN	nfin V;NFINFINFINFINFINFINFINF
outwin V;PRS;NOM(3,SG)	;NOM(3,SG) V;PRS;NOM(3,SG) V;P
outwin V;V.PTCP;PST	;PTCP;PST;PST;PST;PST;PST;PST;
overdot V;NFIN	verdot V;NFINININININININININI
overdot V;PST	verdot V;PST;PST;PST;PST;PST;P
overdot V;V.PTCP;PRS	;PTCP;PRS;PRS;PRS;PRS;PRS;PRS;
overdot V;V.PTCP;PST	;PTCP;PST;PST;PST;PST;PST;PST;
overexpose V;NFIN	erexpose V;NFININININININININI
overexpose V;PST	erexpose V;PST;PST;PST;PST;PST
overexpose V;V.PTCP;PST	;PTCP;PST;PST;PST;PST;PST;PST;
overgloom V;NFIN	vergloom V;NFININININININININI
overgloom V;PRS;NOM(3,SG)	;PRS;NOM(3,SG);NOM(3,SG);NOM(3
overgloom V;PST	vergloom V;PST;PST;PST;PST;PST
overgloom V;V.PTCP;PST	;PTCP;PST;PST;PST;PST;PST;PST;
overgrow V;PRS;NOM(3,SG)	;PRS;NOM(3,SG);NOM(3,SG);NOM(3
overgrow V;V.PTCP;PRS	;PTCP;PRS;PRS;PRS;PRS;PRS;PRS;
overplow V;NFIN	;NFIN;N;N;N;N;N;N;N;N;N;N;N;N;
overplow V;PST	 V;PST;PST;PST;PST;PST;PST;PST
overplow V;V.PTCP;PRS	;PTCP;PRS;PRS;PRS;PRS;PRS;PRS;
overplow V;V.PTCP;PST	;PTCP;PST;PST;PST;PST;PST;PST;
overpublicize V;NFIN	 V;NFIN V;NFIN V;NFIN V;NFIN V
overpublicize V;V.PTCP;PRS	;V.PTCP;PRS;PRS;PRS;PRS;PRS;PR
overpublicize V;V.PTCP;PST	;PTCP;PST;PST;PST;PST;PST;PST;
overreckon V;NFIN	 V;NFINA;NFINA;NFINA;NFINA;NFI
overreckon V;PRS;NOM(3,SG)	;PRS;NOM(3,SG);NOM(3,SG);NOM(3
overreckon V;PST	verreckon V;PST;PST;PST;PST;PS
overreckon V;V.PTCP;PRS	;PTCP;PRS;PRS;PRS;PRS;PRS;PRS;
overtask V;NFIN	vertask V;NFINFINFINFINFINFINF
overtask V;PRS;NOM(3,SG)	ertask V;PRS;NOM(3,SG);NOM(3,S
overtask V;V.PTCP;PRS	;PTCP;PRS;PRS;PRS;PRS;PRS;PRS;
overtask V;V.PTCP;PST	;PTCP;PST;PST;PST;PST;PST;PST;
overwater V;NFIN	verwater V;NFINN;NFINN;NFINN;N
overwater V;PST	water V;PST;PST;PST;PST;PST;PS
palatalize V;NFIN	alize V;NFINNFINNFINNFINNFINNF
palatalize V;PST	alatalize V;PST;PST;PST;PST;PS
palatalize V;V.PTCP;PRS	;PTCP;PRS;PRS;PRS;PRS;PRS;PRS;
palatalize V;V.PTCP;PST	;PTCP;PST;PST;PST;PST;PST;PST;
paralyze V;NFIN	yze V;NFINFINFINFINFINFINFINFI
paralyze V;PRS;NOM(3,SG)	;PRS;NOM(3,SG) V;PRS;NOM(3,SG)
paralyze V;V.PTCP;PRS	;PTCP;PRS;PRS;PRS;PRS;PRS;PRS;
parboil V;NFIN	;NFIN;NFIN;NFIN;NFIN;NFIN;NFIN
parboil V;PRS;NOM(3,SG)	;PRS;NOM(3,SG) V;PRS;NOM(3,SG)
parboil V;V.PTCP;PRS	;PTCP;PRS;PRS;PRS;PRS;PRS;PRS;
parboil V;V.PTCP;PST	;PTCP;PST;PST;PST;PST;PST;PST;
pauperise V;PRS;NOM(3,SG)	;NOM(3,SG);NOM(3,SG);NOM(3,SG)
pauperise V;PST	;PST;PST;PST;PST;PST;PST;PST;P
pauperise V;V.PTCP;PRS	;V.PTCP;PRS;PRS;PRS;PRS;PRS;PR
pauperise V;V.PTCP;PST	;PTCP;PST;PST;PST;PST;PST;PST;
perhorresce V;PRS;NOM(3,SG)	;PRS;NOM(3,SG);NOM(3,SG);NOM(3
perhorresce V;PST	resce V;PST;PST;PST;PST;PST;PS
perhorresce V;V.PTCP;PRS	;PTCP;PRS;PRS;PRS;PRS;PRS;PRS;
perhorresce V;V.PTCP;PST	;PTCP;PST;PST;PST;PST;PST;PST;
phosphorylate V;NFIN	;NFINININININININININININININI
phosphorylate V;V.PTCP;PST	;PTCP;PST;PST;PST;PST;PST;PST;
piggyback V;PRS;NOM(3,SG)	 V;PRS;NOM(3,SG);NOM(3,SG);NOM
piggyback V;PST	;PST;PST;PST;PST;PST;PST;PST;P
piggyback V;V.PTCP;PRS	;PTCP;PRS;PRS;PRS;PRS;PRS;PRS;
piggyback V;V.PTCP;PST	;PST;PST;PST;PST;PST;PST;PST;P
politize V;NFIN	 V;NFINTINTINTINTINTINTINTINTI
politize V;PST	ze V;PST;PST;PST;PST;PST;PST;P
politize V;V.PTCP;PST	;PTCP;PST;PST;PST;PST;PST;PST;
polycondense V;NFIN	;NFIN;NFIN;NFIN;NFIN;NFIN;NFIN
polycondense V;PRS;NOM(3,SG)	;PRS;NOM(3,SG);PRS;NOM(3,SG);P
polycondense V;PST	;PST;PST;PST;PST;PST;PST;PST;P
polycondense V;V.PTCP;PST	PTCP;PST;PST;PST;PST;PST;PST;P
polytenize V;NFIN	nize V;NFINNFINNFINNFINNFINNFI
polytenize V;PRS;NOM(3,SG)	;PRS;NOM(3,SG) V;PRS;NOM(3,SG)
polytenize V;V.PTCP;PST	enize V;V.PTCP;PST;PST;PST;PST
pork V;PST	pork V;PST;PST;PST;PST;PST;PST
pork V;V.PTCP;PRS	;PTCP;PRS;PRS;PRS;PRS;PRS;PRS;
pork V;V.PTCP;PST	PTCP;PST;PST;PST;PST;PST;PST;P
pouch V;NFIN	 V;NFIN IN IN IN IN IN IN IN I
pouch V;PST	 V;PST V;PST V;PST V;PST V;PST
pouch V;V.PTCP;PRS	;PTCP;PRS;PRS;PRS;PRS;PRS;PRS;
pouch V;V.PTCP;PST	;PTCP;PST;PST;PST;PST;PST;PST;
practicalize V;NFIN	NFIN;NFIN;N;N;N;N;N;N;N;N;N;N;
practicalize V;PRS;NOM(3,SG)	;PRS;NOM(3,SG) V;PRS;NOM(3,SG)
practicalize V;PST	icalize V;PST;PST;PST;PST;PST;
practicalize V;V.PTCP;PRS	;V.PTCP;PRS;PRS;PRS;PRS;PRS;PR
praise V;NFIN	;
NFINFINFINFINFINFINFINFINFIN
praise V;V.PTCP;PST	;PTCP;PST;PST;PST;PST;PST;PST;
predicate V;NFIN	;NFINN;NFINN;NFINN;NFINN;NFINN
predicate V;V.PTCP;PRS	;PTCP;PRS;PRS;PRS;PRS;PRS;PRS;
preprogram V;NFIN	;NFIN;N;NFIN;N;N;NFIN;N;N;NFIN
preprogram V;PRS;NOM(3,SG)	preprogram V;PRS;NOM(3,SG);NOM
preprogram V;V.PTCP;PRS	;PTCP;PRS;PRS;PRS;PRS;PRS;PRS;
preprogram V;V.PTCP;PST	;PTCP;PST;PST;PST;PST;PST;PST;
preseed V;NFIN	;NFINFINFINFINFINFINFINFINFINF
preseed V;PRS;NOM(3,SG)	;PRS;NOM(3,SG) V;PRS;NOM(3,SG)
preseed V;PST	preseed V;PST;PST;PST;PST;PST;
preseed V;V.PTCP;PST	;PTCP;PST;PST;PST;PST;PST;PST;
preshow V;PST	preshow V;PST;PST;PST;PST;PST;
preshow V;V.PTCP;PRS	preshow V;V.PTCP;PRS;PRS;PRS;P
preshow V;V.PTCP;PST	;PTCP;PST;PST;PST;PST;PST;PST;
pretest V;PRS;NOM(3,SG)	;PRS;NOM(3,SG) V;PRS;NOM(3,SG)
pretest V;PST	pretest V;PST;PST;PST;PST;PST;
pretest V;V.PTCP;PRS	PTCP;PRS;PRS;PRS;PRS;PRS;PRS;P
pretest V;V.PTCP;PST	PTCP;PST;PST;PST;PST;PST;PST;P
proclaime V;NFIN	nfin
NFINFINFINFINFINFINFINFIN
proclaime V;V.PTCP;PST	;PTCP;PST;PST;PST;PST;PST;PST;
protocol V;PRS;NOM(3,SG)	(3,SG))
Protocol V;PRS;NOM(3,S
protocol V;PST	 V;PST;PST;PST;PST;PST;PST;PST
protocol V;V.PTCP;PRS	;PTCP;PRS;PRS;PRS;PRS;PRS;PRS;
provinciate V;NFIN	;NFINFINFINFINFINFINFINFINFINF
provinciate V;PST	;PST;PST;PST;PST;PST;PST;PST;P
provinciate V;V.PTCP;PRS	;V.PTCP;PRS;PRS;PRS;PRS;PRS;PR
provinciate V;V.PTCP;PST	;V.PTCP;PST;PST;PST;PST;PST;PS
re-dye V;NFIN	e-dye V;NFINAAAAAAAAAAAAAAAAAA
re-dye V;PST	e-dye V;PST V;PST V;PST V;PST 
re-dye V;V.PTCP;PRS	;PTCP;PRS;PRS;PRS;PRS;PRS;PRS;
re-dye V;V.PTCP;PST	;PTCP;PST;PST;PST;PST;PST;PST;
re-use V;NFIN	e-use V;NFININININININININININ
re-use V;PRS;NOM(3,SG)	;NOM(3,SG) V;PRS;NOM(3,SG) V;P
re-use V;PST	e-use V;PST;PST;PST;PST;PST;PS
re-use V;V.PTCP;PRS	;PTCP;PRS;PRS;PRS;PRS;PRS;PRS;
rearrest V;NFIN	rest V;NFININININININININININI
rearrest V;V.PTCP;PRS	;V.PTCP;PRS;PRS;PRS;PRS;PRS;PR
redemand V;NFIN	edemand V;NFINININININININININ
redemand V;V.PTCP;PRS	;PTCP;PRS;PRS;PRS;PRS;PRS;PRS;
redemand V;V.PTCP;PST	;V.PTCP;PST;PST;PST;PST;PST;PS
redline V;PST	edline V;PST;PST;PST;PST;PST;P
redline V;V.PTCP;PST	;PTCP;PST;PST;PST;PST;PST;PST;
refamiliarize V;NFIN	;NFINFINFINFINFINFINFINFINFINF
refamiliarize V;PRS;NOM(3,SG)	;PRS;NOM(3,SG) V;PRS;NOM(3,SG)
refamiliarize V;PST	efamiliarize V;PST;PST;PST;PST
refamiliarize V;V.PTCP;PRS	;PTCP;PRS;PRS;PRS;PRS;PRS;PRS;
refold V;PRS;NOM(3,SG)	;NOM(3,SG) V;PRS;NOM(3,SG) V;P
refold V;PST	efold V;PST;PST;PST;PST;PST;PS
refold V;V.PTCP;PRS	;PTCP;PRS;PRS;PRS;PRS;PRS;PRS;
refold V;V.PTCP;PST	;PTCP;PST;PST;PST;PST;PST;PST;
regale V;NFIN	NFININININININININININININININ
regale V;PRS;NOM(3,SG)	;PRS;NOM(3,SG);PRS;NOM(3,SG);P
regale V;V.PTCP;PRS	;PTCP;PRS;PRS;PRS;PRS;PRS;PRS;
regale V;V.PTCP;PST	PTCP;PST;PST;PST;PST;PST;PST;P
regiment V;PST	egiment V;PST;PST;PST;PST;PST;
regiment V;V.PTCP;PST	PTCP;PST;PST;PST;PST;PST;PST;P
rehybridize V;NFIN	e V;NFIN;NFIN;NFIN;NFIN;NFIN;N
rehybridize V;PRS;NOM(3,SG)	;PRS;NOM(3,SG) V;PRS;NOM(3,SG)
rehybridize V;PST	ze V;PST V;PST V;PST V;PST V;P
rehybridize V;V.PTCP;PRS	;V.PTCP;PRS;PRS;PRS;PRS;PRS;PR
reinsulate V;NFIN	einsulate V;NFININININININININ
reinsulate V;V.PTCP;PST	sulate V;V.PTCP;PST;PST;PST;PS
relodge V;NFIN	NFININININININININININININININ
relodge V;PST	elodge V;PST;PST;PST;PST;PST;P
relodge V;V.PTCP;PRS	;PTCP;PRS;PRS;PRS;PRS;PRS;PRS;
relodge V;V.PTCP;PST	;PTCP;PST;PST;PST;PST;PST;PST;
remodel V;PRS;NOM(3,SG)	;NOM(3,SG);NOM(3,SG);NOM(3,SG)
remodel V;PST	el V;PST;PST;PST;PST;PST;PST;P
remodel V;V.PTCP;PRS	;V.PTCP;PRS;PRS;PRS;PRS;PRS;PR
remodel V;V.PTCP;PST	;V.PTCP;PST;PST;PST;PST;PST;PS
renaturalize V;NFIN	enaturalize V;NFINININININININ
renaturalize V;PRS;NOM(3,SG)	;PRS;NOM(3,SG);PRS;NOM(3,SG);P
renaturalize V;V.PTCP;PRS	;PTCP;PRS;PRS;PRS;PRS;PRS;PRS;
renaturalize V;V.PTCP;PST	;PTCP;PST;PST;PST;PST;PST;PST;
reperuse V;NFIN	eperuse V;NFINNNNNNNNNNNNNNNNN
reperuse V;PRS;NOM(3,SG)	;PRS;NOM(3,SG);NOM(3,SG);NOM(3
reperuse V;PST	eperuse V;PST;PST;PST;PST;PST;
reperuse V;V.PTCP;PST	e V;V.PTCP;PST;PST;PST;PST;PST
repipe V;NFIN	epipe V;NFININININININININININ
repipe V;PRS;NOM(3,SG)	;NOM(3,SG) V;PRS;NOM(3,SG) V;P
repipe V;V.PTCP;PST	;PTCP;PST;PST;PST;PST;PST;PST;
repopularise V;NFIN	pularise V;NFININININININININI
repopularise V;PST	pularise V;PST;PST;PST;PST;PST
repopularise V;V.PTCP;PRS	;V.PTCP;PRS;PRS;PRS;PRS;PRS;PR
repopularise V;V.PTCP;PST	;V.PTCP;PST;PST;PST;PST;PST;PS
repot V;NFIN	;NFINININININININININININININI
repot V;PST	;PST;PST;PST;PST;PST;PST;PST;P
repot V;V.PTCP;PRS	;PTCP;PRS;PRS;PRS;PRS;PRS;PRS;
repot V;V.PTCP;PST	;PTCP;PST;PST;PST;PST;PST;PST;
reprice V;NFIN	eprice V;NFINININININININININI
reprice V;PRS;NOM(3,SG)	;PRS;NOM(3,SG) V;PRS;NOM(3,SG)
reprice V;V.PTCP;PRS	;V.PTCP;PRS;PRS;PRS;PRS;PRS;PR
reprice V;V.PTCP;PST	;V.PTCP;PST;PST;PST;PST;PST;PS
reprogramme V;NFIN	NFININININININININININININININ
reprogramme V;PRS;NOM(3,SG)	;PRS;NOM(3,SG);NOM(3,SG);NOM(3
reprogramme V;V.PTCP;PRS	;PTCP;PRS;PRS;PRS;PRS;PRS;PRS;
reprogramme V;V.PTCP;PST	;PTCP;PST;PST;PST;PST;PST;PST;
resent V;PST	esent S;PST;PST;PST;PST;PST;PS
resent V;V.PTCP;PRS	;PTCP;PRS;PRS;PRS;PRS;PRS;PRS;
resent V;V.PTCP;PST	;PTCP;PST;PST;PST;PST;PST;PST;
revector V;NFIN	;NFINININININININININININININI
revector V;PRS;NOM(3,SG)	;PRS;NOM(3,SG);NOM(3,SG);NOM(3
revector V;PST	evector V;PST;PST;PST;PST;PST;
revector V;V.PTCP;PST	;V.PTCP;PST;PST;PST;PST;PST;PS
rewetten V;NFIN	ewetten V;NFINININININININININ
rewetten V;PST	ewetten V;PST V;PST V;PST V;PS
rewetten V;V.PTCP;PRS	;PTCP;PRS;PRS;PRS;PRS;PRS;PRS;
rewetten V;V.PTCP;PST	;PTCP;PST;PST;PST;PST;PST;PST;
rigidize V;NFIN	rigidize V;NFINFINFINFINFINFIN
rigidize V;PRS;NOM(3,SG)	;PRS;NOM(3,SG);PRS;NOM(3,SG);P
rigidize V;V.PTCP;PRS	;PTCP;PRS;PRS;PRS;PRS;PRS;PRS;
rigidize V;V.PTCP;PST	;PTCP;PST;PST;PST;PST;PST;PST;
roadshow V;PRS;NOM(3,SG)	;NOM(3,SG) V;PRS;NOM(3,SG) V;P
roadshow V;PST	adshow v;p;p;p;p;p;p;p;p;p;p;p
roadshow V;V.PTCP;PRS	;PTCP;PRS;PRS;PRS;PRS;PRS;PRS;
roadshow V;V.PTCP;PST	;PTCP;PST;PST;PST;PST;PST;PST;
romanticise V;NFIN	ise V;NFINININININININININININ
romanticise V;PRS;NOM(3,SG)	;PRS;NOM(3,SG);PRS;NOM(3,SG);P
romanticise V;V.PTCP;PRS	;PTCP;PRS;PRS;PRS;PRS;PRS;PRS;
romanticise V;V.PTCP;PST	;PTCP;PST;PST;PST;PST;PST;PST;
rong V;NFIN	rong v;nfing v;nfing v;nfing v
rong V;PRS;NOM(3,SG)	;NOM(3,SG) V;PRS;NOM(3,SG) V;P
rong V;V.PTCP;PRS	 V;V.PTCP;PRS;PRS;PRS;PRS;PRS;
rong V;V.PTCP;PST	;PTCP;PST;PST;PST;PST;PST;PST;
ross V;NFIN	ross V;NFINFINFINFINFINFINFINF
ross V;PRS;NOM(3,SG)	;PRS;NOM(3,SG)
PRS;NOM(3,SG)
P
ross V;PST	ross V;PSTSTSTSTSTSTSTSTSTSTST
roughen V;NFIN	rroughen V;NFINNNNNNNNNNNNNNNN
roughen V;PRS;NOM(3,SG)	;NOM(3,SG);NOM(3,SG);NOM(3,SG)
roughen V;V.PTCP;PST	;PTCP;PST;PST;PST;PST;PST;PST;
roundtrip V;NFIN	;NFIN;NFIN;NFIN;NFIN;NFIN;NFIN
roundtrip V;PST	trip V;PST;PST;PST;PST;PST;PST
roundtrip V;V.PTCP;PRS	;PTCP;PRS;PRS;PRS;PRS;PRS;PRS;
sail V;PRS;NOM(3,SG)	;NOM(3,SG) Sail V;PRS;NOM(3,SG
sail V;PST	T;PST;PST;PST;PST;PST;PST;PST;
sail V;V.PTCP;PRS	 A;V.PTCP;PRS;PRS;PRS;PRS;PRS;
sap V;V.PTCP;PRS	 V;V.PTCP;PRS;PRS;PRS;PRS;PRS;
sap V;V.PTCP;PST	 V;V.PTCP;PST;PST;PST;PST;PST;
sardine V;NFIN	ardine V;NFINININININININININI
sardine V;PRS;NOM(3,SG)	;PRS;NOM(3,SG);NOM(3,SG);NOM(3
sardine V;PST	ardine V;PST;PST;PST;PST;PST;P
sardine V;V.PTCP;PST	;V.PTCP;PST;PST;PST;PST;PST;PS
scapegoat V;NFIN	;NFINININININININININININININI
scapegoat V;PRS;NOM(3,SG)	;NOM(3,SG);NOM(3,SG);NOM(3,SG)
scapegoat V;V.PTCP;PRS	;PTCP;PRS;PRS;PRS;PRS;PRS;PRS;
scapegoat V;V.PTCP;PST	;PTCP;PST;PST;PST;PST;PST;PST;
scone V;NFIN	V;NFIN;NFIN;NFIN;NFIN;NFIN;NFI
scone V;PRS;NOM(3,SG)	;NOM(3,SG) V;PRS;NOM(3,SG) V;P
scone V;PST	scone V;PSTSTSTSCSCSCSCSCSCSCS
scone V;V.PTCP;PST	PTCP;PST;PST;PST;PST;PST;PST;P
season V;NFIN	 V;NFININININININININININININI
season V;PST	eason V;PST;PST;PST;PST;PST;PS
season V;V.PTCP;PRS	eason V;V.PTCP;PRS;PRS;PRS;PRS
season V;V.PTCP;PST	;V.PTCP;PST;PST;PST;PST;PST;PS
seceed V;PRS;NOM(3,SG)	;NOM(3,SG) V;PRS;NOM(3,SG) V;P
seceed V;PST	eceed V;PST;PST;PST;PST;PST;PS
seceed V;V.PTCP;PRS	eceed V;V.PTCP;PRS;PRS;PRS;PRS
seceed V;V.PTCP;PST	;PTCP;PST;PST;PST;PST;PST;PST;
sheal V;NFIN	;NFIN;NFIN;NFIN;NFIN;NFIN;NFIN
sheal V;PRS;NOM(3,SG)	;NOM(3,SG)
PRS;NOM(3,SG)
PRS;N
sheal V;PST	Sheal V;PSTST Sheal Sheal Shea
sheal V;V.PTCP;PST	;PTCP;PST;PST;PST;PST;PST;PST;
sie V;NFIN	;nfin ;nfin ;nfin ;nfin ;nfin 
sie V;PST	St;PST;PST;PST;PST;PST;PST;PST
sie V;V.PTCP;PRS	;V.PTCP;PRS;PRS;PRS;PRS;PRS;PR
sie V;V.PTCP;PST	 V;V.PTCP;PST;PST;PST;PST;PST;
slick V;NFIN	;NFIN;N;N;N;N;N;N;N;N;N;N;N;N;
slick V;PST	;PST;PST;PST;PST;PST;PST;PST;P
slick V;V.PTCP;PST	P;PST;PST;PST;PST;PST;PST;PST;
smirk V;NFIN	;NFIN;NFIN;NFIN;NFIN;NFIN;NFIN
smirk V;PRS;NOM(3,SG)	rk V;PRS;NOM(3,SG) V;PRS;NOM(3
smirk V;V.PTCP;PRS	.PTCP;PRS;PRS;PRS;PRS;PRS;PRS;
smush V;NFIN	;NFIN;N;N;N;N;N;N;N;N;N;N;N;N;
smush V;PST	;;;;;;;;;;;;;;;;;;;;;;;;;;;;;;
smush V;V.PTCP;PRS	;PTCP;PRS;PRS;PRS;PRS;PRS;PRS;
softload V;NFIN	oad V;NFINNYNYNYNYNYNYNYNYNYNY
softload V;PRS;NOM(3,SG)	;PRS;NOM(3,SG);PRS;NOM(3,SG);P
softload V;PST	oftload V;PST;PST;PST;PST;PST;
softload V;V.PTCP;PRS	;PTCP;PRS;PRS;PRS;PRS;PRS;PRS;
somnambulate V;PRS;NOM(3,SG)	ambulate V;PRS;NOM(3,SG);NOM(3
somnambulate V;PST	mbulate V;PST;PST;PST;PST;PST;
somnambulate V;V.PTCP;PRS	;PTCP;PRS;PRS;PRS;PRS;PRS;PRS;
somnambulate V;V.PTCP;PST	PTCP;PST;PST;PST;PST;PST;PST;P
spile V;NFIN	spile V;NFINANANANANANANANANAN
spile V;PRS;NOM(3,SG)	;PRS;NOM(3,SG) V;PRS;NOM(3,SG)
spile V;PST	spile V;PST;PST;PST;PST;PST;PS
spile V;V.PTCP;PRS	PTCP;PRS;PRS;PRS;PRS;PRS;PRS;P
staddle V;NFIN	staddle V;NFIN;NFIN;NFIN;NFIN;
staddle V;PRS;NOM(3,SG)	;PRS;NOM(3,SG) V;PRS;NOM(3,SG)
staddle V;V.PTCP;PRS	 V;V.PTCP;PRS;PRS;PRS;PRS;PRS;
starburst V;PRS;NOM(3,SG)	;PRS;NOM(3,SG);NOM(3,SG);NOM(3
starburst V;PST	tarburst V;PST V;PST V;PST V;P
starburst V;V.PTCP;PRS	;PTCP;PRS;PRS;PRS;PRS;PRS;PRS;
stark V;NFIN	stark V;NFinastark V;NFinastar
stark V;PRS;NOM(3,SG)	;PRS;NOM(3,SG);NOM(3,SG);NOM(3
stark V;PST	stark V;;;;;;;;;;;;;;;;;;;;;;;
stark V;V.PTCP;PRS	stark V;V.PTCP;PRSP;PRSP;PRSP;
sternutate V;PRS;NOM(3,SG)	;PRS;NOM(3,SG);NOM(3,SG);NOM(3
sternutate V;PST	ternutate V;PST;PST;PST;PST;PS
sternutate V;V.PTCP;PRS	;PTCP;PRS;PRS;PRS;PRS;PRS;PRS;
sternutate V;V.PTCP;PST	PTCP;PST;PST;PST;PST;PST;PST;P
storm V;NFIN	storm V;NFIN;NFIN;NFIN;NFIN;NF
storm V;PRS;NOM(3,SG)	 S;PRS;NOM(3,SG)
Storm V;PRS;N
storm V;V.PTCP;PST	 V;V.PTCP;PST;PST;PST;PST;PST;
storyboard V;PRS;NOM(3,SG)	;PRS;NOM(3,SG) V;PRS;NOM(3,SG)
storyboard V;PST	board V;PST;PST;PST;PST;PST;PS
stringify V;NFIN	stringify V;NFIN;NFIN;NFIN;NFI
stringify V;PST	stringify V;PST;PST;PST;PST;PS
stringify V;V.PTCP;PRS	 V;V.PTCP;PRS;PRS;PRS;PRS;PRS;
stringify V;V.PTCP;PST	;V.PTCP;PST;PST;PST;PST;PST;PS
strip-search V;NFIN	earch V;NFININININININININININ
strip-search V;V.PTCP;PRS	;PTCP;PRS;PRS;PRS;PRS;PRS;PRS;
strip-search V;V.PTCP;PST	;PTCP;PST;PST;PST;PST;PST;PST;
strow V;NFIN	V;NFIN;N;N;N;N;N;N;N;N;N;N;N;N
strow V;PST	strow V;PST;Strow V;PST;Strow 
strow V;V.PTCP;PRS	V;V.PTCP;PRS;PRS;PRS;PRS;PRS;P
strow V;V.PTCP;PST	PTCP;PST;PST;PST;PST;PST;PST;P
sublime V;NFIN	NFIN;NFIN;NFIN;NFIN;NFIN;NFIN;
sublime V;V.PTCP;PST	;PTCP;PST;PST;PST;PST;PST;PST;
subsidise V;PRS;NOM(3,SG)	;PRS;NOM(3,SG);NOM(3,SG);NOM(3
subsidise V;V.PTCP;PRS	;V.PTCP;PRS;PRS;PRS;PRS;PRS;PR
subsidise V;V.PTCP;PST	;PTCP;PST;PST;PST;PST;PST;PST;
superordinate V;NFIN	nate V;NFININININININININININI
superordinate V;PRS;NOM(3,SG)	erordinate V;PRS;NOM(3,SG);NOM
superordinate V;PST	nate V;PST V;PST V;PST V;PST V
supervene V;NFIN	vene V;NFININININININININININI
supervene V;PRS;NOM(3,SG)	 V;PRS;NOM(3,SG) V;PRS;NOM(3,S
supervene V;PST	upervene V;PSTV;PSTV;PSTV;PSTV
supervene V;V.PTCP;PRS	;PTCP;PRS;PRS;PRS;PRS;PRS;PRS;
survive V;PRS;NOM(3,SG)	;PRS;NOM(3,SG);NOM(3,SG);NOM(3
survive V;PST	urvive V;PST;PST;PST;PST;PST;P
survive V;V.PTCP;PRS	;PTCP;PRS;PRS;PRS;PRS;PRS;PRS;
terp V;NFIN	 V;NFINAN INAN INAN INAN INAN 
terp V;PST	erp ST;PST;PST;PST;PST;PST;PST
terp V;V.PTCP;PRS	;V.PTCP;PRS;PRS;PRS;PRS;PRS;PR
terp V;V.PTCP;PST	;V.PTCP;PST;PST;PST;PST;PST;PS
thrombose V;NFIN	thrombose V;NFIN;NFIN;NFIN;NFI
thrombose V;PRS;NOM(3,SG)	;PRS;NOM(3,SG);NOM(3,SG);NOM(3
thrombose V;V.PTCP;PST	;V.PTCP;PST;PST;PST;PST;PST;PS
tint V;NFIN	 V;NFININININININININININININI
tint V;PRS;NOM(3,SG)	;NOM(3,SG) PRS;NOM(3,SG) PRS;N
tint V;V.PTCP;PRS	;PTCP;PRS;PRS;PRS;PRS;PRS;PRS;
tint V;V.PTCP;PST	PTCP;PST;PST;PST;PST;PST;PST;P
tipple V;PRS;NOM(3,SG)	;NOM(3,SG);NOM(3,SG);NOM(3,SG)
tipple V;PST	pple e e e e e e e e e e e e e
tipple V;V.PTCP;PRS	;PTCP;PRS;PRS;PRS;PRS;PRS;PRS;
tipple V;V.PTCP;PST	ple V;V.PTCP;PST;PST;PST;PST;P
titivate V;PRS;NOM(3,SG)	;PRS;NOM(3,SG) Participativate
titivate V;V.PTCP;PRS	PTCP;PRSP;PRSP;PRSP;PRSP;PRSP;
titivate V;V.PTCP;PST	 V;V.PTCP;PST;PST;PST;PST;PST;
transsexualize V;PRS;NOM(3,SG)	;PRS;NOM(3,SG);PRS;NOM(3,SG);P
transsexualize V;PST	V;PST;PST;PST;PST;PST;PST;PST;
transsexualize V;V.PTCP;PRS	;PTCP;PRS;PRS;PRS;PRS;PRS;PRS;
transsexualize V;V.PTCP;PST	;PTCP;PST;PST;PST;PST;PST;PST;
trench-plough V;NFIN	nch-plough V;NFINFINFINFINFINF
trench-plough V;PRS;NOM(3,SG)	;NOM(3,SG) V;PRS;NOM(3,SG) V;P
trench-plough V;V.PTCP;PST	;PTCP;PST;PST;PST;PST;PST;PST;
trice V;PRS;NOM(3,SG)	;NOM(3,SG) PRS;NOM(3,SG) PRS;N
trice V;PST	V;PST;PST;PST;PST;PST;PST;PST;
trice V;V.PTCP;PRS	;PTCP;PRS;PRS;PRS;PRS;PRS;PRS;
trypsinise V;NFIN	inise V;NFIN;NFIN;NFIN;NFINN;N
trypsinise V;PRS;NOM(3,SG)	;PRS;NOM(3,SG);NOM(3,SG);NOM(3
trypsinise V;V.PTCP;PRS	;PTCP;PRS;PRS;PRS;PRS;PRS;PRS;
trypsinise V;V.PTCP;PST	;PTCP;PST;PST;PST;PST;PST;PST;
tubulate V;PRS;NOM(3,SG)	;PRS;NOM(3,SG);NOM(3,SG);NOM(3
tubulate V;PST	ubulate V;PST;PST;PST;PST;PST;
twine V;PRS;NOM(3,SG)	;NOM(3,SG) PRS;NOM(3,SG) PRS;N
twine V;PST	V;PST;PST;PST;PST;PST;PST;PST;
twine V;V.PTCP;PRS	e V;V.PTCP;PRS;PRS;PRS;PRS;PRS
twist V;PRS;NOM(3,SG)	;NOM(3,SG) V;PRS;NOM(3,SG) V;P
twist V;PST	ST;PST;PST;PST;PST;PST;PST;PST
twist V;V.PTCP;PRS	PTCP;PRS;PRS;PRS;PRS;PRS;PRS;P
twist V;V.PTCP;PST	;PTCP;PST;PST;PST;PST;PST;PST;
unclamp V;NFIN	unclamp V;NFIN;;NFIN;;NFIN;;NF
unclamp V;PRS;NOM(3,SG)	;PRS;NOM(3,SG) V;PRS;NOM(3,SG)
unclamp V;V.PTCP;PRS	p V;V.PTCP;PRS;PRS;PRS;PRS;PRS
undeceave V;NFIN	NFINFINFINFINFINFINFINFINFINFI
undeceave V;PST	pste v;pste v;pste v;pste v;ps
underdose V;PRS;NOM(3,SG)	;PRS;NOM(3,SG);PRS;NOM(3,SG);P
underdose V;V.PTCP;PRS	erdose V;V.PTCP;PRS;PRS;PRS;PR
underdose V;V.PTCP;PST	;PTCP;PST;PST;PST;PST;PST;PST;
unfocus V;PST	;;;;;;;;;;;;;;;;;;;;;;;;;;;;;;
unfocus V;V.PTCP;PRS	;PTCP;PRS;PRS;PRS;PRS;PRS;PRS;
unfocus V;V.PTCP;PST	;PTCP;PST;PST;PST;PST;PST;PST;
unhyphenate V;PRS;NOM(3,SG)	hyphenate V;PRS;NOM(3,SG)
PRS;
unhyphenate V;PST	e V;PST;ST;ST;ST;ST;ST;ST;ST;S
unhyphenate V;V.PTCP;PRS	;PTCP;PRS;PRS;PRS;PRS;PRS;PRS;
unhyphenate V;V.PTCP;PST	;PTCP;PST;PST;PST;PST;PST;PST;
unpaint V;NFIN	paint v;nfinant v;nfinaunpaint
unpaint V;PRS;NOM(3,SG)	;PRS;NOM(3,SG) V;PRS;NOM(3,SG)
unperplex V;PRS;NOM(3,SG)	;NOM(3,SG);NOM(3,SG);NOM(3,SG)
unperplex V;V.PTCP;PRS	plex V;V.PTCP;PRS;PRS;PRS;PRS;
unperplex V;V.PTCP;PST	;PTCP;PST;PST;PST;PST;PST;PST;
unplat V;NFIN	;nfin;nfin;nfin;nfin;nfin;nfin
unplat V;PRS;NOM(3,SG)	;PRS;NOM(3,SG) PRS;NOM(3,SG) P
unplat V;V.PTCP;PST	;PTCP;PST;PST;PST;PST;PST;PST;
unplug V;NFIN	plug V;NFIN;
NFIN;
NFIN;
NFIN;
unplug V;PRS;NOM(3,SG)	;NOM(3,SG) V;PRS;NOM(3,SG) V;P
unplug V;PST	plug v; pst plug v; pst plug v
unplug V;V.PTCP;PST	 V;V.PTCP;PST;PST;PST;PST;PST;
unsell V;NFIN	unsell V;NFIN;NFIN;NFIN;NFIN;N
unsell V;PRS;NOM(3,SG)	;PRS;NOM(3,SG) V;PRS;NOM(3,SG)
unsell V;PST	ll V;PST;PST;PST;PST;PST;PST;P
unsell V;V.PTCP;PST	;PTCP;PST;PST;PST;PST;PST;PST;
unstabilize V;PRS;NOM(3,SG)	;PRS;NOM(3,SG) V;PRS;NOM(3,SG)
upbar V;NFIN	;NFIN V;NFIN V;NFIN V;NFIN V;N
upbar V;PRS;NOM(3,SG)	;PRS;NOM(3,SG) Startseite V;PR
upbar V;PST	T;PST;PST;PST;PST;PST;PST;PST;
upbar V;V.PTCP;PST	;PTCP;PST;PST;PST;PST;PST;PST;
usher V;NFIN	usher V;NFIN;NFIN;NFIN;NFIN;NF
usher V;PST	;PST;PST;PST;PST;PST;PST;PST;P
usher V;V.PTCP;PRS	;V.PTCP;PRS;PRS;PRS;PRS;PRS;PR
usher V;V.PTCP;PST	er V;V.PTCP;PST;PST;PST;PST;PS
vaccinate V;NFIN	accinate V;NFININININININININI
vaccinate V;PST	;PST;PST;PST;PST;PST;PST;PST;P
vaccinate V;V.PTCP;PRS	;PTCP;PRS;PRS;PRS;PRS;PRS;PRS;
vaccinate V;V.PTCP;PST	;PTCP;PST;PST;PST;PST;PST;PST;
vacillate V;PRS;NOM(3,SG)	;PRS;NOM(3,SG);NOM(3,SG);NOM(3
vacillate V;V.PTCP;PRS	;PTCP;PRS;PRS;PRS;PRS;PRS;PRS;
vacillate V;V.PTCP;PST	PTCP;PST;PST;PST;PST;PST;PST;P
vell V;NFIN	l V;NFININININININININININININ
vell V;PRS;NOM(3,SG)	;NOM(3,SG) Steinberg V;PRS;NOM
vell V;V.PTCP;PST	;PTCP;PST;PST;PST;PST;PST;PST;
verbigerate V;NFIN	erbigerate V;NFINN V;NFINN V;N
verbigerate V;PRS;NOM(3,SG)	;PRS;NOM(3,SG);NOM(3,SG);NOM(3
verbigerate V;PST	;PST;PST;PST;PST;PST;PST;PST;P
verbigerate V;V.PTCP;PRS	PTCP;PRS;PRS;PRS;PRS;PRS;PRS;P
viscerate V;NFIN	;NFINININININININININININININI
viscerate V;PST	;PST;PST;PST;PST;PST;PST;PST;P
viscerate V;V.PTCP;PRS	;PTCP;PRS;PRS;PRS;PRS;PRS;PRS;
viscerate V;V.PTCP;PST	;PTCP;PST;PST;PST;PST;PST;PST;
vivificate V;NFIN	iviviviviviviviviviviviviviviv
vivificate V;PRS;NOM(3,SG)	;PRS;NOM(3,SG)) Strain V;PRS;N
vivificate V;PST	;PST;PST;PST;PST;PST;PST;PST;P
vivificate V;V.PTCP;PST	PTCP;PST;PST;PST;PST;PST;PST;P
wabble V;NFIN	 V;NFIN NFIN NFIN NFIN NFIN NF
wabble V;PRS;NOM(3,SG)	;NOM(3,SG) V;PRS;NOM(3,SG) V;P
wabble V;PST	 V;PST V;PST V;PST V;PST V;PST
wabble V;V.PTCP;PRS	;V.PTCP;PRS;PRS;PRS;PRS;PRS;PR
watchdog V;NFIN	NFIN;NFIN;NFIN;NFIN;NFIN;NFIN;
watchdog V;PST	;PST;PST;PST;PST;PST;PST;PST;P
watchdog V;V.PTCP;PST	;PTCP;PST;PST;PST;PST;PST;PST;
water V;NFIN	ater V;NFININININININININININI
water V;PST	 V;PST;PST;PST;PST;PST;PST;PST
water V;V.PTCP;PST	PTCP;PST;PST;PST;PST;PST;PST;P
wham V;PRS;NOM(3,SG)	;NOM(3,SG) V;PRS;NOM(3,SG) V;P
wham V;V.PTCP;PST	;PTCP;PST;PST;PST;PST;PST;PST;
whoomp V;NFIN	NFIN V;NFIN V;NFIN V;NFIN V;NF
whoomp V;PRS;NOM(3,SG)	;PRS;NOM(3,SG) V;PRS;NOM(3,SG)
whoomp V;PST	hoomp V;PST V;PST V;PST V;PST 
whoomp V;V.PTCP;PST	PTCP;PST;PST;PST;PST;PST;PST;P
whoot V;PRS;NOM(3,SG)	;NOM(3,SG) V;PRS;NOM(3,SG) V;P
whoot V;PST	T;PST;PST;PST;PST;PST;PST;PST;
whoot V;V.PTCP;PRS	;PTCP;PRS;PRS;PRS;PRS;PRS;PRS;
whoot V;V.PTCP;PST	;PTCP;PST;PST;PST;PST;PST;PST;
withsay V;NFIN	NFIN V;NFIN V;NFIN V;NFIN V;NF
withsay V;PRS;NOM(3,SG)	;NOM(3,SG)
Say V;PRS;NOM(3,SG)
withsay V;V.PTCP;PRS	;PTCP;PRS;PRS;PRS;PRS;PRS;PRS;
withsay V;V.PTCP;PST	;PTCP;PST;PST;PST;PST;PST;PST;
world V;NFIN	NFIN V;NFIN V;NFIN V;NFIN V;NF
world V;PRS;NOM(3,SG)	;NOM(3,SG) V;PRS;NOM(3,SG) V;P
world V;V.PTCP;PRS	PTCP;PRS;PRS;PRS;PRS;PRS;PRS;P
world V;V.PTCP;PST	;PTCP;PST;PST;PST;PST;PST;PST;
xeriscape V;PRS;NOM(3,SG)	 V;PRS;NOM(3,SG) V;PRS;NOM(3,S
yabby V;PRS;NOM(3,SG)	(3,SG) V;PRS;NOM(3,SG) V;PRS;N
yabby V;PST	abby V;PST V;PST V;PST V;PST V
yearn V;NFIN	NFIN;NFIN;NFIN;NFIN;NFIN;NFIN;
yearn V;PRS;NOM(3,SG)	;NOM(3,SG);NOM(3,SG);NOM(3,SG)
yearn V;PST	ST
V;PST
V;PST
V;PST
V;PST
V;P
yellow V;PRS;NOM(3,SG)	;NOM(3,SG) V;PRS;NOM(3,SG) V;P
yellow V;PST	yellow V;PSTSTSTSTSTSTSTSTSTST
yellow V;V.PTCP;PRS	;PTCP;PRS;PRS;PRS;PRS;PRS;PRS;
yellow V;V.PTCP;PST	;PTCP;PST;PST;PST;PST;PST;PST;
