indiciar V;2;PL;IND;PST;IPFV	;IND;PST;IPFV;IPFV;IPFV;IPFV;I
adequar V.PTCP;MASC;SG;PST	;SG;PST;SG;PST;SG;PST;SG;PST;S
desdizer V;2;SG;IND;PST;IPFV	;PST;IPFV;IPFV;IPFV;IPFV;IPFV;
refogar V.PTCP;PRS	efogar V.PTCP;PRS;PRS;PRS;PRS;
frequentar V;1;PL;IMP;POS	;PL;IMP;POS;POS;POS;POS;POS;PO
condimentar V;1;SG;IND;PST;PFV	;SG;IND;PST;PFV;PFV;PFV;PFV;PF
içar V;3;PL;SBJV;FUT	;SBJV;FUT;FUT;FUT;FUT;FUT;FUT;
designar V;3;SG;IND;PST;IPFV	;IND;PST;IPFV;IPFV;IPFV;IPFV;I
ziguezaguear V;3;PL;IND;PST;PFV	;PL;PFV;PFV;PFV;PFV;PFV;PFV;PF
acortinar V;3;PL;NFIN	;PL;NFIN;NFIN;NFIN;NFIN;NFIN;N
estocar V;2;PL;COND	;COND;COND;COND;COND;COND;COND
estimular V;1;PL;IND;PST;PFV	;PL;IND;PST;PFV;PFV;PFV;PFV;PF
harmonizar V;1;PL;IMP;NEG	;PL;IMP;NEG;NEG;NEG;NEG;NEG;NE
sublinhar V;1;PL;IND;PST;IPFV	;IND;PST;IPFV;IPFV;IPFV;IPFV;I
contra-atacar V;2;PL;NFIN	;NFIN;NFIN;NFIN;NFIN;NFIN;NFIN
pedalar V;1;PL;SBJV;PRS	;SBJV;PRS;SBJV;PRS;SBJV;PRS;SB
vitimar V;1;PL;COND	;PL;COND;COND;COND;COND;COND;C
brincar V;NFIN	bbrincar V;NFIN
Nacar V;NFIN
N
latinar V;3;SG;IND;PST;PRF	;PST;PRF;PRF;PRF;PRF;PRF;PRF;P
desdizer V;3;PL;IMP;NEG	;IMP;NEG;NEG;NEG;NEG;NEG;NEG;N
estipular V;3;PL;SBJV;PRS	;SBJV;PRS;PRS;PRS;PRS;PRS;PRS;
arquejar V;3;PL;COND	;COND;COND;COND;COND;COND;COND
pregar V;2;PL;IND;PST;IPFV	;IND;PST;IPFV;IPFV;IPFV;IPFV;I
redimir V;1;PL;SBJV;FUT	;SBJV;FUT;FUT;FUT;FUT;FUT;FUT;
borrar V;3;PL;SBJV;PST;IPFV	;PL;SBJV;PST;IPFV;PST;IPFV;PST
surtar V;1;PL;SBJV;FUT	;SBJV;FUT;FUT;FUT;FUT;FUT;FUT;
impregnar V.PTCP;PRS	ar V.PTCP;PRS;PRS;PRS;PRS;PRS;
entrar V;2;PL;IND;PRS	;IND;PRS;IND;PRS;IND;PRS;IND;P
cagar V;1;SG;COND	;COND;COND;COND;COND;COND;COND
apedrejar V;3;SG;IMP;POS	;IMP;POS;POS;POS;POS;POS;POS;P
enfileirar V;2;SG;SBJV;FUT	;SG;SBJV;FUT;FUT;FUT;FUT;FUT;F
registar V;1;SG;SBJV;FUT	;SBJV;FUT;FUT;FUT;FUT;FUT;FUT;
mutilar V;3;PL;SBJV;FUT	;SBJV;FUT;FUT;FUT;FUT;FUT;FUT;
indiciar V;3;SG;SBJV;FUT	;SBJV;FUT;SBJV;FUT;SBJV;FUT;SB
limar V;2;SG;SBJV;PST;IPFV	;SG;SBJV;PST;IPFV;IPFV;IPFV;IP
apatetar V;3;SG;SBJV;PST;IPFV	;SG;SBJV;PST;IPFV;IPFV;IPFV;IP
guardar V;3;PL;IMP;POS	;IMP;POS;POS;POS;POS;POS;POS;P
pagar V;1;SG;IND;PRS	;IND;PRS;IND;PRS;IND;PRS;IND;P
optar V;2;SG;IMP;NEG	;IMP;NEG;NEG;NEG;NEG;NEG;NEG;N
voltar V;1;SG;NFIN	;NFIN;NFIN;NFIN;NFIN;NFIN;NFIN
coevoluir V;2;SG;IND;PST;PFV	;SG;IND;PST;PFV;PFV;PFV;PFV;PF
olear V;2;SG;COND	V;2;SG;COND;COND;COND;COND;CON
conjecturar V;2;PL;IMP;POS	;IMP;POS;POS;POS;POS;POS;POS;P
raciocinar V;2;PL;IMP;POS	;PL;IMP;POS;POS;POS;POS;POS;PO
secundar V;2;PL;NFIN	;2;PL;NFIN;NFIN;NFIN;NFIN;NFIN
aluviar V;3;PL;IND;FUT	;PL;IND;FUT;FUT;FUT;FUT;FUT;FU
aventar V;2;PL;IND;FUT	;2;PL;IND;FUT;FUT;FUT;FUT;FUT;
vesguear V;1;PL;SBJV;FUT	;SBJV;FUT;FUT;FUT;FUT;FUT;FUT;
relacionar V;1;SG;IND;PRS	;IND;PRS;IND;PRS;IND;PRS;IND;P
realçar V;2;PL;IMP;POS	;IMP;POS;POS;POS;POS;POS;POS;P
confraternizar V;1;SG;IND;FUT	;SG;IND;FUT;FUT;FUT;FUT;FUT;FU
olear V;3;SG;IMP;POS	;IMP;POS;POS;POS;POS;POS;POS;P
sangrar V;1;SG;IND;FUT	;SG;IND;FUT;FUT;FUT;FUT;FUT;FU
polimerizar V;3;SG;NFIN	;NFIN;NFIN;NFIN;NFIN;NFIN;NFIN
anteceder V;1;SG;IND;FUT	;SG;IND;FUT;FUT;FUT;FUT;FUT;FU
delimitar V;1;PL;IMP;POS	;POS;POS;POS;POS;POS;POS;POS;P
contrabalançar V;2;SG;IMP;POS	;SG;IMP;POS;POS;POS;POS;POS;PO
desarrazoar V;1;PL;SBJV;FUT	;PL;SBJV;FUT;FUT;FUT;FUT;FUT;F
fallecer V;2;SG;SBJV;FUT	;SG;SBJV;FUT;FUT;FUT;FUT;FUT;F
aventar V;2;PL;IND;PST;IPFV	;IND;PST;IPFV;IPFV;IPFV;IPFV;I
analisar V;1;PL;SBJV;FUT	;SBJV;FUT;FUT;FUT;FUT;FUT;FUT;
adoecer V.PTCP;PRS	er V.PTCP;PRS;PRS;PRS;PRS;PRS;
arrebentar V;1;PL;NFIN	;PL;NFIN;NFIN;NFIN;NFIN;NFIN;N
extinguir V;3;PL;IND;PST;IPFV	;PL;IND;PST;IPFV;IPFV;IPFV;IPF
mastigar V;3;PL;IMP;POS	;POS;POS;POS;POS;POS;POS;POS;P
constatar V;3;PL;IND;PST;IPFV	;IND;PST;IPFV;IPFV;IPFV;IPFV;I
filtrar V;3;PL;SBJV;FUT	;SBJV;FUT;FUT;FUT;FUT;FUT;FUT;
tosar V;1;PL;IND;FUT	;PL;IND;FUT;FUT;FUT;FUT;FUT;FU
proliferar V;1;PL;SBJV;PRS	;SBJV;PRS;SBJV;PRS;SBJV;PRS;SB
cumprimentar V;1;SG;NFIN	;NFIN;NFIN;NFIN;NFIN;NFIN;NFIN
comendar V;3;SG;IND;FUT	;SG;IND;FUT;FUT;FUT;FUT;FUT;FU
desarrazoar V;1;SG;IND;PST;PFV	;SG;IND;PST;PFV;PFV;PFV;PFV;PF
sonambular V.PTCP;MASC;SG;PST	;SG;PST;SG;PST;SG;PST;SG;PST;S
sangrar V;3;PL;IND;PRS	;IND;PRS;IND;PRS;IND;PRS;IND;P
adivinhar V;3;PL;IMP;NEG	;IMP;NEG;NEG;NEG;NEG;NEG;NEG;N
lambujar V.PTCP;FEM;SG;PST	;PST;FEM;SG;PST;PST;PST;PST;PS
registrar V;2;SG;SBJV;FUT	;SG;SBJV;FUT;FUT;FUT;FUT;FUT;F
desembalar V;3;SG;IND;PST;IPFV	;IND;PST;IPFV;IPFV;IPFV;IPFV;I
liquefazer V;2;PL;IMP;NEG	;PL;IMP;NEG;NEG;NEG;NEG;NEG;NE
sobressair V;1;SG;IND;FUT	;SG;IND;FUT;FUT;FUT;FUT;FUT;FU
incorporar V;1;PL;IMP;POS	porar V;1;PL;IMP;POS;POS;POS;P
absceder V;3;SG;NFIN	;3;SG;NFIN;NFIN;NFIN;NFIN;NFIN
escassear V;1;SG;SBJV;PRS	;SG;SBJV;PRS;SBJV;PRS;SBJV;PRS
registrar V;1;PL;IND;PST;IPFV	;IND;PST;IPFV;IPFV;IPFV;IPFV;I
retaliar V.PTCP;MASC;SG;PST	;PST;SG;PST;SG;PST;SG;PST;SG;P
vomitar V;2;PL;IND;PST;PRF	;PL;PST;PRF;PRF;PRF;PRF;PRF;PR
realçar V;1;PL;SBJV;FUT	;SBJV;FUT;FUT;FUT;FUT;FUT;FUT;
derrapar V;1;PL;IND;PRS	;IND;PRS;IND;PRS;IND;PRS;IND;P
denotar V;2;PL;IMP;NEG	;PL;IMP;NEG;NEG;NEG;NEG;NEG;NE
encomendar V;1;SG;SBJV;FUT	;SBJV;FUT;FUT;FUT;FUT;FUT;FUT;
escalfar V;3;PL;IMP;NEG	;PL;IMP;NEG;NEG;NEG;NEG;NEG;NE
desentranhar V;3;PL;IND;PST;IPFV	;IND;PST;IPFV;IPFV;IPFV;IPFV;I
amarrar V;2;SG;SBJV;FUT	;SG;SBJV;FUT;FUT;FUT;FUT;FUT;F
discar V;3;SG;SBJV;PRS	;SBJV;PRS;PRS;PRS;PRS;PRS;PRS;
teclar V;3;PL;SBJV;PRS	;SBJV;PRS;SBJV;PRS;SBJV;PRS;SB
alfabetizar V;1;PL;SBJV;PST;IPFV	;PL;SBJV;PST;IPFV;PFV;PFV;PFV;
ruir V;1;SG;SBJV;PST;IPFV	;SG;SBJV;PST;IPFV;IPFV;IPFV;IP
arquivar V;1;SG;SBJV;FUT	;SG;SBJV;FUT;FUT;FUT;FUT;FUT;F
terminar V;1;PL;IND;PST;IPFV	;IND;PST;IPFV;IPFV;IPFV;IPFV;I
sublinhar V;3;PL;IND;PST;IPFV	;IND;PST;IPFV;IPFV;IPFV;IPFV;I
resplandecer V;2;PL;IND;PST;PFV	;IND;PST;PFV;PFV;PFV;PFV;PFV;P
talhar V;3;PL;NFIN	;NFIN;NFIN;NFIN;NFIN;NFIN;NFIN
ondular V;3;SG;SBJV;PRS	;SBJV;PRS;PRS;PRS;PRS;PRS;PRS;
ensaiar V;2;SG;SBJV;FUT	;SG;SBJV;FUT;FUT;FUT;FUT;FUT;F
prover V;3;SG;COND	;3;SG;COND;COND;COND;COND;COND
tagarelar V.PTCP;MASC;PL;PST	;PL;PST;PL;PST;PL;PST;PL;PST;P
fallecer V;2;SG;SBJV;PRS	;SG;SBJV;PRS;SBJV;PRS;SBJV;PRS
relacionar V;3;PL;IMP;NEG	;PL;IMP;NEG;NEG;NEG;NEG;NEG;NE
concordar V;3;PL;IND;PST;IPFV	;PST;IPFV;IPFV;IPFV;IPFV;IPFV;
assemelhar V;3;PL;COND	;3;PL;COND;COND;COND;COND;COND
filtrar V;2;PL;SBJV;FUT	;SBJV;FUT;FUT;FUT;FUT;FUT;FUT;
engendrar V;1;SG;IND;PRS	;SG;IND;PRS;PRS;PRS;PRS;PRS;PR
proliferar V;3;SG;SBJV;PRS	;SBJV;PRS;SBJV;PRS;SBJV;PRS;SB
silenciar V;2;PL;IMP;NEG	;IMP;NEG;NEG;NEG;NEG;NEG;NEG;N
denominar V;1;PL;IND;PRS	;IND;PRS;IND;PRS;IND;PRS;IND;P
mumificar V;2;PL;IMP;POS	;IMP;POS;IMP;POS;IMP;POS;IMP;P
complicar V;2;PL;IND;PST;PFV	;PL;IND;PST;PFV;PFV;PFV;PFV;PF
terminar V;1;PL;IND;PST;PRF	;PL;IND;PST;PRF;PRF;PRF;PRF;PR
bombardear V.PTCP;FEM;PL;PST	;PL;PST;PL;PST;PL;PST;PL;PST;P
desossar V;1;SG;SBJV;PST;IPFV	;SG;SBJV;PST;IPFV;IPFV;IPFV;IP
remunerar V;3;SG;IND;PST;PFV	;SG;IND;PST;PFV;PFV;PFV;PFV;PF
recriar V;2;PL;IND;PST;PRF	;PL;IND;PST;PRF;PRF;PRF;PRF;PR
enraivecer V;2;PL;COND	;2;PL;COND;COND;COND;COND;COND
designar V;2;PL;IND;PST;PFV	;PL;IND;PST;PFV;PFV;PFV;PFV;PF
damnar V;1;PL;IND;PRS	;IND;PRS;IND;PRS;IND;PRS;IND;P
adequar V;3;SG;IND;PST;IPFV	;IND;PST;IPFV;IPFV;IPFV;IPFV;I
complicar V;1;PL;SBJV;FUT	;SBJV;FUT;FUT;FUT;FUT;FUT;FUT;
blasonar V;1;PL;IND;FUT	;PL;IND;FUT;FUT;FUT;FUT;FUT;FU
interpelar V;2;SG;IND;PST;PRF	;PST;PRF;PRF;PRF;PRF;PRF;PRF;P
gatunar V;3;SG;IND;PRS	;PRS;PRS;PRS;PRS;PRS;PRS;PRS;P
contrair V;3;PL;IMP;NEG	;PL;IMP;NEG;NEG;NEG;NEG;NEG;NE
engastar V;1;SG;SBJV;PRS	;1;SG;SBJV;PRS;PRS;PRS;PRS;PRS
acreditar V;1;PL;IND;PST;PRF	;PST;PRF;PRF;PRF;PRF;PRF;PRF;P
compensar V;1;PL;IND;FUT	;PL;IND;FUT;FUT;FUT;FUT;FUT;FU
achatar V;NFIN	ar V;NFINN V;NFINN V;NFINN V;N
olhar V;2;PL;IND;PST;PFV	;PL;IND;PST;PFV;PFV;PFV;PFV;PF
talhar V;1;SG;NFIN	;NFIN;NFIN;NFIN;NFIN;NFIN;NFIN
redimir V.PTCP;MASC;PL;PST	;PL;PST;PL;PST;PL;PST;PL;PST;P
lapidar V;NFIN	;NFINNININININININININININININ
indiciar V;2;SG;IND;PST;PFV	;PST;PFV;PFV;PFV;PFV;PFV;PFV;P
arquivar V;3;PL;IND;PST;PFV	;PL;IND;PST;PFV;PFV;PFV;PFV;PF
arquejar V;2;PL;COND	;2;PL;COND;COND;COND;COND;COND
cumprir V;1;PL;NFIN	;PL;NFIN;N;NFIN;NFIN;NFIN;NFIN
estipular V;1;PL;SBJV;PRS	;SBJV;PRS;PRS;PRS;PRS;PRS;PRS;
encetar V.PTCP;MASC;SG;PST	;SG;PST;SG;PST;SG;PST;SG;PST;S
abscindir V;2;SG;SBJV;PRS	;SG;SBJV;PRS;SBJV;PRS;SBJV;PRS
supurar V;2;SG;SBJV;PST;IPFV	;SG;SBJV;PST;IPFV;IPFV;IPFV;IP
ablegar V;1;PL;SBJV;FUT	;SBJV;FUT;FUT;FUT;FUT;FUT;FUT;
resplendecer V.PTCP;FEM;SG;PST	;PTCP;FEM;SG;PST;PST;PST;PST;P
charquear V;2;PL;IND;PST;PRF	;PL;PST;PRF;PRF;PRF;PRF;PRF;PR
enrubescer V;1;SG;IND;PST;PFV	;SG;IND;PST;PFV;PFV;PFV;PFV;PF
aclamar V;1;PL;SBJV;FUT	;SBJV;FUT;FUT;FUT;FUT;FUT;FUT;
anteceder V;3;SG;SBJV;FUT	;SBJV;FUT;FUT;FUT;FUT;FUT;FUT;
criticar V;3;SG;IND;FUT	;SG;IND;FUT;FUT;FUT;FUT;FUT;FU
expectorar V;3;SG;IND;PRS	;IND;PRS;IND;PRS;IND;PRS;IND;P
comprehender V;1;SG;IND;FUT	;SG;IND;FUT;FUT;FUT;FUT;FUT;FU
inquirir V;2;PL;SBJV;PST;IPFV	;PL;SBJV;PST;IPFV;IPFV;IPFV;IP
incorporar V;3;SG;IND;PRS	;IND;PRS;IND;PRS;IND;PRS;IND;P
sufocar V;2;PL;IND;PST;IPFV	;IND;PST;IPFV;IPFV;IPFV;IPFV;I
estimar V;2;SG;IND;PRS	;IND;PRS;IND;PRS;IND;PRS;IND;P
desentranhar V;3;SG;COND	;3;SG;COND;COND;COND;COND;COND
achatar V;3;SG;IMP;NEG	;3;SG;IMP;NEG;NEG;NEG;NEG;NEG;
anteceder V;1;PL;IND;PST;PFV	;PL;IND;PST;PFV;PFV;PFV;PFV;PF
adoecer V.PTCP;FEM;SG;PST	;PTCP;FEM;SG;PST;PST;PST;PST;P
interferir V;3;SG;SBJV;PST;IPFV	;SG;SBJV;PST;IPFV;IPFV;IPFV;IP
protrair V.PTCP;FEM;PL;PST	;PL;PST;PL;PST;PL;PST;PL;PST;P
charquear V;1;PL;IND;PST;PFV	;PL;IND;PST;PFV;PFV;PFV;PFV;PF
ousar V;1;SG;NFIN	;NFIN;NFIN;NFIN;NFIN;NFIN;NFIN
adequar V.PTCP;FEM;SG;PST	;PST;PST;PST;PST;PST;PST;PST;P
denominar V;1;PL;IND;PST;PRF	;PST;PRF;PRF;PRF;PRF;PRF;PRF;P
estercar V;3;PL;IND;FUT	;PL;IND;FUT;FUT;FUT;FUT;FUT;FU
economizar V.PTCP;MASC;PL;PST	;PTCP;PL;PST;PST;PST;PST;PST;P
afundir V;3;SG;IND;PST;PFV	;SG;IND;PST;PFV;PFV;PFV;PFV;PF
visitar V;1;SG;IND;PST;IPFV	;IND;PST;IPFV;IPFV;IPFV;IPFV;I
condecorar V;2;PL;COND	;PL;COND;COND;COND;COND;COND;C
adoecer V.PTCP;MASC;PL;PST	;PL;PST;PL;PST;PL;PST;PL;PST;P
cumprimentar V;1;PL;IND;FUT	;PL;IND;FUT;FUT;FUT;FUT;FUT;FU
agradar V;2;PL;SBJV;FUT	;SBJV;FUT;FUT;FUT;FUT;FUT;FUT;
prevalecer V;1;PL;IND;PRS	;IND;PRS;IND;PRS;IND;PRS;IND;P
abafar V.PTCP;MASC;SG;PST	;SG;PST;SG;PST;SG;PST;SG;PST;S
flutuar V;3;SG;IND;FUT	uar V;3;SG;IND;FUT;FUT;FUT;FUT
objetar V;1;PL;IND;PST;PFV	;PL;IND;PST;PFV;PFV;PFV;PFV;PF
escassear V.PTCP;FEM;SG;PST	;PTCP;FEM;SG;PST;PST;PST;PST;P
alojar V;2;PL;IND;FUT	;PL;IND;FUT;FUT;FUT;FUT;FUT;FU
pagar V;2;PL;IND;PST;IPFV	;IND;PST;IPFV;IPFV;IPFV;IPFV;I
cintar V;1;PL;IND;PST;IPFV	;IND;PST;IPFV;IPFV;IPFV;IPFV;I
tanger V;1;PL;IMP;NEG	;IMP;NEG;IMP;NEG;IMP;NEG;IMP;N
consolidar V;3;SG;IND;PST;IPFV	;IND;PST;IPFV;IPFV;IPFV;IPFV;I
amaynar V;1;SG;IND;PRS	;IND;PRS;PRS;PRS;PRS;PRS;PRS;P
condenar V;3;SG;IND;FUT	;SG;IND;FUT;FUT;FUT;FUT;FUT;FU
desistir V;2;SG;SBJV;PRS	;SG;SBJV;PRS;SBJV;PRS;SBJV;PRS
frequentar V;3;PL;SBJV;FUT	;PL;SBJV;FUT;FUT;FUT;FUT;FUT;F
brincar V;1;PL;SBJV;PRS	;SBJV;PRS;SBJV;PRS;SBJV;PRS;SB
visitar V;1;PL;SBJV;FUT	;SBJV;FUT;FUT;FUT;FUT;FUT;FUT;
vocalizar V;1;SG;IND;PRS	;IND;PRS;IND;PRS;IND;PRS;IND;P
safar V;3;PL;IND;PST;PRF	;PL;PST;PRF;PRF;PRF;PRF;PRF;PR
pregar V;3;SG;IND;PST;IPFV	;IND;PST;IPFV;IPFV;IPFV;IPFV;I
encarcerar V;1;SG;SBJV;FUT	;SG;SBJV;FUT;FUT;FUT;FUT;FUT;F
talhar V;3;SG;IMP;NEG	;IMP;NEG;NEG;NEG;NEG;NEG;NEG;N
saturar V;3;PL;IND;PST;PFV	;PL;IND;PST;PFV;PFV;PFV;PFV;PF
remunerar V;2;PL;IND;PRS	;IND;PRS;IND;PRS;IND;PRS;IND;P
anotar V;2;SG;IND;PST;PFV	;SG;IND;PST;PFV;PFV;PFV;PFV;PF
apregoar V;1;SG;COND	;SG;COND;COND;COND;COND;COND;C
sonambular V;2;SG;IMP;NEG	;IMP;NEG;NEG;NEG;NEG;NEG;NEG;N
marchar V;1;SG;IND;FUT	;SG;IND;FUT;FUT;FUT;FUT;FUT;FU
seguir V;3;SG;IND;FUT	;SG;IND;FUT;FUT;FUT;FUT;FUT;FU
inquirir V;1;PL;SBJV;FUT	;SBJV;FUT;FUT;FUT;FUT;FUT;FUT;
proliferar V;1;PL;IMP;NEG	;IMP;IMP;IMP;IMP;IMP;IMP;IMP;I
desentranhar V;3;PL;IND;FUT	;PL;IND;FUT;FUT;FUT;FUT;FUT;FU
escavar V;1;PL;SBJV;FUT	;SBJV;FUT;FUT;FUT;FUT;FUT;FUT;
ascender V;3;PL;IND;PST;PFV	;PL;PST;PFV;PFV;PFV;PFV;PFV;PF
segmentar V;2;SG;IND;PST;IPFV	;IND;PST;IPFV;IPFV;IPFV;IPFV;I
desvairar V;3;PL;SBJV;PST;IPFV	;PL;SBJV;PST;IPFV;IPFV;IPFV;IP
ascender V;2;SG;SBJV;PST;IPFV	;SG;SBJV;PST;IPFV;IPFV;IPFV;IP
condecorar V;3;PL;IND;PRS	;IND;PRS;IND;PRS;IND;PRS;IND;P
afundir V;2;SG;COND	;2;SG;COND;COND;COND;COND;COND
escravizar V;1;SG;IND;PRS	;IND;PRS;IND;PRS;IND;PRS;IND;P
regularizar V;3;SG;IND;PST;PRF	;PST;PRF;PRF;PRF;PRF;PRF;PRF;P
revelar V;1;PL;IND;PST;PFV	;PL;IND;PST;PFV;PFV;PFV;PFV;PF
entrar V.PTCP;PRS	PTCP;PRS;PRS;PRS;PRS;PRS;PRS;P
vir V;1;PL;SBJV;PST;IPFV	;PL;SBJV;PST;IPFV;PST;IPFV;PST
pescar V;2;SG;NFIN	;NFIN;NFIN;NFIN;NFIN;NFIN;NFIN
bombardear V;1;SG;NFIN	;NFIN;NFIN;NFIN;NFIN;NFIN;NFIN
colorar V;2;PL;SBJV;PRS	;SBJV;PRS;SBJV;PRS;SBJV;PRS;SB
surtar V;2;SG;SBJV;PRS	;SBJV;PRS;SBJV;PRS;SBJV;PRS;SB
arrebentar V;3;PL;IND;PST;PFV	;PL;IND;PST;PFV;PFV;PFV;PFV;PF
mastigar V;2;PL;SBJV;PRS	;SBJV;PRS;PRS;PRS;PRS;PRS;PRS;
enrubescer V;1;PL;IND;PRS	;IND;PRS;IND;PRS;IND;PRS;IND;P
privilegiar V;2;SG;SBJV;PST;IPFV	;SG;SBJV;PST;IPFV;IPFV;IPFV;IP
desossar V;NFIN	esossar V;NFINININININININININ
deificar V;3;SG;SBJV;FUT	;SBJV;FUT;FUT;FUT;FUT;FUT;FUT;
vesguear V;3;PL;SBJV;PRS	;SBJV;PRS;SBJV;PRS;SBJV;PRS;SB
alucinar V;2;PL;IMP;NEG	;IMP;NEG;NEG;NEG;NEG;NEG;NEG;N
printar V;3;PL;IND;PST;IPFV	;IND;PST;IPFV;IPFV;IPFV;IPFV;I
simpatizar V;1;SG;IND;FUT	;SG;IND;FUT;FUT;FUT;FUT;FUT;FU
ondular V;2;SG;SBJV;FUT	;SBJV;FUT;FUT;FUT;FUT;FUT;FUT;
sobressair V;1;SG;SBJV;PRS	;SG;SBJV;PRS;SBJV;PRS;SBJV;PRS
escassear V;2;SG;SBJV;PST;IPFV	;SG;SBJV;PST;IPFV;IPFV;IPFV;IP
maltar V;2;SG;IMP;NEG	;IMP;NEG;NEG;NEG;NEG;NEG;NEG;N
delinear V;1;PL;SBJV;PRS	;SBJV;PRS;PRS;PRS;PRS;PRS;PRS;
desistir V;2;PL;SBJV;PRS	;SBJV;PRS;SBJV;PRS;SBJV;PRS;SB
secundar V;2;PL;SBJV;PRS	;SBJV;PRS;SBJV;PRS;SBJV;PRS;SB
ensaiar V;2;PL;IND;PST;PRF	;PL;PST;PRF;PRF;PRF;PRF;PRF;PR
analisar V;2;SG;IND;PRS	;IND;PRS;PRS;PRS;PRS;PRS;PRS;P
sonambular V;2;PL;COND	;2;PL;COND;COND;COND;COND;COND
alucinar V;1;PL;IND;PRS	;IND;PRS;PRS;PRS;PRS;PRS;PRS;P
comprehender V;2;PL;SBJV;PRS	;SBJV;PRS;SBJV;PRS;SBJV;PRS;SB
molestar V;1;PL;NFIN	;1;PL;NFINININININININININININ
biotransformar V;1;PL;IMP;POS	;IMP;POS;POS;POS;POS;POS;POS;P
pagar V;1;PL;COND	 V;1;PL;COND;COND;COND;COND;CO
designar V;1;PL;IND;PST;PFV	;PL;IND;PST;PFV;PFV;PFV;PFV;PF
engendrar V;2;SG;IMP;POS	;SG;IMP;POS;POS;POS;POS;POS;PO
jazer V;3;PL;IND;PRS	;PL;IND;PRS;PRS;PRS;PRS;PRS;PR
tratar V;1;PL;SBJV;PRS	;SBJV;PRS;PRS;PRS;PRS;PRS;PRS;
instigar V.PTCP;MASC;PL;PST	;PL;PST;PL;PST;PL;PST;PL;PST;P
leiloar V;3;PL;SBJV;FUT	;SBJV;FUT;FUT;FUT;FUT;FUT;FUT;
uivar V;2;PL;IND;PST;PRF	;PST;PRF;PRF;PRF;PRF;PRF;PRF;P
ludibriar V;2;SG;IMP;NEG	;SG;IMP;NEG;NEG;NEG;NEG;NEG;NE
complicar V;1;PL;IMP;NEG	;IMP;NEG;IMP;NEG;IMP;NEG;IMP;N
açacalar V.PTCP;FEM;SG;PST	;FEM;SG;PST;PST;PST;PST;PST;PS
escravizar V;1;SG;COND	;SG;COND;COND;COND;COND;COND;C
colorar V;1;PL;SBJV;PST;IPFV	;PL;SBJV;PST;IPFV;PFV;PFV;PFV;
cagar V;NFIN	;NFIN;NFIN;NFIN;NFIN;NFIN;NFIN
alucinar V.PTCP;FEM;SG;PST	;SG;PST;PST;PST;PST;PST;PST;PS
blogar V;2;PL;COND	;2;PL;COND;COND;COND;COND;COND
enrubescer V;2;PL;SBJV;FUT	;SBJV;FUT;FUT;FUT;FUT;FUT;FUT;
cagar V;2;SG;SBJV;PST;IPFV	;SG;SBJV;PST;IPFV;IPFV;IPFV;IP
conjecturar V;3;SG;COND	;3;SG;COND;COND;COND;COND;COND
assoprar V;3;PL;IMP;POS	;PL;IMP;POS;POS;POS;POS;POS;PO
destratar V;3;SG;IMP;NEG	;IMP;NEG;NEG;NEG;NEG;NEG;NEG;N
crochetar V;2;SG;IND;PST;IPFV	;IND;PST;IPFV;IPFV;IPFV;IPFV;I
aquaplanar V;3;PL;IND;PST;IPFV	;IND;PST;IPFV;IPFV;IPFV;IPFV;I
surtar V;1;SG;COND	;SG;COND;COND;COND;COND;COND;C
silenciar V;3;PL;SBJV;PRS	;SBJV;PRS;SBJV;PRS;SBJV;PRS;SB
latir V;3;SG;SBJV;PRS	;SBJV;PRS;SBJV;PRS;SBJV;PRS;SB
frequentar V;NFIN	ntar V;NFIN;NFIN;NFIN;NFIN;NFI
içar V;1;PL;IND;FUT	;PL;IND;FUT;FUT;FUT;FUT;FUT;FU
sinterizar V;3;SG;IND;PRS	;IND;PRS;IND;PRS;IND;PRS;IND;P
flutuar V;2;SG;SBJV;FUT	;SG;SBJV;FUT;SBJV;FUT;SBJV;FUT
leiloar V;1;SG;IND;PST;IPFV	;IND;PST;IPFV;IPFV;IPFV;IPFV;I
blogar V;3;PL;IND;PST;PFV	;PL;IND;PST;PFV;PFV;PFV;PFV;PF
lambujar V;2;SG;NFIN	;2;SG;NFIN;NFIN;NFIN;NFIN;NFIN
printar V;2;PL;IND;FUT	;PL;IND;FUT;FUT;FUT;FUT;FUT;FU
impregnar V;2;PL;IMP;POS	;IMP;POS;POS;POS;POS;POS;POS;P
attentar V;1;SG;IND;PST;PRF	;PST;PRF;PRF;PRF;PRF;PRF;PRF;P
arianizar V;2;PL;IMP;NEG	;IMP;NEG;NEG;NEG;NEG;NEG;NEG;N
marchar V;3;PL;IND;FUT	;PL;IND;FUT;FUT;FUT;FUT;FUT;FU
arquejar V;1;PL;IMP;POS	;PL;IMP;POS;POS;POS;POS;POS;PO
encriptar V;2;SG;SBJV;PST;IPFV	;SG;SBJV;PST;IPFV;IPFV;IPFV;IP
manjar V;2;PL;IND;PST;PRF	;PL;PST;PRF;PRF;PRF;PRF;PRF;PR
alocar V;2;SG;IND;PST;PFV	;SG;IND;PST;PFV;PFV;PFV;PFV;PF
vesguear V;3;PL;SBJV;FUT	;SBJV;FUT;FUT;FUT;FUT;FUT;FUT;
encetar V;3;PL;SBJV;PST;IPFV	;PL;SBJV;PST;IPFV;IPFV;IPFV;IP
eliminar V;2;SG;IMP;NEG	;SG;IMP;NEG;IMP;NEG;IMP;NEG;IM
ziguezaguear V;1;PL;SBJV;FUT	;SBJV;FUT;FUT;FUT;FUT;FUT;FUT;
bombardear V;3;SG;SBJV;PST;IPFV	;SG;SBJV;PST;IPFV;IPFV;IPFV;IP
ladrar V;1;SG;IND;PST;PRF	;PST;PRF;PRF;PRF;PRF;PRF;PRF;P
amamentar V.PTCP;MASC;PL;PST	;PL;PST;PL;PST;PL;PST;PL;PST;P
protrair V;3;PL;IMP;POS	;PL;IMP;POS;POS;POS;POS;POS;PO
menosprezar V;2;SG;IND;FUT	;SG;IND;FUT;FUT;FUT;FUT;FUT;FU
botar V;3;SG;IMP;POS	;IMP;POS;IMP;POS;IMP;POS;IMP;P
ascender V;1;PL;IND;FUT	;IND;FUT;FUT;FUT;FUT;FUT;FUT;F
ruir V;3;PL;NFIN	;PL;NFIN;N;N;N;N;N;N;N;N;N;N;N
munir V;1;PL;NFIN	;1;PL;NFIN;1;PL;NFIN;1;PL;NFIN
estimular V;3;PL;SBJV;PRS	;SBJV;PRS;PRS;PRS;PRS;PRS;PRS;
bombardear V;1;SG;IND;FUT	;SG;IND;FUT;FUT;FUT;FUT;FUT;FU
escassear V;3;PL;IND;FUT	;PL;IND;FUT;FUT;FUT;FUT;FUT;FU
registrar V;2;PL;NFIN	;2;PL;NFIN;NFIN;NFIN;NFIN;NFIN
maquinar V;2;SG;SBJV;PRS	;SBJV;PRS;SBJV;PRS;SBJV;PRS;SB
embasar V;3;SG;IMP;NEG	;IMP;NEG;NEG;NEG;NEG;NEG;NEG;N
sonambular V;2;PL;IMP;POS	;PL;IMP;POS;POS;POS;POS;POS;PO
frequentar V;2;SG;SBJV;FUT	;SG;SBJV;FUT;FUT;FUT;FUT;FUT;F
comprehender V;2;SG;NFIN	;2;SG;NFIN;NFIN;NFIN;NFIN;NFIN
lambujar V;1;PL;SBJV;PRS	;S;S;S;S;S;S;S;S;S;S;S;S;S;S;S
crescer V;1;PL;IND;PST;PFV	;PL;IND;PST;PFV;PFV;PFV;PFV;PF
leiloar V;3;SG;IND;FUT	;SG;IND;FUT;FUT;FUT;FUT;FUT;FU
antidotar V;NFIN	tar V;NFINININININININININININ
sufocar V;1;SG;COND	;COND;COND;COND;COND;COND;COND
rufar V;2;PL;IND;PST;PFV	;PL;IND;PST;PFV;PFV;PFV;PFV;PF
estrumar V.PTCP;MASC;SG;PST	;SG;PST;SG;PST;SG;PST;SG;PST;S
registar V;2;SG;IND;PST;PRF	;PST;PRF;PRF;PRF;PRF;PRF;PRF;P
postular V.PTCP;FEM;SG;PST	;PST;PST;PST;PST;PST;PST;PST;P
anabolizar V;2;PL;SBJV;PRS	;SBJV;PRS;SBJV;PRS;SBJV;PRS;SB
printar V;2;SG;COND	;COND;COND;COND;COND;COND;COND
desvairar V;NFIN	;NFIN;NFIN;NFIN;NFIN;NFIN;NFIN
desrespeitar V.PTCP;MASC;SG;PST	;PST;PST;PST;PST;PST;PST;PST;P
prover V;2;SG;SBJV;PST;IPFV	;SG;SBJV;PST;IPFV;IPFV;IPFV;IP
comichar V;1;PL;IND;PST;IPFV	;IND;PST;IPFV;IPFV;IPFV;IPFV;I
telhar V;1;PL;IMP;NEG	;IMP;NEG;NEG;NEG;NEG;NEG;NEG;N
assemelhar V;3;SG;IMP;POS	;IMP;POS;POS;POS;POS;POS;POS;P
simpatizar V;1;SG;SBJV;PST;IPFV	;SG;SBJV;PST;IPFV;IPFV;IPFV;IP
deliciar V;3;PL;COND	;COND;COND;COND;COND;COND;COND
flutuar V;1;SG;SBJV;PST;IPFV	;SG;SBJV;PST;IPFV;IPFV;IPFV;IP
ladrar V;3;PL;IND;PST;PFV	;PL;PST;PFV;PFV;PFV;PFV;PFV;PF
expectorar V;1;SG;NFIN	;NFIN;NFIN;NFIN;NFIN;NFIN;NFIN
munir V;2;SG;NFIN	 V;2;SG;NFIN;2;SG;NFIN;2;SG;NF
destratar V;3;PL;IND;PST;PFV	;PL;IND;PST;PFV;PFV;PFV;PFV;PF
estocar V;3;SG;IND;PST;PRF	;PST;PRF;PRF;PRF;PRF;PRF;PRF;P
kickar V;1;PL;SBJV;PST;IPFV	;PL;SBJV;PST;IPFV;IPFV;IPFV;IP
ponderar V;3;PL;SBJV;FUT	;PL;SBJV;FUT;FUT;FUT;FUT;FUT;F
desarmar V;1;SG;IND;PRS	;IND;PRS;IND;PRS;IND;PRS;IND;P
terminar V.PTCP;FEM;PL;PST	;PL;PST;PL;PST;PL;PST;PL;PST;P
antidotar V;3;SG;IMP;NEG	;IMP;NEG;NEG;NEG;NEG;NEG;NEG;N
remunerar V;1;PL;IND;PST;IPFV	;IND;PST;IPFV;IPFV;IPFV;IPFV;I
vomitar V;1;SG;NFIN	;NFIN;NFIN;NFIN;NFIN;NFIN;NFIN
ponderar V;2;SG;IMP;NEG	;2;SG;IMP;NEG;NEG;NEG;NEG;NEG;
vesguear V.PTCP;MASC;PL;PST	;PL;PL;PST;PL;PST;PL;PST;PL;PS
analisar V;2;SG;COND	;2;SG;COND;COND;COND;COND;COND
realçar V.PTCP;MASC;PL;PST	;PTCP;PST;PL;PST;PST;PST;PST;P
arquivar V;1;SG;IND;PST;PFV	;SG;IND;PST;PFV;PFV;PFV;PFV;PF
secundar V;3;SG;IND;PST;PFV	;SG;IND;PST;PFV;PFV;PFV;PFV;PF
adjudicar V;2;PL;IND;PST;PFV	;PL;IND;PST;PFV;PFV;PFV;PFV;PF
arianizar V;1;SG;COND	;SG;COND
V;1;SG;COND
V;1;SG;CO
açacalar V;2;SG;IMP;NEG	G;IMP;NEG;NEG;NEG;NEG;NEG;NEG;
marchar V;2;SG;NFIN	;2;SG;NFIN;N;N;N;N;N;N;N;N;N;N
desrespeitar V;2;PL;IND;PST;PRF	;PL;PST;PRF;PRF;PRF;PRF;PRF;PR
estimular V;2;PL;SBJV;PST;IPFV	;PL;SBJV;PST;IPFV;IPFV;IPFV;IP
abafar V;2;SG;NFIN	;SG;NFIN;NFIN;NFIN;NFIN;NFIN;N
sobressair V;3;PL;COND	;PL;COND;COND;COND;COND;COND;C
desentranhar V;1;PL;IND;FUT	;PL;IND;FUT;FUT;FUT;FUT;FUT;FU
blasonar V;1;PL;IMP;NEG	P;PL;IMP;NEG;NEG;NEG;NEG;NEG;N
arrebentar V;3;SG;SBJV;PRS	;SBJV;PRS;PRS;PRS;PRS;PRS;PRS;
simbolizar V;3;SG;NFIN	;NFIN;NFIN;NFIN;NFIN;NFIN;NFIN
acortinar V;3;SG;IND;FUT	;SG;IND;FUT;FUT;FUT;FUT;FUT;FU
crochetar V;3;SG;IND;PST;PFV	;SG;IND;PST;PFV;PFV;PFV;PFV;PF
açacalar V;2;SG;IND;PRS	;IND;PRS;IND;PRS;IND;PRS;IND;P
cumprimentar V;1;SG;IND;FUT	;SG;IND;FUT;FUT;FUT;FUT;FUT;FU
vincular V;1;PL;IND;PRS	;PL;IND;PRS;PRS;PRS;PRS;PRS;PR
latir V;1;SG;SBJV;PST;IPFV	;SG;SBJV;PST;IPFV;IPFV;IPFV;IP
agradar V;2;SG;SBJV;PRS	;SBJV;PRS;PRS;PRS;PRS;PRS;PRS;
silenciar V.PTCP;FEM;SG;PST	;PST;FEM;SG;PST;PST;PST;PST;PS
derrapar V;2;SG;COND	;2;SG;COND;COND;COND;COND;COND
desentranhar V;2;SG;IND;PST;PFV	;SG;IND;PST;PFV;PFV;PFV;PFV;PF
botar V;3;SG;IND;PST;PRF	;PST;PRF;PRF;PRF;PRF;PRF;PRF;P
escavar V;1;SG;IND;PRS	;IND;PRS;IND;PRS;IND;PRS;IND;P
sobressair V;3;SG;COND	;SG;COND;COND;COND;COND;COND;C
zumbificar V;1;SG;SBJV;PST;IPFV	;SG;SBJV;PST;IPFV;IPFV;IPFV;IP
confraternizar V;2;SG;SBJV;PST;IPFV	;SG;SBJV;PST;IPFV;IPFV;IPFV;IP
parcelar V;3;SG;SBJV;PST;IPFV	;SG;SBJV;PST;IPFV;IPFV;IPFV;IP
prender V;2;SG;COND	;COND;COND;COND;COND;COND;COND
sociabilizar V;2;PL;SBJV;PST;IPFV	;PL;SBJV;PST;IPFV;PFV;PFV;PFV;
alocar V;1;PL;COND	;PL;COND;COND;COND;COND;COND;C
comprehender V;1;SG;SBJV;PRS	;SG;SBJV;PRS;SBJV;PRS;SBJV;PRS
fatorar V;3;PL;NFIN	;3;PL;NFIN;3;PL;NFIN;3;PL;NFIN
terminar V;3;SG;IMP;POS	;IMP;POS;IMP;POS;IMP;POS;IMP;P
adoecer V;2;SG;COND	;SG;COND V;2;SG;COND V;2;SG;CO
agradar V;1;PL;IND;PRS	;IND;PRS;PRS;PRS;PRS;PRS;PRS;P
retaliar V;3;SG;NFIN	;SG;NFININININININININININININ
vomitar V;3;SG;IND;PST;PFV	;SG;IND;PST;PFV;PFV;PFV;PFV;PF
resplandecer V;1;PL;COND	;PL;COND;;;;;;;;;;;;;;;;;;;;;;
designar V;3;SG;SBJV;FUT	;SBJV;FUT;FUT;FUT;FUT;FUT;FUT;
adjudicar V;1;SG;SBJV;PRS	;SBJV;PRS;SBJV;PRS;SBJV;PRS;SB
adivinhar V;2;PL;IND;FUT	;PL;IND;FUT;FUT;FUT;FUT;FUT;FU
instigar V;2;SG;SBJV;PRS	;SBJV;PRS;SBJV;PRS;SBJV;PRS;SB
inquirir V;3;PL;IMP;POS	;PL;IMP;POS;POS;POS;POS;POS;PO
mutilar V;3;PL;IND;PST;IPFV	;IND;PST;IPFV;IPFV;IPFV;IPFV;I
entrar V;1;SG;COND	 A;1;SG;COND;COND;COND;COND;CO
denominar V;1;SG;IND;FUT	;SG;IND;FUT;FUT;FUT;FUT;FUT;FU
guarnecer V;2;SG;IND;PST;PFV	;SG;IND;PST;PFV;PFV;PFV;PFV;PF
desentranhar V;2;PL;IND;PST;PRF	;PL;IND;PST;PRF;PRF;PRF;PRF;PR
desdizer V;1;SG;NFIN	;SG;NFIN;NFIN;NFIN;NFIN;NFIN;N
arquivar V;1;PL;IND;PST;PRF	;PL;IND;PST;PRF;PRF;PRF;PRF;PR
seguir V;1;SG;SBJV;PRS	;SBJV;PRS;SBJV;PRS;SBJV;PRS;SB
redimir V;3;SG;IND;PST;PFV	;SG;IND;PST;PFV;PFV;PFV;PFV;PF
tretar V;2;SG;SBJV;FUT	;SBJV;FUT;FUT;FUT;FUT;FUT;FUT;
teorizar V;2;PL;IND;PST;IPFV	;IND;PST;IPFV;IPFV;IPFV;IPFV;I
escassear V;3;SG;IND;PST;PFV	;SG;IND;PST;PFV;PFV;PFV;PFV;PF
impregnar V;3;SG;IND;PST;PRF	;PST;PRF;PRF;PRF;PRF;PRF;PRF;P
açacalar V;1;SG;IND;PST;IPFV	;IND;PST;IPFV;IPFV;IPFV;IPFV;I
encomendar V;2;PL;IND;PST;IPFV	;IND;PST;IPFV;IPFV;IPFV;IPFV;I
festar V;3;SG;IND;PST;IPFV	;IPFV;IPFV;IPFV;IPFV;IPFV;IPFV
encetar V;3;SG;IND;FUT	;SG;IND;FUT;FUT;FUT;FUT;FUT;FU
tanger V;2;PL;SBJV;PST;IPFV	;PL;SBJV;PST;IPFV;PST;IPFV;PST
encetar V;2;PL;IMP;NEG	;IMP;NEG;NEG;NEG;NEG;NEG;NEG;N
instigar V;3;PL;SBJV;PST;IPFV	;PL;SBJV;PST;IPFV;IPFV;IPFV;IP
maltar V;1;SG;SBJV;PST;IPFV	;SG;SBJV;PST;IPFV;IPFV;IPFV;IP
entrar V;3;PL;NFIN	;3;PL;NFINININININININININININ
visar V;3;PL;IND;PST;PRF	;PL;PST;PRF;PRF;PRF;PRF;PRF;PR
consolidar V;3;SG;SBJV;PST;IPFV	;SG;SBJV;PST;IPFV;IPFV;IPFV;IP
cumprir V;2;SG;NFIN	;SG;NFIN;NFIN;NFIN;NFIN;NFIN;N
afundir V;3;SG;NFIN	;3;SG;NFIN;3;SG;NFIN;3;SG;NFIN
expectorar V.PTCP;MASC;SG;PST	;PST;SG;PST;SG;PST;SG;PST;SG;P
criticar V;2;SG;IMP;POS	;IMP;POS;IMP;POS;IMP;POS;IMP;P
desarranjar V.PTCP;FEM;PL;PST	;PL;PST;PL;PST;PL;PST;PL;PST;P
refogar V;2;SG;SBJV;PST;IPFV	;SG;SBJV;PST;IPFV;IPFV;IPFV;IP
ziguezaguear V;1;SG;IND;PRS	;IND;PRS;IND;PRS;IND;PRS;IND;P
bebericar V;2;SG;SBJV;PRS	;SG;SBJV;PRS;SBJV;PRS;SBJV;PRS
publicitar V;3;SG;IND;PST;IPFV	;IND;PST;IPFV;IPFV;IPFV;IPFV;I
blasonar V;2;PL;COND	;2;PL;COND;2;PL;COND;2;PL;COND
inquirir V.PTCP;FEM;PL;PST	;PL;PST;PL;PST;PL;PST;PL;PST;P
estimar V;2;SG;IND;FUT	;SG;IND;FUT;FUT;FUT;FUT;FUT;FU
uivar V;2;SG;SBJV;FUT	;SG;SBJV;FUT;FUT;FUT;FUT;FUT;F
cuidar V;2;SG;IND;FUT	;SG;IND;FUT;FUT;FUT;FUT;FUT;FU
absceder V;2;PL;IND;PST;IPFV	;IND;PST;IPFV;IPFV;IPFV;IPFV;I
alucinar V;1;SG;IND;FUT	;SG;IND;FUT;FUT;FUT;FUT;FUT;FU
designar V;3;PL;IND;PRS	;PL;IND;PRS;PRS;PRS;PRS;PRS;PR
aquaplanar V;3;PL;IND;PRS	;IND;PRS;IND;PRS;IND;PRS;IND;P
deixar V;2;PL;IND;PST;PFV	;PL;IND;PST;PFV;PFV;PFV;PFV;PF
agachar V;1;SG;IND;PST;PFV	;SG;IND;PST;PFV;PFV;PFV;PFV;PF
simpatizar V;1;PL;IND;PST;IPFV	;IND;PST;IPFV;IPFV;IPFV;IPFV;I
pegar V;2;PL;IND;PST;PFV	;PL;IND;PST;PFV;PFV;PFV;PFV;PF
rufar V;2;PL;IND;PST;PRF	;PL;IND;PST;PRF;PRF;PRF;PRF;PR
estercar V.PTCP;PRS	PTCP;PRS;PRS;PRS;PRS;PRS;PRS;P
instigar V;3;PL;NFIN	stigar V;3;PL;NFIN;NFIN;NFIN;N
citar V.PTCP;MASC;PL;PST	;PL;PST;PST;PST;PST;PST;PST;PS
mumificar V;3;SG;SBJV;PRS	;SBJV;PRS;SBJV;PRS;SBJV;PRS;SB
antidotar V;3;PL;IND;PST;PRF	;PL;PST;PRF;PRF;PRF;PRF;PRF;PR
bombardear V;2;PL;SBJV;FUT	;SBJV;FUT;FUT;FUT;FUT;FUT;FUT;
predominar V.PTCP;MASC;SG;PST	;SG;PST;SG;PST;SG;PST;SG;PST;S
concordar V;3;PL;NFIN	;PL;NFIN;NFIN;NFIN;NFIN;NFIN;N
estocar V;1;SG;IND;FUT	;SG;IND;FUT;FUT;FUT;FUT;FUT;FU
visitar V;2;SG;IMP;POS	;SG;IMP;POS;POS;POS;POS;POS;PO
designar V;3;PL;SBJV;PRS	;SBJV;PRS;SBJV;PRS;SBJV;PRS;SB
proceder V;3;SG;IMP;NEG	;IMP;NEG;NEG;NEG;NEG;NEG;NEG;N
safar V;1;SG;COND	;COND;COND;COND;COND;COND;COND
enramalhetar V;2;PL;COND	;2;PL;COND;COND;COND;COND;COND
confraternizar V;2;PL;IMP;POS	;IMP;POS;POS;POS;POS;POS;POS;P
impregnar V;2;PL;NFIN	;2;PL;NFIN;NFIN;NFIN;NFIN;NFIN
abafar V;2;PL;IND;PST;PFV	;PL;IND;PST;PFV;PFV;PFV;PFV;PF
deixar V;3;SG;IND;PST;PRF	;PST;PRF;PRF;PRF;PRF;PRF;PRF;P
abafar V;2;SG;IMP;POS	;IMP;POS;IMP;POS;IMP;POS;IMP;P
existir V;2;PL;COND	;2;PL;COND;2;PL;COND;2;PL;COND
vir V;3;PL;IND;PST;PRF	;PL;PST;PRF;PRF;PRF;PRF;PRF;PR
deliciar V;1;PL;SBJV;PRS	;SBJV;PRS;SBJV;PRS;SBJV;PRS;SB
saturar V;2;PL;IMP;POS	;IMP;POS;POS;POS;POS;POS;POS;P
auferir V;3;SG;IND;PRS	;IND;PRS;IND;PRS;IND;PRS;IND;P
regularizar V.PTCP;MASC;SG;PST	;PST;SG;PST;SG;PST;SG;PST;SG;P
corroborar V;3;SG;IMP;POS	;IMP;POS;IMP;POS;IMP;POS;IMP;P
harmonizar V;1;SG;SBJV;PRS	;SG;SBJV;PRS;SBJV;PRS;SBJV;PRS
auguriar V;2;PL;IND;FUT	;PL;IND;FUT;FUT;FUT;FUT;FUT;FU
vir V;2;PL;SBJV;PRS	;SBJV;PRS;SBJV;PRS;SBJV;PRS;SB
reiterar V;3;PL;IMP;NEG	;PL;IMP;NEG;NEG;NEG;NEG;NEG;NE
alfabetizar V;3;PL;COND	;3;PL;COND;COND;COND;COND;COND
pisotear V;1;PL;NFIN	;1;PL;NFIN;NFIN;NFIN;NFIN;NFIN
estipular V;2;SG;SBJV;FUT	;SG;SBJV;FUT;FUT;FUT;FUT;FUT;F
ensaboar V;2;SG;IND;FUT	;2;SG;IND;FUT;FUT;FUT;FUT;FUT;
talhar V;2;SG;SBJV;FUT	;SBJV;FUT;FUT;FUT;FUT;FUT;FUT;
criticar V;2;PL;SBJV;PST;IPFV	;PL;SBJV;PST;IPFV;PST;IPFV;PST
terminar V;2;SG;COND	 V;2;SG;COND
SG;COND
SG;COND
S
derrapar V;2;PL;IND;PRS	;IND;PRS;IND;PRS;IND;PRS;IND;P
brincar V;1;PL;IND;PRS	;PL;IND;PRS;PRS;PRS;PRS;PRS;PR
retinir V;2;SG;SBJV;PRS	;SG;SBJV;PRS;SBJV;PRS;SBJV;PRS
enramalhetar V;2;SG;SBJV;PST;IPFV	;SG;SBJV;PST;IPFV;IPFV;IPFV;IP
estercar V;1;PL;SBJV;PST;IPFV	;PL;SBJV;PST;IPFV;PFV;PFV;PFV;
maltar V;2;PL;IND;FUT	;PL;IND;FUT;FUT;FUT;FUT;FUT;FU
commandar V;NFIN	mandar V;NFINNFINNFINNFINNFINN
gatunar V;2;SG;SBJV;PST;IPFV	;SBJV;PST;IPFV;IPFV;IPFV;IPFV;
amancebar V;3;PL;NFIN	;PL;NFIN
NFIN
NFIN
NFIN
NFIN
N
deixar V;1;PL;SBJV;PRS	;PL;SBJV;PRS;PRS;PRS;PRS;PRS;P
bombardear V;2;SG;IMP;NEG	;SG;IMP;NEG;NEG;NEG;NEG;NEG;NE
escravizar V;1;SG;SBJV;FUT	;SG;SBJV;FUT;SBJV;FUT;SBJV;FUT
amaynar V;2;PL;SBJV;PST;IPFV	;PL;SBJV;PST;IPFV;IPFV;IPFV;IP
delimitar V;3;SG;NFIN	;2;SG;NFIN;NFIN;NFIN;NFIN;NFIN
sociabilizar V;2;PL;IMP;POS	;IMP;POS;POS;POS;POS;POS;POS;P
blasonar V;2;PL;SBJV;PST;IPFV	;PL;SBJV;PST;IPFV;PST;IPFV;PST
tosar V;2;PL;IND;FUT	;PL;IND;FUT;FUT;FUT;FUT;FUT;FU
encriptar V;2;PL;SBJV;PRS	;SBJV;PRS;SBJV;PRS;SBJV;PRS;SB
administrar V;1;PL;IND;FUT	;PL;IND;FUT;FUT;FUT;FUT;FUT;FU
ousar V;2;PL;IND;FUT	;PL;IND;FUT;FUT;FUT;FUT;FUT;FU
escassear V;2;PL;SBJV;FUT	;SBJV;FUT;FUT;FUT;FUT;FUT;FUT;
adoecer V;3;SG;IND;PST;PRF	;PST;PRF;PRF;PRF;PRF;PRF;PRF;P
existir V;2;PL;SBJV;PST;IPFV	;PL;SBJV;PST;IPFV;IPFV;IPFV;IP
escassear V.PTCP;PRS	assear V.PTCP;PRS;PRS;PRS;PRS;
estipular V;3;SG;IMP;POS	;IMP;POS;IMP;POS;IMP;POS;IMP;P
estrumar V;3;PL;IND;PRS	;IND;PRS;IND;PRS;IND;PRS;IND;P
incorporar V;2;SG;IND;PST;PRF	;PST;PRF;PRF;PRF;PRF;PRF;PRF;P
contrabalançar V;1;PL;NFIN	;PL;NFIN;
V;1;PL;NFIN;
V;1;PL;
aparafusar V;3;PL;NFIN	;PL;NFIN;NFIN;NFIN;NFIN;NFIN;N
contra-atacar V;2;PL;IND;PST;IPFV	;IND;PST;IPFV;IPFV;IPFV;IPFV;I
ablegar V;1;PL;NFIN	;NFIN;NFIN;NFIN;NFIN;NFIN;NFIN
patentear V;3;SG;IND;PST;IPFV	;IND;PST;IPFV;IPFV;IPFV;IPFV;I
lesmar V;1;SG;IND;PRS	;IND;PRS;PRS;PRS;PRS;PRS;PRS;P
adoecer V;1;PL;SBJV;FUT	;SBJV;FUT;FUT;FUT;FUT;FUT;FUT;
tilintar V;3;PL;IND;PRS	;IND;PRS;IND;PRS;IND;PRS;IND;P
condenar V;2;PL;IND;PRS	;PL;IND;PRS;PRS;PRS;PRS;PRS;PR
ensaboar V;2;PL;IND;FUT	;PL;IND;FUT;FUT;FUT;FUT;FUT;FU
commandar V;3;SG;COND	;3;SG;COND;COND;COND;COND;COND
delinear V;1;PL;IND;PST;PFV	;PST;PFV;PFV;PFV;PFV;PFV;PFV;P
ziguezaguear V;3;PL;SBJV;PRS	;SBJV;PRS;PRS;PRS;PRS;PRS;PRS;
colorar V;3;PL;SBJV;FUT	;SBJV;FUT;FUT;FUT;FUT;FUT;FUT;
impregnar V;2;SG;SBJV;PST;IPFV	;SG;SBJV;PST;IPFV;IPFV;IPFV;IP
sinterizar V;1;PL;SBJV;PST;IPFV	;PL;SBJV;PST;IPFV;PFV;PFV;PFV;
atenazar V;2;PL;NFIN	;2;PL;NFIN;NFIN;NFIN;NFIN;NFIN
teorizar V;3;SG;IND;FUT	;SG;IND;FUT;FUT;FUT;FUT;FUT;FU
alocar V;2;PL;IMP;POS	;IMP;POS;POS;POS;POS;POS;POS;P
sociabilizar V;3;PL;SBJV;FUT	;SBJV;FUT;FUT;FUT;FUT;FUT;FUT;
antidotar V;1;SG;IND;PST;PFV	;SG;IND;PST;PFV;PFV;PFV;PFV;PF
conjecturar V;3;SG;IND;PRS	;IND;PRS;IND;PRS;IND;PRS;IND;P
tilintar V;3;PL;COND	;PL;COND;COND;COND;COND;COND;C
ascender V;3;SG;NFIN	;3;SG;NFIN;N;NFIN;N;NFIN;N;NFI
aquaplanar V;2;PL;IND;PRS	;IND;PRS;IND;PRS;IND;PRS;IND;P
incorporar V;2;PL;IMP;NEG	porporar V;2;PL;IMP;NEG;NEG;NE
talhar V;2;SG;IND;PST;PRF	;PST;PRF;PRF;PRF;PRF;PRF;PRF;P
silenciar V;2;PL;IND;PST;PFV	;PL;PFV;PFV;PFV;PFV;PFV;PFV;PF
reiterar V;1;PL;SBJV;FUT	;SBJV;FUT;FUT;FUT;FUT;FUT;FUT;
contrair V;1;SG;IND;PST;PRF	;PST;PRF;PRF;PRF;PRF;PRF;PRF;P
privilegiar V;1;PL;SBJV;FUT	;SBJV;FUT;FUT;FUT;FUT;FUT;FUT;
expectorar V;1;SG;COND	;SG;COND;COND;COND;COND;COND;C
attentar V;1;PL;SBJV;FUT	;SBJV;FUT;FUT;FUT;FUT;FUT;FUT;
expectorar V;3;PL;IND;PST;PFV	;PL;PL;PL;PL;PL;PL;PL;PL;PL;PL
sinterizar V;3;PL;IND;PST;PRF	;PL;PL;PL;PL;PL;PL;PL;PL;PL;PL
desdizer V;1;PL;IND;PRS	;IND;PRS;IND;PRS;IND;PRS;IND;P
estimular V;1;SG;COND	;SG;COND;COND;COND;COND;COND;C
saturar V;3;PL;NFIN	;3;PL;NFINININININININININININ
protrair V;3;PL;IND;PST;PFV	;PL;PL;PFV;PFV;PFV;PFV;PFV;PFV
registar V;3;PL;IND;FUT	;PL;IND;FUT;FUT;FUT;FUT;FUT;FU
ousar V;3;PL;IND;PST;PRF	;PL;PST;PRF;PRF;PRF;PRF;PRF;PR
barbear V;1;PL;IND;PRS	;IND;PRS;IND;PRS;IND;PRS;IND;P
torrar V;3;PL;IND;PRS	;IND;PRS;IND;PRS;IND;PRS;IND;P
kickar V;3;PL;NFIN	;PL;NFIN;N;N;N;N;N;N;N;N;N;N;N
liquefazer V;1;SG;IND;PST;PRF	;PST;PRF;PRF;PRF;PRF;PRF;PRF;P
munir V;1;SG;NFIN	;1;SG;NFIN;N;N;N;N;N;N;N;N;N;N
attentar V;1;SG;IND;FUT	;SG;IND;FUT;FUT;FUT;FUT;FUT;FU
liderar V.PTCP;FEM;PL;PST	;PL;PST;PL;PST;PL;PST;PL;PST;P
grudar V;2;SG;IND;PRS	;IND;PRS;PRS;PRS;PRS;PRS;PRS;P
vesguear V;3;SG;SBJV;PRS	;SBJV;PRS;SBJV;PRS;SBJV;PRS;SB
sortear V;1;SG;IND;PST;IPFV	;IND;PST;IPFV;IPFV;IPFV;IPFV;I
arquejar V;2;SG;IND;PST;IPFV	;IND;PST;IPFV;IPFV;IPFV;IPFV;I
arseniar V;3;PL;SBJV;PRS	;SBJV;PRS;PRS;PRS;PRS;PRS;PRS;
entrar V;1;SG;SBJV;FUT	;SBJV;FUT;FUT;FUT;FUT;FUT;FUT;
kickar V;1;PL;COND	;PL;COND;COND;COND;COND;COND;C
recompensar V;1;PL;IND;FUT	;PL;IND;FUT;FUT;FUT;FUT;FUT;FU
vir V;2;SG;SBJV;PST;IPFV	;SG;SBJV;PST;IPFV;IPFV;IPFV;IP
implicar V;3;SG;COND	;3;SG;COND;COND;COND;COND;COND
apreciar V;2;PL;IND;PST;PRF	;PL;PST;PRF;PRF;PRF;PRF;PRF;PR
enramalhetar V;1;SG;SBJV;FUT	;SBJV;FUT;FUT;FUT;FUT;FUT;FUT;
festar V;1;SG;SBJV;PST;IPFV	;SG;SBJV;PST;IPFV;IPFV;IPFV;IP
pescar V;3;SG;IND;PRS	;IND;PRS;IND;PRS;IND;PRS;IND;P
enfileirar V;2;SG;IND;PST;IPFV	;IPFV;IPFV;IPFV;IPFV;IPFV;IPFV
aclamar V;1;PL;IMP;NEG	;PL;IMP;NEG;NEG;NEG;NEG;NEG;NE
teclar V;2;PL;IND;PST;PRF	;PL;IND;PST;PRF;PRF;PRF;PRF;PR
derrapar V;2;SG;IMP;POS	;IMP;POS;IMP;POS;IMP;POS;IMP;P
sortear V;3;SG;COND	;3;SG;COND;COND;COND;COND;COND
saltear V;3;PL;IND;PST;PFV	;PL;PST;PFV;PFV;PFV;PFV;PFV;PF
sufocar V;3;SG;IND;PST;PFV	;SG;IND;PST;PFV;PFV;PFV;PFV;PF
agachar V;2;PL;IMP;NEG	;IMP;NEG;NEG;NEG;NEG;NEG;NEG;N
arianizar V;3;PL;NFIN	;PL;NFININININININININININININ
registrar V;3;PL;IND;PRS	;PL;IND;PRS;PRS;PRS;PRS;PRS;PR
aparafusar V.PTCP;FEM;SG;PST	;PTCP;FEM;SG;PST;PST;PST;PST;P
cuidar V;3;SG;COND	;COND;COND;COND;COND;COND;COND
arquejar V;3;SG;IND;PST;PRF	;PST;PRF;PRF;PRF;PRF;PRF;PRF;P
vesguear V;1;SG;NFIN	;NFIN;NFIN;NFIN;NFIN;NFIN;NFIN
estimar V;2;PL;COND	;2;PL;COND;COND;COND;COND;COND
cotejar V;1;PL;SBJV;PST;IPFV	;PL;SBJV;PST;IPFV;PFV;PFV;PFV;
denominar V;2;SG;SBJV;FUT	;SG;SBJV;FUT;SBJV;FUT;SBJV;FUT
desentranhar V;3;SG;IND;PST;IPFV	;IPFV;IPFV;IPFV;IPFV;IPFV;IPFV
inflamar V;1;SG;SBJV;PRS	;SG;SBJV;PRS;SBJV;PRS;SBJV;PRS
condecorar V;1;PL;IMP;POS	;IMP;POS;IMP;POS;IMP;POS;IMP;P
ascender V;2;SG;NFIN	;2;SG;NFIN;N;NFIN;N;NFIN;N;NFI
acreditar V;2;SG;SBJV;PRS	;SBJV;PRS;SBJV;PRS;SBJV;PRS;SB
compensar V;2;PL;IMP;POS	;IMP;POS;IMP;POS;IMP;POS;IMP;P
prender V;3;SG;IND;PRS	;IND;PRS;IND;PRS;IND;PRS;IND;P
tanger V;2;SG;IMP;NEG	;IMP;NEG;NEG;NEG;NEG;NEG;NEG;N
desiludir V;3;SG;SBJV;PRS	;SBJV;PRS;PRS;PRS;PRS;PRS;PRS;
discar V;2;SG;IMP;POS	;IMP;POS;IMP;POS;IMP;POS;IMP;P
entabuar V;1;SG;IND;PST;PFV	;SG;IND;PST;PFV;PFV;PFV;PFV;PF
recompensar V.PTCP;FEM;PL;PST	;PL;PST;PL;PST;PL;PST;PL;PST;P
rimar V;2;PL;IND;PST;PFV	;PL;IND;PST;PFV;PFV;PFV;PFV;PF
crescer V;3;SG;SBJV;PST;IPFV	;SG;SBJV;PST;IPFV;IPFV;IPFV;IP
menstruar V;2;PL;IND;PST;IPFV	;IND;PST;IPFV;IPFV;IPFV;IPFV;I
manjar V;1;PL;IND;PRS	;IND;PRS;IND;PRS;IND;PRS;IND;P
comendar V;1;PL;IND;PST;PFV	;PL;IND;PST;PFV;PFV;PFV;PFV;PF
sobresair V;3;SG;IND;FUT	;SG;IND;FUT;FUT;FUT;FUT;FUT;FU
menosprezar V;1;SG;IND;PST;PRF	;PST;PRF;PRF;PRF;PRF;PRF;PRF;P
alegar V;3;PL;IMP;NEG	;IMP;NEG;NEG;NEG;NEG;NEG;NEG;N
alojar V;2;SG;NFIN	;2;SG;NFIN;NFIN;NFIN;NFIN;NFIN
estipular V;2;SG;SBJV;PRS	;SG;SBJV;PRS;SBJV;PRS;SBJV;PRS
copular V.PTCP;FEM;SG;PST	;SG;PST;PST;PST;PST;PST;PST;PS
adivinhar V;2;PL;SBJV;PRS	;SBJV;PRS;SBJV;PRS;SBJV;PRS;SB
arianizar V;1;PL;IMP;NEG	;PL;IMP;NEG;NEG;NEG;NEG;NEG;NE
munir V;3;SG;IND;PST;IPFV	;IPFV;IPFV;IPFV;IPFV;IPFV;IPFV
aclamar V;3;PL;IND;FUT	;PL;IND;FUT;FUT;FUT;FUT;FUT;FU
sortear V;1;PL;SBJV;FUT	;SBJV;FUT;FUT;FUT;FUT;FUT;FUT;
fluorar V;1;SG;IND;PST;PFV	;SG;IND;PST;PFV;PFV;PFV;PFV;PF
papar V;3;PL;SBJV;FUT	;SBJV;FUT;FUT;FUT;FUT;FUT;FUT;
attentar V;1;SG;SBJV;PST;IPFV	;SG;SBJV;PST;IPFV;PST;IPFV;IPF
compensar V;2;PL;SBJV;PST;IPFV	;PL;SBJV;PST;IPFV;IPFV;IPFV;IP
derrapar V.PTCP;PRS	PTCP;PRS;PRS;PRS;PRS;PRS;PRS;P
delimitar V;1;SG;IND;FUT	;SG;IND;FUT;FUT;FUT;FUT;FUT;FU
doar V;1;SG;NFIN	;NFIN;N;N;N;N;N;N;N;N;N;N;N;N;
privilegiar V;2;SG;IMP;POS	;SG;IMP;POS;POS;POS;POS;POS;PO
achatar V;1;PL;SBJV;PRS	;PL;SBJV;PRS;PRS;PRS;PRS;PRS;P
rimar V;3;SG;IND;PST;PRF	;PST;PRF;PRF;PRF;PRF;PRF;PRF;P
abarcar V;2;SG;IND;PST;PFV	;SG;IND;PST;PFV;PFV;PFV;PFV;PF
deliciar V;3;SG;IND;PST;PFV	;SG;IND;PST;PFV;PFV;PFV;PFV;PF
simbolizar V;2;SG;IMP;POS	;IMP;POS;IMP;POS;IMP;POS;IMP;I
registrar V;3;PL;SBJV;PST;IPFV	;PL;SBJV;PST;IPFV;IPFV;IPFV;IP
amancebar V;2;PL;IMP;NEG	;PL;IMP;NEG;NEG;NEG;NEG;NEG;NE
formigar V;3;SG;IND;PST;PFV	 V;3;SG;IND;PST;PFV;PFV;PFV;PF
guardar V;3;PL;COND	;COND;COND;COND;COND;COND;COND
safar V;1;PL;IND;FUT	;PL;IND;FUT;FUT;FUT;FUT;FUT;FU
depenar V;3;PL;NFIN	;PL;NFIN;NFIN;NFIN;NFIN;NFIN;N
talhar V;3;PL;SBJV;FUT	;SBJV;FUT;FUT;FUT;FUT;FUT;FUT;
expectorar V;3;SG;IND;PST;IPFV	;IND;PST;IPFV;IPFV;IPFV;IPFV;I
vomitar V;1;SG;IND;PST;PFV	;SG;IND;PST;PFV;PFV;PFV;PFV;PF
algemar V;3;SG;IMP;POS	;IMP;POS;POS;POS;POS;POS;POS;P
resplandecer V;1;PL;IND;PST;IPFV	;IND;PST;IPFV;IPFV;IPFV;IPFV;I
talhar V.PTCP;MASC;PL;PST	;PL;PST;PL;PST;PL;PST;PL;PST;P
raciocinar V;2;SG;IND;PRS	;IND;PRS;IND;PRS;IND;PRS;IND;P
estocar V;2;SG;SBJV;PRS	;SG;SBJV;PRS;PRS;PRS;PRS;PRS;P
tretar V;3;PL;NFIN	;NFIN;NFIN;NFIN;NFIN;NFIN;NFIN
atenazar V;2;SG;IMP;POS	;IMP;POS;POS;POS;POS;POS;POS;P
formigar V;3;PL;IND;PRS	;IND;PRS;IND;PRS;IND;PRS;IND;P
fluorar V;2;PL;SBJV;PRS	;SBJV;PRS;SBJV;PRS;SBJV;PRS;SB
gatunar V;1;SG;IND;PRS	;IND;PRS;PRS;PRS;PRS;PRS;PRS;P
arrebentar V;1;SG;IND;PRS	;IND;PRS;IND;PRS;IND;PRS;IND;P
postular V;1;SG;SBJV;PST;IPFV	;SG;SBJV;PST;IPFV;IPFV;IPFV;IP
indiciar V;3;SG;NFIN	;NFIN;NFIN;NFIN;NFIN;NFIN;NFIN
saturar V;2;PL;IND;PRS	;IND;PRS;IND;PRS;IND;PRS;IND;P
aclamar V;1;SG;COND	;COND;COND;COND;COND;COND;COND
tratar V;3;SG;IND;PST;PFV	;SG;IND;PST;PFV;PFV;PFV;PFV;PF
encabular V.PTCP;PRS	abular V.PTCP;PRS;PRS;PRS;PRS;
latinar V;1;SG;IND;PST;PRF	;PST;PRF;PRF;PRF;PRF;PRF;PRF;P
comichar V;1;PL;NFIN	;1;PL;NFIN;N;NFIN;N;NFIN;NFIN;
apedrejar V;3;PL;IND;PST;IPFV	;IND;PST;IPFV;IPFV;IPFV;IPFV;I
contrabalançar V;2;PL;IMP;NEG	;PL;IMP;NEG;NEG;NEG;NEG;NEG;NE
ruir V;1;SG;IND;PST;PRF	;PST;PRF;PRF;PRF;PRF;PRF;PRF;P
rimar V;NFIN	 V;NFINAR V;NFINAR V;NFINAR V;
pagar V;3;PL;NFIN	;PL;NFIN;;NFIN;;NFIN;;NFIN;;NF
contactar V;3;SG;IND;PST;PFV	;SG;IND;PST;PFV;PFV;PFV;PFV;PF
depenar V;3;PL;IMP;POS	;IMP;POS;IMP;POS;IMP;POS;IMP;P
retardar V;2;SG;IND;PRS	;IND;PRS;IND;PRS;IND;PRS;IND;P
copular V;3;SG;SBJV;PST;IPFV	;SBJV;PST;IPFV;IPFV;IPFV;IPFV;
prevalecer V;2;SG;NFIN	;NFIN;N;NFIN;NFIN;NFIN;NFIN;NF
commandar V.PTCP;PRS	mandar V.PTCP;PRS;PRS;PRS;PRS;
encabular V;1;SG;SBJV;FUT	;SG;SBJV;FUT;SBJV;FUT;SBJV;FUT
condenar V;3;PL;SBJV;FUT	;SBJV;FUT;FUT;FUT;FUT;FUT;FUT;
simpatizar V;NFIN	;NFINN V;NFINN V;NFINN V;NFINN
instigar V;1;PL;IMP;POS	ar V;1;PL;IMP;POS;POS;POS;POS;
aplainar V;2;SG;IND;FUT	;2;SG;IND;FUT;FUT;FUT;FUT;FUT;
vesguear V.PTCP;PRS	guear V.PTCP;PRS;PRS;PRS;PRS;P
deixar V;1;PL;IND;FUT	;PL;IND;FUT;FUT;FUT;FUT;FUT;FU
pegar V;3;SG;SBJV;FUT	;SBJV;FUT;FUT;FUT;FUT;FUT;FUT;
molestar V;1;SG;IND;PST;PRF	;PST;PRF;PRF;PRF;PRF;PRF;PRF;P
antidotar V;2;PL;SBJV;PRS	;SBJV;PRS;PRS;PRS;PRS;PRS;PRS;
desiludir V;2;PL;COND	;2;PL;COND;COND;COND;COND;COND
inflamar V;2;SG;SBJV;FUT	;SG;SBJV;FUT;FUT;FUT;FUT;FUT;F
lambujar V;1;PL;COND	;PL;COND
V;1;PL;COND
V;1;PL;CO
proliferar V;2;PL;IND;PRS	;IND;PRS;IND;PRS;IND;PRS;IND;P
tosar V;2;PL;IMP;NEG	;IMP;NEG;NEG;NEG;NEG;NEG;NEG;N
confraternizar V;2;PL;IND;FUT	;PL;IND;FUT;FUT;FUT;FUT;FUT;FU
torpedear V;2;PL;SBJV;PRS	;SBJV;PRS;SBJV;PRS;SBJV;PRS;SB
revelar V;2;SG;IND;PRS	;IND;PRS;PRS;PRS;PRS;PRS;PRS;P
papar V;1;SG;IND;FUT	;SG;IND;FUT;FUT;FUT;FUT;FUT;FU
olear V;2;PL;NFIN	;PL;NFIN;NFIN;NFIN;NFIN;NFIN;N
publicitar V;3;SG;IND;PRS	;IND;PRS;IND;PRS;IND;PRS;IND;P
tretar V;1;SG;COND	;COND;COND;COND;COND;COND;COND
proliferar V.PTCP;FEM;PL;PST	;PL;PL;PL;PL;PL;PL;PL;PL;PL;PL
condenar V;2;PL;IND;PST;IPFV	;IND;PST;IPFV;IPFV;IPFV;IPFV;I
estocar V;3;PL;SBJV;FUT	;SBJV;FUT;FUT;FUT;FUT;FUT;FUT;
cagar V;3;SG;IMP;NEG	;IMP;NEG;NEG;NEG;NEG;NEG;NEG;N
derrapar V;2;SG;IND;PST;IPFV	;PST;IPFV;IPFV;IPFV;IPFV;IPFV;
açacalar V;2;PL;SBJV;PRS	;SBJV;PRS;SBJV;PRS;SBJV;PRS;SB
desvairar V;1;SG;SBJV;PST;IPFV	;SG;SBJV;PST;IPFV;IPFV;IPFV;IP
sangrar V;2;PL;IND;FUT	;PL;IND;FUT;FUT;FUT;FUT;FUT;FU
volver V.PTCP;MASC;SG;PST	;SG;PST;SG;PST;SG;PST;SG;PST;S
papar V;2;PL;IND;PRS	;PL;IND;PRS;PRS;PRS;PRS;PRS;PR
corroborar V;3;SG;SBJV;FUT	;SBJV;FUT;SBJV;FUT;SBJV;FUT;SB
pisotear V;1;PL;SBJV;PRS	;PL;SBJV;PRS;SBJV;PRS;SBJV;PRS
attentar V;3;SG;COND	;3;SG;COND;COND;COND;COND;COND
teorizar V;3;PL;SBJV;PST;IPFV	;PL;SBJV;PST;IPFV;PFV;PFV;PFV;
extinguir V;1;SG;IND;PST;IPFV	;IND;PST;IPFV;IPFV;IPFV;IPFV;I
proliferar V;3;PL;IND;PRS	;IND;PRS;IND;PRS;IND;PRS;IND;P
derrapar V;3;PL;COND	;3;PL;COND;COND;COND;COND;COND
reiterar V;3;SG;IND;PST;IPFV	;IPFV;IPFV;IPFV;IPFV;IPFV;IPFV
tosar V;1;SG;IND;PST;IPFV	;IND;PST;IPFV;IPFV;IPFV;IPFV;I
remunerar V;2;SG;IND;PST;PFV	;SG;IND;PST;PFV;PFV;PFV;PFV;PF
eliminar V;3;PL;SBJV;PRS	;SBJV;PRS;SBJV;PRS;SBJV;PRS;SB
rastrejar V;2;SG;NFIN	;2;SG;NFIN;N;N;N;N;N;N;N;N;N;N
supurar V;1;PL;SBJV;PRS	;SBJV;PRS;PRS;PRS;PRS;PRS;PRS;
estocar V;2;PL;IND;PST;PFV	;PL;IND;PST;PFV;PFV;PFV;PFV;PF
indiciar V;2;PL;IMP;POS	;PL;IMP;POS;POS;POS;POS;POS;PO
ensaboar V;2;SG;IMP;POS	;IMP;POS;POS;POS;POS;POS;POS;P
pegar V;3;PL;IMP;POS	;IMP;POS;IMP;POS;IMP;POS;IMP;P
alojar V;1;PL;IND;PST;IPFV	;IND;PST;IPFV;IPFV;IPFV;IPFV;I
sonambular V;3;PL;SBJV;PRS	;SBJV;PRS;PRS;PRS;PRS;PRS;PRS;
formigar V;3;SG;SBJV;FUT	;SBJV;FUT;FUT;FUT;FUT;FUT;FUT;
engendrar V;3;SG;IND;PST;PFV	;SG;IND;PST;PFV;PFV;PFV;PFV;PF
latinar V;2;PL;IND;FUT	;PL;IND;FUT;FUT;FUT;FUT;FUT;FU
vomitar V;3;PL;SBJV;PRS	;PL;SBJV;PRS;PRS;PRS;PRS;PRS;P
conjecturar V;1;SG;IND;PRS	;SG;IND;PRS;IND;PRS;IND;PRS;IN
excetuar V;2;PL;IMP;NEG	;PL;IMP;NEG;NEG;NEG;NEG;NEG;NE
desafogar V;2;SG;IMP;POS	;IMP;POS;IMP;POS;IMP;POS;IMP;P
kickar V;3;PL;SBJV;FUT	;SBJV;FUT;FUT;FUT;FUT;FUT;FUT;
existir V;1;PL;IMP;NEG	;IMP;NEG;IMP;NEG;IMP;NEG;IMP;N
indiciar V;3;PL;COND	;3;PL;COND;COND;COND;COND;COND
aquaplanar V;2;PL;SBJV;PRS	;SBJV;PRS;SBJV;PRS;SBJV;PRS;SB
postular V;2;PL;IND;PRS	;IND;PRS;IND;PRS;IND;PRS;IND;P
pregar V;2;SG;IMP;NEG	;IMP;NEG;NEG;NEG;NEG;NEG;NEG;N
guarnecer V;2;PL;IND;PRS	;IND;PRS;PRS;PRS;PRS;PRS;PRS;P
designar V;1;SG;SBJV;PRS	;SG;SBJV;PRS;SBJV;PRS;SBJV;PRS
desafogar V;3;PL;NFIN	;PL;NFIN;N;NFIN;NFIN;NFIN;NFIN
latinar V;3;SG;SBJV;PRS	;SBJV;PRS;SBJV;PRS;SBJV;PRS;SB
pagar V;2;PL;IND;PST;PRF	;PL;PST;PRF;PRF;PRF;PRF;PRF;PR
alocar V;1;SG;IND;PRS	;IND;PRS;PRS;PRS;PRS;PRS;PRS;P
ostracizar V;1;PL;SBJV;PST;IPFV	;PL;SBJV;PST;IPFV;PFV;PFV;PFV;
finalizar V.PTCP;PRS	PTCP;PRS;PRS;PRS;PRS;PRS;PRS;P
expectorar V;1;SG;IND;PST;PRF	;PST;PRF;PRF;PRF;PRF;PRF;PRF;P
rufar V;1;PL;IND;PST;PRF	;PL;IND;PST;PRF;PRF;PRF;PRF;PR
extinguir V.PTCP;FEM;PL;PST	;PL;PST;PL;PST;PL;PST;PL;PST;P
proceder V;2;SG;SBJV;PRS	;SG;SBJV;PRS;SBJV;PRS;SBJV;PRS
brunir V;2;SG;SBJV;PRS	;SG;SBJV;PRS;SBJV;PRS;SBJV;PRS
bombardear V;1;PL;NFIN	;PL;NFIN;N;N;NFIN;N;N;NFIN;N;N
redimir V;3;SG;IND;PRS	;IND;PRS;PRS;PRS;PRS;PRS;PRS;P
recompensar V;1;PL;COND	;PL;COND;;;;;;;;;;;;;;;;;;;;;;
assemelhar V;1;SG;IND;PST;IPFV	;IND;PST;IPFV
V;1;SG;IND;PST;I
lesmar V;3;PL;SBJV;PST;IPFV	;PL;SBJV;PST;IPFV;PST;IPFV;PST
arseniar V;3;SG;SBJV;PRS	;SG;SBJV;PRS;SBJV;PRS;SBJV;PRS
recompensar V;2;PL;IND;PST;PRF	;PL;IND;PST;PRF;PRF;PRF;PRF;PR
visar V;1;PL;IND;PST;PRF	;PL;IND;PST;PRF;PRF;PRF;PRF;PR
adoecer V;3;SG;SBJV;PST;IPFV	;SG;SBJV;PST;IPFV;IPFV;IPFV;IP
entabuar V;1;PL;IND;PST;PRF	;PST;PRF;PRF;PRF;PRF;PRF;PRF;P
arseniar V;1;PL;IND;PST;PRF	;PL;IND;PST;PRF;PRF;PRF;PRF;PR
arquivar V;1;SG;SBJV;PST;IPFV	;SG;SBJV;PST;IPFV;IPFV;IPFV;IP
remunerar V;NFIN	emunerar V;NFININININININININI
tilintar V;2;PL;IND;FUT	;PL;IND;FUT;FUT;FUT;FUT;FUT;FU
arquejar V;1;PL;IND;PST;PRF	;PL;IND;PST;PRF;PRF;PRF;PRF;PR
estimar V;3;PL;IND;PST;PRF	;PL;PST;PRF;PRF;PRF;PRF;PRF;PR
amarrar V;3;PL;SBJV;FUT	;SBJV;FUT;FUT;FUT;FUT;FUT;FUT;
entrar V;NFIN	eentrar v;nfin;nfin;entrar v;n
lambujar V;2;PL;COND	;2;PL;COND
V;2;PL;COND
V;2;PL;
jazer V;2;SG;IND;PST;PFV	;SG;IND;PST;PFV;PFV;PFV;PFV;PF
contrabalançar V;1;SG;SBJV;PRS	;SG;SBJV;PRS;SBJV;PRS;SBJV;PRS
commandar V;1;SG;COND	;COND;COND;COND;COND;COND;COND
barbear V;2;PL;IMP;NEG	;PL;IMP;NEG;NEG;NEG;NEG;NEG;NE
cumprimentar V;2;PL;COND	 V;2;PL;COND;2;PL;COND;2;PL;CO
engastar V;1;SG;NFIN	;NFIN;NFIN;NFIN;NFIN;NFIN;NFIN
rufar V;3;PL;SBJV;FUT	;SBJV;FUT;FUT;FUT;FUT;FUT;FUT;
estercar V;3;SG;IND;PST;PFV	;SG;IND;PST;PFV;PFV;PFV;PFV;PF
luctar V;3;SG;IND;PST;PFV	;SG;IND;PST;PFV;PFV;PFV;PFV;PF
expectorar V;3;SG;IND;FUT	;SG;IND;FUT;FUT;FUT;FUT;FUT;FU
remunerar V;1;PL;IND;FUT	;PL;IND;FUT;FUT;FUT;FUT;FUT;FU
abocanhar V.PTCP;FEM;SG;PST	;PST;FEM;SG;PST;PST;PST;PST;PS
abscindir V;2;PL;SBJV;PST;IPFV	;PL;SBJV;PST;IPFV;PST;IPFV;PST
revelar V;2;PL;IMP;POS	PL;IMP;POS;POS;POS;POS;POS;POS
escavar V;1;SG;IND;PST;PFV	;SG;IND;PST;PFV;PFV;PFV;PFV;PF
conjecturar V;2;SG;IND;PST;PRF	;PST;PRF;PRF;PRF;PRF;PRF;PRF;P
agachar V;1;PL;IND;PST;PFV	;IND;PST;PFV;PFV;PFV;PFV;PFV;P
maltar V;3;SG;SBJV;PST;IPFV	;SBJV;PST;IPFV;IPFV;IPFV;IPFV;
ruir V;1;PL;NFIN	;PL;NFIN;N;N;N;N;N;N;N;N;N;N;N
tosar V;1;SG;COND	;SG;COND;COND;COND;COND;COND;C
aventar V;2;SG;IND;PST;PRF	;PST;PRF;PRF;PRF;PRF;PRF;PRF;P
abarcar V.PTCP;FEM;SG;PST	;PTCP;FEM;SG;PST;PST;PST;PST;P
simpatizar V;2;SG;IND;PST;PFV	;SG;IND;PST;PFV;PFV;PFV;PFV;PF
deixar V;3;PL;COND	;PL;CONDD V;3;PL;CONDD V;3;PL;
desiludir V;3;SG;SBJV;PST;IPFV	;SBJV;PST;IPFV;IPFV;IPFV;IPFV;
tratar V;2;PL;IND;PST;IPFV	;IND;PST;IPFV;IPFV;IPFV;IPFV;I
respirar V;3;PL;SBJV;PST;IPFV	;PL;SBJV;PST;IPFV;PST;IPFV;PFV
vomitar V;3;PL;IND;PST;PRF	;PL;PST;PRF;PRF;PRF;PRF;PRF;PR
registar V;1;PL;SBJV;PST;IPFV	;PL;SBJV;PST;IPFV;PFV;PFV;PFV;
assoprar V;2;SG;IND;FUT	;2;SG;IND;FUT;FUT;FUT;FUT;FUT;
içar V;3;PL;IND;FUT	;PL;IND;FUT;FUT;FUT;FUT;FUT;FU
inquirir V;1;PL;COND	;PL;COND;COND;COND;COND;COND;C
aclamar V;1;PL;SBJV;PST;IPFV	;PL;SBJV;PST;IPFV;PFV;PFV;PFV;
aplainar V;3;PL;SBJV;FUT	;SBJV;FUT;FUT;FUT;FUT;FUT;FUT;
apoteosar V;2;SG;IND;PST;PFV	;SG;IND;PST;PFV;PFV;PFV;PFV;PF
saltear V;2;SG;IND;PRS	;IND;PRS;PRS;PRS;PRS;PRS;PRS;P
concordar V;1;PL;IND;PRS	;IND;PRS;IND;PRS;IND;PRS;IND;P
reiterar V;1;SG;COND	;1;SG;COND;COND;COND;COND;COND
confraternizar V;3;PL;SBJV;PST;IPFV	;PL;SBJV;PST;IPFV;IPFV;IPFV;IP
afundir V;3;SG;IMP;POS	;IMP;POS;POS;POS;POS;POS;POS;P
apreciar V;3;SG;NFIN	;NFIN;NFIN;NFIN;NFIN;NFIN;NFIN
vomitar V;2;SG;IND;FUT	;SG;IND;FUT;FUT;FUT;FUT;FUT;FU
arrebentar V;2;SG;IND;PST;PFV	;SG;IND;PST;PFV;PFV;PFV;PFV;PF
incorporar V;3;PL;IND;FUT	;PL;IND;FUT;FUT;FUT;FUT;FUT;FU
ligar V;2;PL;SBJV;PST;IPFV	;PL;SBJV;PST;IPFV;IPFV;IPFV;IP
desdizer V;3;PL;SBJV;PRS	;SBJV;PRS;PRS;PRS;PRS;PRS;PRS;
objetar V;1;SG;SBJV;PST;IPFV	;SG;SBJV;PST;IPFV;PST;IPFV;PFV
mastigar V;2;PL;IND;PRS	;IND;PRS;IND;PRS;IND;PRS;IND;P
desistir V;1;PL;IND;PRS	;IND;PRS;IND;PRS;IND;PRS;IND;P
charquear V.PTCP;MASC;PL;PST	;PL;PST;PL;PST;PL;PST;PL;PST;P
crescer V;2;SG;IMP;NEG	;IMP;NEG;IMP;NEG;IMP;NEG;IMP;N
alucinar V;2;PL;IMP;POS	;IMP;POS;POS;POS;POS;POS;POS;P
blogar V;3;SG;SBJV;FUT	 V;3;SG;SBJV;FUT;FUT;FUT;FUT;F
pegar V;2;SG;IND;FUT	;2;SG;IND;FUT;FUT;FUT;FUT;FUT;
talhar V.PTCP;FEM;PL;PST	;PL;PST;PL;PST;PL;PST;PL;PST;P
comichar V;1;PL;SBJV;FUT	;SBJV;FUT;FUT;FUT;FUT;FUT;FUT;
destratar V;2;PL;IND;FUT	;PL;IND;FUT;FUT;FUT;FUT;FUT;FU
contrabalançar V;NFIN	ar V;NFINININININININININININI
auguriar V;2;PL;IND;PST;PFV	;PL;IND;PST;PFV;PFV;PFV;PFV;PF
desarrazoar V;1;SG;IND;FUT	;SG;IND;FUT;FUT;FUT;FUT;FUT;FU
concordar V;2;PL;NFIN	;2;PL;NFIN;NFIN;NFIN;NFIN;NFIN
objetar V;1;PL;NFIN	;NFIN;NFIN;NFIN;NFIN;NFIN;NFIN
antidotar V.PTCP;FEM;PL;PST	;PL;PST;PL;PST;PL;PST;PL;PST;P
desarmar V;3;SG;NFIN	;NFIN;N;N;N;N;N;N;N;N;N;N;N;N;
indiciar V;3;PL;IND;PST;PFV	;PST;PFV;PFV;PFV;PFV;PFV;PFV;P
delinear V;1;PL;IMP;POS	;IMP;POS;POS;POS;POS;POS;POS;P
sociabilizar V;3;PL;IMP;POS	;PL;IMP;POS;POS;POS;POS;POS;PO
copular V;1;SG;SBJV;PRS	;SG;SBJV;PRS;SBJV;PRS;SBJV;PRS
resplandecer V;3;PL;IND;PST;PRF	;PL;PL;PST;PRF;PRF;PRF;PRF;PRF
criticar V;2;SG;IND;PST;PRF	;PST;PRF;PRF;PRF;PRF;PRF;PRF;P
direcionar V;1;SG;SBJV;FUT	;SG;SBJV;FUT;SBJV;FUT;SBJV;FUT
teclar V;3;PL;IMP;POS	;IMP;POS;IMP;POS;IMP;POS;IMP;P
desarranjar V;1;SG;IND;PST;PRF	;PST;PRF;PRF;PRF;PRF;PRF;PRF;P
transitar V;2;SG;IND;FUT	;2;SG;IND;FUT;FUT;FUT;FUT;FUT;
protrair V;1;PL;IND;PST;PRF	;PST;PRF;PRF;PRF;PRF;PRF;PRF;P
commandar V;1;PL;SBJV;PST;IPFV	;PL;SBJV;PST;IPFV;PFV;PFV;PFV;
decrescer V;1;PL;IND;PST;PFV	;PL;IND;PST;PFV;PFV;PFV;PFV;PF
vincular V;2;SG;SBJV;PST;IPFV	;SG;SBJV;PST;IPFV;IPFV;IPFV;IP
liquefazer V;1;SG;SBJV;FUT	;SG;SBJV;FUT;FUT;FUT;FUT;FUT;F
acreditar V;1;PL;IND;PST;IPFV	;IND;PST;IPFV;IPFV;IPFV;IPFV;I
munir V;NFIN	unir V;NFINAN V;NFINAN V;NFINA
punguear V;1;PL;COND	;PL;COND;COND;COND;COND;COND;C
desafogar V;3;SG;IND;PRS	;IND;PRS;IND;PRS;IND;PRS;IND;P
telar V;3;PL;IND;PST;IPFV	;IND;PST;IPFV;IPFV;IPFV;IPFV;I
interferir V;2;SG;SBJV;FUT	;SG;SBJV;FUT;FUT;FUT;FUT;FUT;F
consternar V;3;PL;IMP;NEG	;PL;IMP;NEG;NEG;NEG;NEG;NEG;NE
polimerizar V;2;SG;SBJV;PST;IPFV	;SG;SBJV;PST;IPFV;IPFV;IPFV;IP
visitar V;1;SG;IND;PST;PRF	;PST;PRF;PRF;PRF;PRF;PRF;PRF;P
assemelhar V;1;SG;SBJV;PRS	;SG;SBJV;PRS;SBJV;PRS;SBJV;PRS
saturar V;1;PL;IMP;POS	;IMP;POS;POS;POS;POS;POS;POS;P
revelar V;1;SG;IND;PRS	;IND;PRS;IND;PRS;IND;PRS;IND;P
amancebar V;3;PL;IND;FUT	;PL;IND;FUT;FUT;FUT;FUT;FUT;FU
ablegar V;3;PL;IND;PST;PRF	;PL;IND;PST;PRF;PRF;PRF;PRF;PR
agradar V;3;SG;SBJV;PRS	;SBJV;PRS;PRS;PRS;PRS;PRS;PRS;
entabuar V;2;SG;SBJV;PST;IPFV	;SG;SBJV;PST;IPFV;IPFV;IPFV;IP
deixar V;1;SG;SBJV;PRS	;SBJV;PRS;PRS;PRS;PRS;PRS;PRS;
eliminar V;3;SG;IND;PST;IPFV	;IPFV;IPFV;IPFV;IPFV;IPFV;IPFV
encarcerar V;2;PL;COND	;COND;COND;COND;COND;COND;COND
expedir V.PTCP;FEM;PL;PST	;PL;PST;PL;PST;PL;PST;PL;PST;P
surtar V;3;PL;COND	;3;PL;COND;COND;COND;COND;COND
barbear V;2;SG;SBJV;FUT	;SG;SBJV;FUT;FUT;FUT;FUT;FUT;F
ousar V;2;SG;IND;PST;PFV	;PST;PFV;PFV;PFV;PFV;PFV;PFV;P
saturar V;3;PL;IND;PST;PRF	;PL;PST;PRF;PRF;PRF;PRF;PRF;PR
ensaiar V;1;SG;SBJV;PST;IPFV	;SG;SBJV;PST;IPFV;IPFV;IPFV;IP
analisar V;2;SG;SBJV;PRS	SG;SBJV;PRS;PRS;PRS;PRS;PRS;PR
convencer V;2;SG;COND	;COND;COND;COND;COND;COND;COND
reconsiderar V;NFIN	NFININININININININININININININ
aventar V;2;PL;SBJV;PRS	;SBJV;PRS;PRS;PRS;PRS;PRS;PRS;
comendar V;2;PL;SBJV;FUT	;SBJV;FUT;FUT;FUT;FUT;FUT;FUT;
zumbificar V.PTCP;MASC;SG;PST	;SG;PST;SG;PST;SG;PST;SG;PST;S
papar V;3;SG;IND;PST;IPFV	;IND;PST;IPFV;IPFV;IPFV;IPFV;I
engendrar V;3;PL;IMP;POS	;POS;POS;POS;POS;POS;POS;POS;P
escavar V;1;SG;SBJV;FUT	;SG;SBJV;FUT;FUT;FUT;FUT;FUT;F
escravizar V;3;PL;IND;PRS	;IND;PRS;IND;PRS;IND;PRS;IND;P
tagarelar V;3;SG;SBJV;FUT	;SBJV;FUT;SBJV;FUT;SBJV;FUT;SB
desarranjar V;3;PL;IND;PST;PFV	;PL;IND;PST;PFV;PFV;PFV;PFV;PF
desarranjar V;1;PL;NFIN	;PL;NFIN;;;;;;;;;;;;;;;;;;;;;;
papar V;3;PL;SBJV;PRS	;SBJV;PRS;SBJV;PRS;SBJV;PRS;SB
mastigar V;1;PL;IND;PRS	;IND;PRS;IND;PRS;IND;PRS;IND;P
ziguezaguear V;2;SG;IND;PST;PFV	;PST;PFV;PFV;PFV;PFV;PFV;PFV;P
pisotear V;1;PL;SBJV;FUT	;PL;SBJV;FUT;FUT;FUT;FUT;FUT;F
eliminar V;2;SG;IND;PST;IPFV	;PST;IPFV;IPFV;IPFV;IPFV;IPFV;
registar V;1;SG;NFIN	;NFINININININININININININININI
aquaplanar V;3;PL;NFIN	;PL;NFIN;PL;NFIN;PL;NFIN;PL;NF
menstruar V;3;PL;IND;PST;PFV	;PL;IND;PST;PFV;PFV;PFV;PFV;PF
pretender V;1;PL;IND;PST;PRF	;PL;IND;PST;PRF;PRF;PRF;PRF;PR
volver V;NFIN	 V;NFININININININININININININI
terminar V;3;PL;SBJV;PRS	;SBJV;PRS;SBJV;PRS;SBJV;PRS;SB
teclar V;2;SG;IND;PRS	;IND;PRS;PRS;PRS;IND;PRS;IND;P
bombardear V;2;SG;IND;FUT	;SG;IND;FUT;FUT;FUT;FUT;FUT;FU
enramalhetar V;1;PL;IND;PST;IPFV	;IND;PST;IPFV;IPFV;IPFV;IPFV;I
talhar V;1;SG;SBJV;FUT	;SBJV;FUT;FUT;FUT;FUT;FUT;FUT;
tilintar V;2;SG;IND;PST;PFV	;2;2;3;4;5;6;7;7;7;7;7;7;7;7;7
menstruar V;3;PL;COND	;PL;COND;COND;COND;COND;COND;C
recompensar V;3;SG;IND;PST;IPFV	;IPFV;IPFV;IPFV;IPFV;IPFV;IPFV
expectorar V;2;SG;IMP;POS	;IMP;POS;POS;POS;POS;POS;POS;P
vincular V.PTCP;MASC;SG;PST	;SG;PST;SG;PST;SG;PST;SG;PST;S
grudar V;1;PL;SBJV;FUT	;SBJV;FUT;FUT;FUT;FUT;FUT;FUT;
içar V;3;SG;IND;FUT	;SG;IND;FUT;FUT;FUT;FUT;FUT;FU
fatorar V;1;SG;NFIN	;1;SG;NFIN;1;SG;NFIN;1;SG;NFIN
alocar V;3;SG;SBJV;PST;IPFV	;SBJV;PST;IPFV;IPFV;IPFV;IPFV;
inquirir V;3;PL;IMP;NEG	;IMP;NEG;NEG;NEG;NEG;NEG;NEG;N
amancebar V;1;SG;SBJV;PRS	;SBJV;PRS;PRS;PRS;PRS;PRS;PRS;
pescar V;1;PL;IMP;NEG	;IMP;NEG;NEG;NEG;NEG;NEG;NEG;N
miscrar V;3;SG;IND;PST;PRF	;PST;PRF;PRF;PRF;PRF;PRF;PRF;P
alegar V;3;PL;SBJV;FUT	;SBJV;FUT;FUT;FUT;FUT;FUT;FUT;
proceder V;2;PL;NFIN	;PL;NFIN;NFIN;NFIN;NFIN;NFIN;N
festar V.PTCP;PRS	PTCP;PRS;PRS;PRS;PRS;PRS;PRS;P
vesguear V;2;PL;IND;PST;PRF	;PL;IND;PST;PRF;PRF;PRF;PRF;PR
desossar V;3;SG;IMP;NEG	;IMP;NEG;NEG;NEG;NEG;NEG;NEG;N
retinir V;NFIN	etinir V;NFINANANANANANANANANA
abocanhar V;2;PL;NFIN	;2;PL;NFIN;2;PL;NFIN;2;PL;NFIN
ondular V;1;SG;SBJV;PRS	;SBJV;PRS;PRS;PRS;PRS;PRS;PRS;
administrar V;3;SG;IND;PRS	;IND;PRS;IND;PRS;IND;PRS;IND;P
abarcar V;2;SG;SBJV;FUT	;SG;SBJV;FUT;FUT;FUT;FUT;FUT;F
decrescer V;3;PL;SBJV;PRS	;SBJV;PRS;SBJV;PRS;SBJV;PRS;SB
sociabilizar V;1;PL;NFIN	;PL;NFIN;NFIN;NFIN;NFIN;NFIN;N
indiciar V;1;PL;NFIN	;NFIN;NFIN;NFIN;NFIN;NFIN;NFIN
maquinar V;3;SG;COND	;COND;COND;COND;COND;COND;COND
entabuar V;2;SG;SBJV;FUT	;SG;SBJV;FUT;FUT;FUT;FUT;FUT;F
analisar V;2;SG;IND;PST;PFV	;SG;IND;PST;PFV;PFV;PFV;PFV;PF
ruir V;2;PL;SBJV;PRS	;SBJV;PRS;SBJV;PRS;SBJV;PRS;SB
sufocar V;3;SG;NFIN	;NFIN;NFIN;NFIN;NFIN;NFIN;NFIN
attentar V;1;SG;SBJV;FUT	;SBJV;FUT;FUT;FUT;FUT;FUT;FUT;
cumprimentar V;2;PL;NFIN	;2;PL;NFIN;NFIN;NFIN;NFIN;NFIN
complicar V;1;PL;SBJV;PST;IPFV	;PL;SBJV;PST;IPFV;IPFV;IPFV;IP
registar V;2;PL;IND;PRS	;IND;PRS;IND;PRS;IND;PRS;IND;P
torrar V;2;PL;SBJV;FUT	;SBJV;FUT;FUT;FUT;FUT;FUT;FUT;
reiterar V.PTCP;FEM;PL;PST	;PL;PST;PL;PST;PL;PST;PL;PST;P
miscrar V;2;SG;IMP;POS	;IMP;POS;IMP;POS;IMP;POS;IMP;P
inquirir V;1;SG;IND;PRS	;IND;PRS;IND;PRS;IND;PRS;IND;P
cuidar V;2;PL;SBJV;PST;IPFV	;PL;SBJV;PST;IPFV;PST;IPFV;PST
estrumar V;2;PL;NFIN	;2;PL;NFIN;NFIN;NFIN;NFIN;NFIN
sobressair V;3;PL;IND;PST;PRF	;PL;PST;PRF;PRF;PRF;PRF;PRF;PR
apatetar V;2;PL;IMP;POS	;IMP;POS;POS;POS;POS;POS;POS;P
contrair V;3;SG;COND	;3;SG;COND;COND;COND;COND;COND
apoteosar V;3;SG;IMP;NEG	;IMP;NEG;NEG;NEG;NEG;NEG;NEG;N
escravizar V;2;SG;NFIN	;NFIN;NFIN;NFIN;NFIN;NFIN;NFIN
flutuar V;3;PL;IND;PST;IPFV	;IND;PST;IPFV;IPFV;IPFV;IPFV;I
assignalar V;1;SG;SBJV;PST;IPFV	;SG;SBJV;PST;IPFV;IPFV;IPFV;IP
munir V;2;SG;IND;PST;IPFV	;IND;PST;IPFV;IPFV;IPFV;IPFV;I
zumbificar V;3;SG;SBJV;FUT	;SBJV;FUT;SBJV;FUT;SBJV;FUT;SB
munir V;2;SG;IND;PST;PRF	;PST;PRF;PRF;PRF;PRF;PRF;PRF;P
talhar V;3;PL;IND;PST;IPFV	;IND;PST;IPFV;IPFV;IPFV;IPFV;I
telhar V;3;PL;IND;FUT	;PL;IND;FUT;FUT;FUT;FUT;FUT;FU
designar V;1;PL;IMP;NEG	;PL;IMP;NEG;NEG;NEG;NEG;NEG;NE
predominar V;2;PL;SBJV;PST;IPFV	;PL;SBJV;PST;IPFV;IPFV;IPFV;IP
copular V;2;SG;NFIN	;2;NFIN;N;N;N;N;N;N;N;N;N;N;N;
predominar V;3;PL;IND;FUT	;PL;IND;FUT;FUT;FUT;FUT;FUT;FU
abscindir V;NFIN	dir V;NFINN;NFINN;NFINN;NFINN;
contrabalançar V;3;SG;IND;FUT	;SG;IND;FUT;FUT;FUT;FUT;FUT;FU
simpatizar V;2;SG;COND	;2;SG;COND;COND;COND;COND;COND
fluorar V;3;PL;IMP;NEG	 V;3;PL;IMP;NEG;NEG;NEG;NEG;NE
ocorrer V;1;PL;NFIN	;PL;NFIN;N;NFIN;N;NFIN;NFIN;NF
liquefazer V;2;SG;IND;PRS	;IND;PRS;IND;PRS;IND;PRS;IND;P
ligar V;3;SG;SBJV;PRS	;SBJV;PRS;SBJV;PRS;SBJV;PRS;SB
comprehender V;2;PL;IND;PST;PRF	;PL;PST;PRF;PRF;PRF;PRF;PRF;PR
desarranjar V;2;PL;IND;PST;PRF	;PL;IND;PST;PRF;PRF;PRF;PRF;PR
mutilar V;2;PL;SBJV;PST;IPFV	;PL;SBJV;PST;IPFV;IPFV;IPFV;IP
visitar V;2;SG;SBJV;FUT	;SBJV;FUT;FUT;FUT;FUT;FUT;FUT;
encomendar V.PTCP;MASC;PL;PST	;PL;PST;PST;PST;PST;PST;PST;PS
alegar V;1;SG;IND;PST;IPFV	;IND;PST;IPFV;IPFV;IPFV;IPFV;I
jazer V.PTCP;FEM;SG;PST	;SG;PST;PST;PST;PST;PST;PST;PS
convencer V;2;PL;IND;PST;PFV	;IND;PST;PFV;PFV;PFV;PFV;PFV;P
escavar V;2;SG;IMP;POS	;IMP;POS;POS;POS;POS;POS;POS;P
vesguear V;1;PL;NFIN	;PL;NFIN;NFIN;NFIN;NFIN;NFIN;N
encharcar V.PTCP;PRS	PTCP;PRSY;PRSY;PRSY;PRSY;PRSY;
copular V;2;PL;IND;FUT	;PL;IND;FUT;FUT;FUT;FUT;FUT;FU
achatar V;3;SG;IND;PST;PRF	;PST;PRF;PRF;PRF;PRF;PRF;PRF;P
remunerar V;3;PL;IMP;POS	;IMP;POS;POS;POS;POS;POS;POS;P
estipular V;1;SG;SBJV;PST;IPFV	;SG;SBJV;PST;IPFV;IPFV;IPFV;IP
resplendecer V;3;SG;IND;FUT	;SG;IND;FUT;FUT;FUT;FUT;FUT;FU
papar V;3;SG;IND;FUT	;SG;IND;FUT;FUT;FUT;FUT;FUT;FU
engastar V;3;PL;IND;PST;PFV	;PL;IND;PST;PFV;PFV;PFV;PFV;PF
mutilar V;1;PL;IND;PRS	;IND;PRS;IND;PRS;IND;PRS;IND;P
nublar V;3;PL;SBJV;FUT	;SBJV;FUT;FUT;FUT;FUT;FUT;FUT;
capotar V;2;SG;IND;PST;IPFV	;IND;PST;IPFV;IPFV;IPFV;IPFV;I
damnar V;2;PL;NFIN	;PL;NFIN;NFIN;NFIN;NFIN;NFIN;N
afundir V;3;PL;SBJV;PRS	;SBJV;PRS;PRS;PRS;PRS;PRS;PRS;
simbolizar V;3;SG;IMP;POS	;IMP;POS;IMP;POS;IMP;POS;IMP;I
resplandecer V;3;SG;COND	;SG;COND;COND;COND;COND;COND;C
desenrolar V;2;SG;IMP;POS	;IMP;POS;IMP;POS;IMP;POS;IMP;P
fluorar V;2;SG;IMP;NEG	;IMP;NEG;NEG;NEG;NEG;NEG;NEG;N
denominar V;2;SG;COND	;2;SG;COND;COND;COND;COND;COND
anotar V;3;SG;IND;PST;IPFV	;IPFV;IPFV;IPFV;IPFV;IPFV;IPFV
crescer V;2;PL;IND;PST;IPFV	;IND;PST;IPFV;IPFV;IPFV;IPFV;I
olhar V;NFIN	;nfin ar v;nfin ar v;nfin ar v
apedrejar V;2;SG;IMP;NEG	;SG;IMP;NEG;NEG;NEG;NEG;NEG;NE
escravizar V;2;SG;IND;PST;PFV	;SG;IND;PST;PFV;PFV;PFV;PFV;PF
pôr V;2;PL;IND;PST;PRF	;PST;PRF;PRF;PRF;PRF;PRF;PRF;P
pescar V;3;PL;IND;PST;PFV	;PL;PST;PFV;PFV;PFV;PFV;PFV;PF
surtar V;NFIN	;NFINN;NFINN;NFINN;NFINN;NFINN
pisotear V;3;SG;COND	;3;SG;COND;COND;COND;COND;COND
agachar V;1;PL;COND	;PL;COND;COND;COND;COND;COND;C
estimular V;2;PL;SBJV;FUT	;SBJV;FUT;FUT;FUT;FUT;FUT;FUT;
optar V;3;PL;IMP;NEG	;IMP;NEG;NEG;NEG;NEG;NEG;NEG;N
polimerizar V;3;PL;IND;FUT	;PL;IND;FUT;FUT;FUT;FUT;FUT;FU
escalfar V.PTCP;FEM;SG;PST	;PTCP;FEM;SG;PST;PST;PST;PST;P
instigar V;3;SG;IND;PST;IPFV	;IND;PST;IPFV;IPFV;IPFV;IPFV;I
