Generate the inflected form for the lemma: "აბსტრაქტული", according to the following morphological descriptions: "ADJ;DAT(PL)"	აბსტრაქტულ
Generate the inflected form for the lemma: "აბსტრაქტული", according to the following morphological descriptions: "ADJ;DAT(PL;LGSPEC2)"	აბსტრაქტულ
Generate the inflected form for the lemma: "აბსტრაქტული", according to the following morphological descriptions: "ADJ;DAT(SG)"	აბსტრაქტულ
Generate the inflected form for the lemma: "აბსტრაქტული", according to the following morphological descriptions: "ADJ;ERG(PL)"	აბსტრაქტულ
Generate the inflected form for the lemma: "აბსტრაქტული", according to the following morphological descriptions: "ADJ;ERG(PL;LGSPEC2)"	მონაცვლები
Generate the inflected form for the lemma: "აბსტრაქტული", according to the following morphological descriptions: "ADJ;ERG(SG)"	აბსტრაქტულ
Generate the inflected form for the lemma: "აბსტრაქტული", according to the following morphological descriptions: "ADJ;FRML(PL)"	აბსტრაქტულ
Generate the inflected form for the lemma: "აბსტრაქტული", according to the following morphological descriptions: "ADJ;FRML(SG)"	აბსტრაქტულ
Generate the inflected form for the lemma: "აბსტრაქტული", according to the following morphological descriptions: "ADJ;GEN(PL)"	აბსტრაქტულ
Generate the inflected form for the lemma: "აბსტრაქტული", according to the following morphological descriptions: "ADJ;GEN(PL;LGSPEC2)"	აბსტრაქტულ
Generate the inflected form for the lemma: "აბსტრაქტული", according to the following morphological descriptions: "ADJ;GEN(SG)"	აბსტრაქტულ
Generate the inflected form for the lemma: "აბსტრაქტული", according to the following morphological descriptions: "ADJ;INS(PL)"	აბსტრაქტულ
Generate the inflected form for the lemma: "აბსტრაქტული", according to the following morphological descriptions: "ADJ;INS(SG)"	აბსტრაქტულ
Generate the inflected form for the lemma: "აბსტრაქტული", according to the following morphological descriptions: "ADJ;NOM(PL)"	აბსტრაქტულ
Generate the inflected form for the lemma: "აბსტრაქტული", according to the following morphological descriptions: "ADJ;NOM(PL;LGSPEC2)"	აბსტრაქტულ
Generate the inflected form for the lemma: "აბსტრაქტული", according to the following morphological descriptions: "ADJ;NOM(SG)"	აბსტრაქტულ
Generate the inflected form for the lemma: "აბსტრაქტული", according to the following morphological descriptions: "ADJ;VOC(PL)"	აბსტრაქტულ
Generate the inflected form for the lemma: "აბსტრაქტული", according to the following morphological descriptions: "ADJ;VOC(PL;LGSPEC2)"	აბსტრაქტულ
Generate the inflected form for the lemma: "აბსტრაქტული", according to the following morphological descriptions: "ADJ;VOC(SG)"	აბსტრაქტულ
Generate the inflected form for the lemma: "აგენტი", according to the following morphological descriptions: "N;DAT(PL)"	აგენტი" და "
Generate the inflected form for the lemma: "აგენტი", according to the following morphological descriptions: "N;DAT(PL;LGSPEC2)"	აგენტი აგე
Generate the inflected form for the lemma: "აგენტი", according to the following morphological descriptions: "N;DAT(SG)"	აგენტი აგე
Generate the inflected form for the lemma: "აგენტი", according to the following morphological descriptions: "N;ERG(PL)"	აგენტი აგე
Generate the inflected form for the lemma: "აგენტი", according to the following morphological descriptions: "N;ERG(PL;LGSPEC2)"	აგენტი აგე
Generate the inflected form for the lemma: "აგენტი", according to the following morphological descriptions: "N;ERG(SG)"	აგენტი აგე
Generate the inflected form for the lemma: "აგენტი", according to the following morphological descriptions: "N;FRML(PL)"	აგენტი" და "
Generate the inflected form for the lemma: "აგენტი", according to the following morphological descriptions: "N;FRML(SG)"	აგენტი აგე
Generate the inflected form for the lemma: "აგენტი", according to the following morphological descriptions: "N;GEN(PL)"	აგენტი აგე
Generate the inflected form for the lemma: "აგენტი", according to the following morphological descriptions: "N;GEN(PL;LGSPEC2)"	აგენტი აგე
Generate the inflected form for the lemma: "აგენტი", according to the following morphological descriptions: "N;GEN(SG)"	აგენტი" და ა
Generate the inflected form for the lemma: "აგენტი", according to the following morphological descriptions: "N;INS(PL)"	აგენტი" და "
Generate the inflected form for the lemma: "აგენტი", according to the following morphological descriptions: "N;INS(SG)"	აგენტი აგე
Generate the inflected form for the lemma: "აგენტი", according to the following morphological descriptions: "N;NOM(PL)"	აგენტი" და "
Generate the inflected form for the lemma: "აგენტი", according to the following morphological descriptions: "N;NOM(PL;LGSPEC2)"	აგენტი აგე
Generate the inflected form for the lemma: "აგენტი", according to the following morphological descriptions: "N;NOM(SG)"	აგენტი" და "
Generate the inflected form for the lemma: "აგენტი", according to the following morphological descriptions: "N;VOC(PL)"	აგენტი აგე
Generate the inflected form for the lemma: "აგენტი", according to the following morphological descriptions: "N;VOC(PL;LGSPEC2)"	აგენტი აგე
Generate the inflected form for the lemma: "აგენტი", according to the following morphological descriptions: "N;VOC(SG)"	აგენტი აგე
Generate the inflected form for the lemma: "ათეთრებს", according to the following morphological descriptions: "V;IMP;NOM(2,PL);ACC(1,SG)"	ათეთრებს" დ
Generate the inflected form for the lemma: "ათეთრებს", according to the following morphological descriptions: "V;IND;FUT;NOM(3,PL);ACC(2,PL)"	ათეთრებსა 
Generate the inflected form for the lemma: "ათეთრებს", according to the following morphological descriptions: "V;IND;IPFV;NOM(2,PL);ACC(1,SG)"	ათეთრებსათ
Generate the inflected form for the lemma: "ათეთრებს", according to the following morphological descriptions: "V;IND;IPFV;NOM(2,SG);ACC(1,PL)"	ათეთრებს" დ
Generate the inflected form for the lemma: "ათეთრებს", according to the following morphological descriptions: "V;IND;IPFV;NOM(2,SG);ACC(3,PL)"	ათეთრებს
Gener
Generate the inflected form for the lemma: "ათეთრებს", according to the following morphological descriptions: "V;IND;PRS;NOM(1,PL);ACC(2,SG)"	ათეთრებს" დ
Generate the inflected form for the lemma: "ათეთრებს", according to the following morphological descriptions: "V;IND;PRS;NOM(2,SG);ACC(1,SG)"	ათეთრებსა 
Generate the inflected form for the lemma: "ათეთრებს", according to the following morphological descriptions: "V;IND;PRS;NOM(3,PL);ACC(1,PL)"	ათეთრებს" დ
Generate the inflected form for the lemma: "ათეთრებს", according to the following morphological descriptions: "V;IND;PRS;NOM(3,PL);ACC(2,PL)"	ათეთრებს" დ
Generate the inflected form for the lemma: "ათეთრებს", according to the following morphological descriptions: "V;IND;PRS;NOM(3,PL);ACC(3,SG)"	ათეთრებსა 
Generate the inflected form for the lemma: "ათეთრებს", according to the following morphological descriptions: "V;IND;PRS;NOM(3,SG);ACC(2,PL)"	ათეთრებს" დ
Generate the inflected form for the lemma: "ათეთრებს", according to the following morphological descriptions: "V;IND;PST;PFV;NOM(3,SG);ACC(2,SG)"	ათეთრებს ა
Generate the inflected form for the lemma: "ათეთრებს", according to the following morphological descriptions: "V;IND;PST;PRF;NOM(1,PL);ACC(2,SG)"	ათეთრებს" დ
Generate the inflected form for the lemma: "ათეთრებს", according to the following morphological descriptions: "V;IND;PST;PRF;NOM(1,PL);ACC(3,SG)"	ათეთრებს" დ
Generate the inflected form for the lemma: "ათეთრებს", according to the following morphological descriptions: "V;IND;PST;PRF;NOM(1,SG);ACC(2,SG)"	ათეთრებს" დ
Generate the inflected form for the lemma: "ათეთრებს", according to the following morphological descriptions: "V;IND;PST;PRF;NOM(2,PL);ACC(3,PL)"	ათეთრებს" დ
Generate the inflected form for the lemma: "ათეთრებს", according to the following morphological descriptions: "V;IND;PST;PRF;NOM(3,PL);ACC(2,PL)"	ათეთრებს" დ
Generate the inflected form for the lemma: "ათეთრებს", according to the following morphological descriptions: "V;IND;PST;PRF;NOM(3,PL);ACC(3,SG)"	ათეთრებს ა
Generate the inflected form for the lemma: "ათეთრებს", according to the following morphological descriptions: "V;OPT;NOM(3,PL);ACC(1,PL)"	ათეთრებს" დ
Generate the inflected form for the lemma: "ათეთრებს", according to the following morphological descriptions: "V;OPT;NOM(3,PL);ACC(2,PL)"	ათეთრებს" დ
Generate the inflected form for the lemma: "ათეთრებს", according to the following morphological descriptions: "V;SBJV;FUT;NOM(2,PL);ACC(1,PL)"	ათეთრებს" დ
Generate the inflected form for the lemma: "ათეთრებს", according to the following morphological descriptions: "V;SBJV;FUT;NOM(2,SG);ACC(3,PL)"	ათეთრებს" დ
Generate the inflected form for the lemma: "ათეთრებს", according to the following morphological descriptions: "V;SBJV;FUT;NOM(3,PL);ACC(2,SG)"	ათეთრებს ა
Generate the inflected form for the lemma: "ათეთრებს", according to the following morphological descriptions: "V;SBJV;PRF;NOM(3,PL);ACC(3,PL)"	ათეთრებს" დ
Generate the inflected form for the lemma: "ათეთრებს", according to the following morphological descriptions: "V;SBJV;PRS;NOM(2,SG);ACC(1,PL)"	ათეთრებს" დ
Generate the inflected form for the lemma: "აკვამარინი", according to the following morphological descriptions: "N;DAT(PL)"	აკვამარინი
Generate the inflected form for the lemma: "აკვამარინი", according to the following morphological descriptions: "N;DAT(PL;LGSPEC2)"	აკვამარინი
Generate the inflected form for the lemma: "აკვამარინი", according to the following morphological descriptions: "N;DAT(SG)"	აკვამარინი
Generate the inflected form for the lemma: "აკვამარინი", according to the following morphological descriptions: "N;ERG(PL)"	აკვამარინი
Generate the inflected form for the lemma: "აკვამარინი", according to the following morphological descriptions: "N;ERG(PL;LGSPEC2)"	 აკვამარინ
Generate the inflected form for the lemma: "აკვამარინი", according to the following morphological descriptions: "N;ERG(SG)"	ბარემისი ა
Generate the inflected form for the lemma: "აკვამარინი", according to the following morphological descriptions: "N;FRML(PL)"	აკვამარინი
Generate the inflected form for the lemma: "აკვამარინი", according to the following morphological descriptions: "N;FRML(SG)"	აკვამარინი
Generate the inflected form for the lemma: "აკვამარინი", according to the following morphological descriptions: "N;GEN(PL)"	აკვამარინი
Generate the inflected form for the lemma: "აკვამარინი", according to the following morphological descriptions: "N;GEN(PL;LGSPEC2)"	აკვამარინი
Generate the inflected form for the lemma: "აკვამარინი", according to the following morphological descriptions: "N;GEN(SG)"	აკვამარინი
Generate the inflected form for the lemma: "აკვამარინი", according to the following morphological descriptions: "N;INS(PL)"	აკვამარინი
Generate the inflected form for the lemma: "აკვამარინი", according to the following morphological descriptions: "N;INS(SG)"	აკვამარინი
Generate the inflected form for the lemma: "აკვამარინი", according to the following morphological descriptions: "N;NOM(PL)"	აკვამარინი
Generate the inflected form for the lemma: "აკვამარინი", according to the following morphological descriptions: "N;NOM(PL;LGSPEC2)"	აკვამარინი
Generate the inflected form for the lemma: "აკვამარინი", according to the following morphological descriptions: "N;NOM(SG)"	აკვამარინი
Generate the inflected form for the lemma: "აკვამარინი", according to the following morphological descriptions: "N;VOC(PL)"	აკვამარინი
Generate the inflected form for the lemma: "აკვამარინი", according to the following morphological descriptions: "N;VOC(PL;LGSPEC2)"	აკვამარინი
Generate the inflected form for the lemma: "აკვამარინი", according to the following morphological descriptions: "N;VOC(SG)"	აკვამარინი
Generate the inflected form for the lemma: "ართმევს", according to the following morphological descriptions: "V;COND;NOM(2,PL);ACC(3,PL)"	ართმევს". Genera
Generate the inflected form for the lemma: "ართმევს", according to the following morphological descriptions: "V;COND;NOM(2,SG);ACC(1,SG)"	ართმევს არ
Generate the inflected form for the lemma: "ართმევს", according to the following morphological descriptions: "V;COND;NOM(3,PL);ACC(3,PL)"	ართმევს". The le
Generate the inflected form for the lemma: "ართმევს", according to the following morphological descriptions: "V;IMP;NOM(3,PL);ACC(1,PL)"	ართმევს". Genera
Generate the inflected form for the lemma: "ართმევს", according to the following morphological descriptions: "V;IMP;NOM(3,SG);ACC(1,SG)"	ართმევს არ
Generate the inflected form for the lemma: "ართმევს", according to the following morphological descriptions: "V;IND;FUT;NOM(1,PL);ACC(3,SG)"	ართმევს არ
Generate the inflected form for the lemma: "ართმევს", according to the following morphological descriptions: "V;IND;FUT;NOM(2,SG);ACC(1,SG)"	ართმევს არ
Generate the inflected form for the lemma: "ართმევს", according to the following morphological descriptions: "V;IND;FUT;NOM(3,PL);ACC(3,PL)"	ართმევს არ
Generate the inflected form for the lemma: "ართმევს", according to the following morphological descriptions: "V;IND;FUT;NOM(3,SG);ACC(1,SG)"	ართმევს არ
Generate the inflected form for the lemma: "ართმევს", according to the following morphological descriptions: "V;IND;IPFV;NOM(1,PL);ACC(3,SG)"	ართმევს არ
Generate the inflected form for the lemma: "ართმევს", according to the following morphological descriptions: "V;IND;PRF;NOM(1,SG);ACC(2,PL)"	ართმევს". Genera
Generate the inflected form for the lemma: "ართმევს", according to the following morphological descriptions: "V;IND;PRF;NOM(3,PL);ACC(3,PL)"	ართმევს არ
Generate the inflected form for the lemma: "ართმევს", according to the following morphological descriptions: "V;IND;PRF;NOM(3,PL);ACC(3,SG)"	ართმევს არ
Generate the inflected form for the lemma: "ართმევს", according to the following morphological descriptions: "V;IND;PRS;NOM(2,SG);ACC(3,PL)"	ართმევს არ
Generate the inflected form for the lemma: "ართმევს", according to the following morphological descriptions: "V;IND;PRS;NOM(3,PL);ACC(3,SG)"	ართმევს არ
Generate the inflected form for the lemma: "ართმევს", according to the following morphological descriptions: "V;IND;PRS;NOM(3,SG);ACC(1,SG)"	ართმევს არ
Generate the inflected form for the lemma: "ართმევს", according to the following morphological descriptions: "V;IND;PST;PFV;NOM(2,PL);ACC(1,SG)"	ართმევს არ
Generate the inflected form for the lemma: "ართმევს", according to the following morphological descriptions: "V;IND;PST;PFV;NOM(3,SG);ACC(3,SG)"	ართმევს არ
Generate the inflected form for the lemma: "ართმევს", according to the following morphological descriptions: "V;OPT;NOM(2,PL);ACC(3,PL)"	ართმევს". Genera
Generate the inflected form for the lemma: "ართმევს", according to the following morphological descriptions: "V;OPT;NOM(3,PL);ACC(2,PL)"	ართმევს". Genera
Generate the inflected form for the lemma: "ართმევს", according to the following morphological descriptions: "V;SBJV;PRF;NOM(1,SG);ACC(3,PL)"	ართმევს არ
Generate the inflected form for the lemma: "ართმევს", according to the following morphological descriptions: "V;SBJV;PRF;NOM(2,SG);ACC(3,SG)"	ართმევს არ
Generate the inflected form for the lemma: "ართმევს", according to the following morphological descriptions: "V;SBJV;PRF;NOM(3,PL);ACC(2,SG)"	ართმევს არ
Generate the inflected form for the lemma: "ართმევს", according to the following morphological descriptions: "V;SBJV;PRS;NOM(2,PL);ACC(1,PL)"	ართმევს". The le
Generate the inflected form for the lemma: "ართმევს", according to the following morphological descriptions: "V;SBJV;PRS;NOM(2,SG);ACC(1,PL)"	ართმევს" და 
Generate the inflected form for the lemma: "ართმევს", according to the following morphological descriptions: "V;SBJV;PRS;NOM(3,SG);ACC(3,SG)"	ართმევს არ
Generate the inflected form for the lemma: "ასისტენტი", according to the following morphological descriptions: "N;DAT(PL)"	ასისტენტი 
Generate the inflected form for the lemma: "ასისტენტი", according to the following morphological descriptions: "N;DAT(PL;LGSPEC2)"	ასისტენტი 
Generate the inflected form for the lemma: "ასისტენტი", according to the following morphological descriptions: "N;DAT(SG)"	მასალა ასი
Generate the inflected form for the lemma: "ასისტენტი", according to the following morphological descriptions: "N;ERG(PL)"	ასისტენტი 
Generate the inflected form for the lemma: "ასისტენტი", according to the following morphological descriptions: "N;ERG(PL;LGSPEC2)"	ასისტენტი 
Generate the inflected form for the lemma: "ასისტენტი", according to the following morphological descriptions: "N;ERG(SG)"	მასალა ასი
Generate the inflected form for the lemma: "ასისტენტი", according to the following morphological descriptions: "N;FRML(PL)"	;FRML(PL)"; "ასისტ
Generate the inflected form for the lemma: "ასისტენტი", according to the following morphological descriptions: "N;FRML(SG)"	ასისტენტი 
Generate the inflected form for the lemma: "ასისტენტი", according to the following morphological descriptions: "N;GEN(PL)"	ასისტენტი
Ge
Generate the inflected form for the lemma: "ასისტენტი", according to the following morphological descriptions: "N;GEN(PL;LGSPEC2)"	ასისტენტი 
Generate the inflected form for the lemma: "ასისტენტი", according to the following morphological descriptions: "N;GEN(SG)"	მონაცემები
Generate the inflected form for the lemma: "ასისტენტი", according to the following morphological descriptions: "N;INS(PL)"	ასისტენტი
Ge
Generate the inflected form for the lemma: "ასისტენტი", according to the following morphological descriptions: "N;INS(SG)"	მასალა ასი
Generate the inflected form for the lemma: "ასისტენტი", according to the following morphological descriptions: "N;NOM(PL)"	ასისტენტი
Ge
Generate the inflected form for the lemma: "ასისტენტი", according to the following morphological descriptions: "N;NOM(PL;LGSPEC2)"	ასისტენტი
Ge
Generate the inflected form for the lemma: "ასისტენტი", according to the following morphological descriptions: "N;NOM(SG)"	ასისტენტი 
Generate the inflected form for the lemma: "ასისტენტი", according to the following morphological descriptions: "N;VOC(PL)"	ასისტენტი 
Generate the inflected form for the lemma: "ასისტენტი", according to the following morphological descriptions: "N;VOC(PL;LGSPEC2)"	ასისტენტი

Generate the inflected form for the lemma: "ასისტენტი", according to the following morphological descriptions: "N;VOC(SG)"	ასისტენტი

Generate the inflected form for the lemma: "ატიპური", according to the following morphological descriptions: "ADJ;DAT(PL)"	ატიპური" ატ
Generate the inflected form for the lemma: "ატიპური", according to the following morphological descriptions: "ADJ;DAT(PL;LGSPEC2)"	ატიპური ატ
Generate the inflected form for the lemma: "ატიპური", according to the following morphological descriptions: "ADJ;DAT(SG)"	ატიპური" ატ
Generate the inflected form for the lemma: "ატიპური", according to the following morphological descriptions: "ADJ;ERG(PL)"	ისი ატიპურ
Generate the inflected form for the lemma: "ატიპური", according to the following morphological descriptions: "ADJ;ERG(PL;LGSPEC2)"	ატიპური ატ
Generate the inflected form for the lemma: "ატიპური", according to the following morphological descriptions: "ADJ;ERG(SG)"	ატიპური" ატ
Generate the inflected form for the lemma: "ატიპური", according to the following morphological descriptions: "ADJ;FRML(PL)"	ატიპური" და 
Generate the inflected form for the lemma: "ატიპური", according to the following morphological descriptions: "ADJ;FRML(SG)"	ატიპური" და 
Generate the inflected form for the lemma: "ატიპური", according to the following morphological descriptions: "ADJ;GEN(PL)"	ი ატიპური ა
Generate the inflected form for the lemma: "ატიპური", according to the following morphological descriptions: "ADJ;GEN(PL;LGSPEC2)"	ატიპური
ატ
Generate the inflected form for the lemma: "ატიპური", according to the following morphological descriptions: "ADJ;GEN(SG)"	ატიპური
ატ
Generate the inflected form for the lemma: "ატიპური", according to the following morphological descriptions: "ADJ;INS(PL)"	ისი ატიპურ
Generate the inflected form for the lemma: "ატიპური", according to the following morphological descriptions: "ADJ;INS(SG)"	ატიპური" და 
Generate the inflected form for the lemma: "ატიპური", according to the following morphological descriptions: "ADJ;NOM(PL)"	ისტორის ატ
Generate the inflected form for the lemma: "ატიპური", according to the following morphological descriptions: "ADJ;NOM(PL;LGSPEC2)"	ატიპური ატ
Generate the inflected form for the lemma: "ატიპური", according to the following morphological descriptions: "ADJ;NOM(SG)"	ატიპური" და 
Generate the inflected form for the lemma: "ატიპური", according to the following morphological descriptions: "ADJ;VOC(PL)"	ისი ატიპურ
Generate the inflected form for the lemma: "ატიპური", according to the following morphological descriptions: "ADJ;VOC(PL;LGSPEC2)"	ატიპური ატ
Generate the inflected form for the lemma: "ატიპური", according to the following morphological descriptions: "ADJ;VOC(SG)"	ატიპური" და 
Generate the inflected form for the lemma: "ბიოლოგი", according to the following morphological descriptions: "N;DAT(PL)"	ერი ბიოლოგ
Generate the inflected form for the lemma: "ბიოლოგი", according to the following morphological descriptions: "N;DAT(PL;LGSPEC2)"	მანიშნებელ
Generate the inflected form for the lemma: "ბიოლოგი", according to the following morphological descriptions: "N;DAT(SG)"	ანალიტის გ
Generate the inflected form for the lemma: "ბიოლოგი", according to the following morphological descriptions: "N;ERG(PL)"	მანიშნებელ
Generate the inflected form for the lemma: "ბიოლოგი", according to the following morphological descriptions: "N;ERG(PL;LGSPEC2)"	მანიშნებელ
Generate the inflected form for the lemma: "ბიოლოგი", according to the following morphological descriptions: "N;ERG(SG)"	მანიშნებელ
Generate the inflected form for the lemma: "ბიოლოგი", according to the following morphological descriptions: "N;FRML(PL)"	ისი ბიოლოგ
Generate the inflected form for the lemma: "ბიოლოგი", according to the following morphological descriptions: "N;FRML(SG)"	ისი ბიოლოგ
Generate the inflected form for the lemma: "ბიოლოგი", according to the following morphological descriptions: "N;GEN(PL)"	ისი ბიოლოგ
Generate the inflected form for the lemma: "ბიოლოგი", according to the following morphological descriptions: "N;GEN(PL;LGSPEC2)"	ის მონაცემ
Generate the inflected form for the lemma: "ბიოლოგი", according to the following morphological descriptions: "N;GEN(SG)"	ის მონაცემ
Generate the inflected form for the lemma: "ბიოლოგი", according to the following morphological descriptions: "N;INS(PL)"	ანგარიში ბ
Generate the inflected form for the lemma: "ბიოლოგი", according to the following morphological descriptions: "N;INS(SG)"	მანიშნებელ
Generate the inflected form for the lemma: "ბიოლოგი", according to the following morphological descriptions: "N;NOM(PL)"	ერისიონი
Gener
Generate the inflected form for the lemma: "ბიოლოგი", according to the following morphological descriptions: "N;NOM(PL;LGSPEC2)"	მანიშნებელ
Generate the inflected form for the lemma: "ბიოლოგი", according to the following morphological descriptions: "N;NOM(SG)"	ერისი
Generate the i
Generate the inflected form for the lemma: "ბიოლოგი", according to the following morphological descriptions: "N;VOC(PL)"	ანგარიში ბ
Generate the inflected form for the lemma: "ბიოლოგი", according to the following morphological descriptions: "N;VOC(PL;LGSPEC2)"	მანიშნებელ
Generate the inflected form for the lemma: "ბიოლოგი", according to the following morphological descriptions: "N;VOC(SG)"	ისი ბიოლოგ
Generate the inflected form for the lemma: "გარანტი", according to the following morphological descriptions: "N;DAT(PL)"	ისტორის გა
Generate the inflected form for the lemma: "გარანტი", according to the following morphological descriptions: "N;DAT(PL;LGSPEC2)"	ის გარანტი 
Generate the inflected form for the lemma: "გარანტი", according to the following morphological descriptions: "N;DAT(SG)"	ისი გარანტ
Generate the inflected form for the lemma: "გარანტი", according to the following morphological descriptions: "N;ERG(PL)"	ისტორის გა
Generate the inflected form for the lemma: "გარანტი", according to the following morphological descriptions: "N;ERG(PL;LGSPEC2)"	ის გარანტი 
Generate the inflected form for the lemma: "გარანტი", according to the following morphological descriptions: "N;ERG(SG)"	ის გარანტი 
Generate the inflected form for the lemma: "გარანტი", according to the following morphological descriptions: "N;FRML(PL)"	გარანტი გა
Generate the inflected form for the lemma: "გარანტი", according to the following morphological descriptions: "N;FRML(SG)"	ის გარანტი 
Generate the inflected form for the lemma: "გარანტი", according to the following morphological descriptions: "N;GEN(PL)"	ის გარანტი 
Generate the inflected form for the lemma: "გარანტი", according to the following morphological descriptions: "N;GEN(PL;LGSPEC2)"	ის გარანტი 
Generate the inflected form for the lemma: "გარანტი", according to the following morphological descriptions: "N;GEN(SG)"	ის გარანტი 
Generate the inflected form for the lemma: "გარანტი", according to the following morphological descriptions: "N;INS(PL)"	ისი გარანტ
Generate the inflected form for the lemma: "გარანტი", according to the following morphological descriptions: "N;INS(SG)"	გარანტი
Generate
Generate the inflected form for the lemma: "გარანტი", according to the following morphological descriptions: "N;NOM(PL)"	ისტორის გა
Generate the inflected form for the lemma: "გარანტი", according to the following morphological descriptions: "N;NOM(PL;LGSPEC2)"	ის გარანტი 
Generate the inflected form for the lemma: "გარანტი", according to the following morphological descriptions: "N;NOM(SG)"	ისი გარანტ
Generate the inflected form for the lemma: "გარანტი", according to the following morphological descriptions: "N;VOC(PL)"	ისი გარანტ
Generate the inflected form for the lemma: "გარანტი", according to the following morphological descriptions: "N;VOC(PL;LGSPEC2)"	ის გარანტი 
Generate the inflected form for the lemma: "გარანტი", according to the following morphological descriptions: "N;VOC(SG)"	ის გარანტი 
Generate the inflected form for the lemma: "გუთანი", according to the following morphological descriptions: "N;DAT(PL)"	გუთანი გუთ
Generate the inflected form for the lemma: "გუთანი", according to the following morphological descriptions: "N;DAT(PL;LGSPEC2)"	გუთანი გუთ
Generate the inflected form for the lemma: "გუთანი", according to the following morphological descriptions: "N;DAT(SG)"	გუთანი გუთ
Generate the inflected form for the lemma: "გუთანი", according to the following morphological descriptions: "N;ERG(PL)"	გუთანი გუთ
Generate the inflected form for the lemma: "გუთანი", according to the following morphological descriptions: "N;ERG(PL;LGSPEC2)"	გუთანი გუთ
Generate the inflected form for the lemma: "გუთანი", according to the following morphological descriptions: "N;ERG(SG)"	გუთანი გუთ
Generate the inflected form for the lemma: "გუთანი", according to the following morphological descriptions: "N;FRML(PL)"	გუთანი გუთ
Generate the inflected form for the lemma: "გუთანი", according to the following morphological descriptions: "N;FRML(SG)"	გუთანი გუთ
Generate the inflected form for the lemma: "გუთანი", according to the following morphological descriptions: "N;GEN(PL)"	გუთანი გუთ
Generate the inflected form for the lemma: "გუთანი", according to the following morphological descriptions: "N;GEN(PL;LGSPEC2)"	გუთანი გუთ
Generate the inflected form for the lemma: "გუთანი", according to the following morphological descriptions: "N;GEN(SG)"	გუთანი გუთ
Generate the inflected form for the lemma: "გუთანი", according to the following morphological descriptions: "N;INS(PL)"	გუთანი გუთ
Generate the inflected form for the lemma: "გუთანი", according to the following morphological descriptions: "N;INS(SG)"	გუთანი გუთ
Generate the inflected form for the lemma: "გუთანი", according to the following morphological descriptions: "N;NOM(PL)"	გუთანი გუთ
Generate the inflected form for the lemma: "გუთანი", according to the following morphological descriptions: "N;NOM(PL;LGSPEC2)"	გუთანი გუთ
Generate the inflected form for the lemma: "გუთანი", according to the following morphological descriptions: "N;NOM(SG)"	გუთანი გუთ
Generate the inflected form for the lemma: "გუთანი", according to the following morphological descriptions: "N;VOC(PL)"	გუთანი გუთ
Generate the inflected form for the lemma: "გუთანი", according to the following morphological descriptions: "N;VOC(PL;LGSPEC2)"	გუთანი გუთ
Generate the inflected form for the lemma: "გუთანი", according to the following morphological descriptions: "N;VOC(SG)"	გუთანი გუთ
Generate the inflected form for the lemma: "დოლარი", according to the following morphological descriptions: "N;DAT(PL)"	დოლარი დოლ
Generate the inflected form for the lemma: "დოლარი", according to the following morphological descriptions: "N;DAT(PL;LGSPEC2)"	დოლარი დოლ
Generate the inflected form for the lemma: "დოლარი", according to the following morphological descriptions: "N;DAT(SG)"	დოლარი დოლ
Generate the inflected form for the lemma: "დოლარი", according to the following morphological descriptions: "N;ERG(PL)"	დოლარი დოლ
Generate the inflected form for the lemma: "დოლარი", according to the following morphological descriptions: "N;ERG(PL;LGSPEC2)"	დოლარი დოლ
Generate the inflected form for the lemma: "დოლარი", according to the following morphological descriptions: "N;ERG(SG)"	დოლარი დოლ
Generate the inflected form for the lemma: "დოლარი", according to the following morphological descriptions: "N;FRML(PL)"	დოლარი დოლ
Generate the inflected form for the lemma: "დოლარი", according to the following morphological descriptions: "N;FRML(SG)"	დოლარი დოლ
Generate the inflected form for the lemma: "დოლარი", according to the following morphological descriptions: "N;GEN(PL)"	დოლარი დოლ
Generate the inflected form for the lemma: "დოლარი", according to the following morphological descriptions: "N;GEN(PL;LGSPEC2)"	დოლარი დოლ
Generate the inflected form for the lemma: "დოლარი", according to the following morphological descriptions: "N;GEN(SG)"	დოლარი დოლ
Generate the inflected form for the lemma: "დოლარი", according to the following morphological descriptions: "N;INS(PL)"	დოლარი დოლ
Generate the inflected form for the lemma: "დოლარი", according to the following morphological descriptions: "N;INS(SG)"	დოლარი დოლ
Generate the inflected form for the lemma: "დოლარი", according to the following morphological descriptions: "N;NOM(PL)"	დოლარი დოლ
Generate the inflected form for the lemma: "დოლარი", according to the following morphological descriptions: "N;NOM(PL;LGSPEC2)"	დოლარი დოლ
Generate the inflected form for the lemma: "დოლარი", according to the following morphological descriptions: "N;NOM(SG)"	დოლარი დოლ
Generate the inflected form for the lemma: "დოლარი", according to the following morphological descriptions: "N;VOC(PL)"	დოლარი დოლ
Generate the inflected form for the lemma: "დოლარი", according to the following morphological descriptions: "N;VOC(PL;LGSPEC2)"	დოლარი დოლ
Generate the inflected form for the lemma: "დოლარი", according to the following morphological descriptions: "N;VOC(SG)"	დოლარი დოლ
Generate the inflected form for the lemma: "ებონიტი", according to the following morphological descriptions: "N;DAT(PL)"	ებონიტი ებ
Generate the inflected form for the lemma: "ებონიტი", according to the following morphological descriptions: "N;DAT(PL;LGSPEC2)"	ებონიტი ებ
Generate the inflected form for the lemma: "ებონიტი", according to the following morphological descriptions: "N;DAT(SG)"	ებონიტი ებ
Generate the inflected form for the lemma: "ებონიტი", according to the following morphological descriptions: "N;ERG(PL)"	ებონიტი ებ
Generate the inflected form for the lemma: "ებონიტი", according to the following morphological descriptions: "N;ERG(PL;LGSPEC2)"	ებონიტი ებ
Generate the inflected form for the lemma: "ებონიტი", according to the following morphological descriptions: "N;ERG(SG)"	ებონიტი ებ
Generate the inflected form for the lemma: "ებონიტი", according to the following morphological descriptions: "N;FRML(PL)"	ებონიტი ებ
Generate the inflected form for the lemma: "ებონიტი", according to the following morphological descriptions: "N;FRML(SG)"	ებონიტი ებ
Generate the inflected form for the lemma: "ებონიტი", according to the following morphological descriptions: "N;GEN(PL)"	ებონიტი ებ
Generate the inflected form for the lemma: "ებონიტი", according to the following morphological descriptions: "N;GEN(PL;LGSPEC2)"	ებონიტი ებ
Generate the inflected form for the lemma: "ებონიტი", according to the following morphological descriptions: "N;GEN(SG)"	ებონიტი ებ
Generate the inflected form for the lemma: "ებონიტი", according to the following morphological descriptions: "N;INS(PL)"	ებონიტი ებ
Generate the inflected form for the lemma: "ებონიტი", according to the following morphological descriptions: "N;INS(SG)"	ებონიტი ებ
Generate the inflected form for the lemma: "ებონიტი", according to the following morphological descriptions: "N;NOM(PL)"	ებონიტი ებ
Generate the inflected form for the lemma: "ებონიტი", according to the following morphological descriptions: "N;NOM(PL;LGSPEC2)"	ებონიტი ებ
Generate the inflected form for the lemma: "ებონიტი", according to the following morphological descriptions: "N;NOM(SG)"	ებონიტი ებ
Generate the inflected form for the lemma: "ებონიტი", according to the following morphological descriptions: "N;VOC(PL)"	ებონიტი ებ
Generate the inflected form for the lemma: "ებონიტი", according to the following morphological descriptions: "N;VOC(PL;LGSPEC2)"	ებონიტი ებ
Generate the inflected form for the lemma: "ებონიტი", according to the following morphological descriptions: "N;VOC(SG)"	ებონიტი ებ
Generate the inflected form for the lemma: "ეზო", according to the following morphological descriptions: "N;DAT(PL)"	ეზო ეზო ეზო 
Generate the inflected form for the lemma: "ეზო", according to the following morphological descriptions: "N;DAT(PL;LGSPEC2)"	ეზო ეზო ეზო 
Generate the inflected form for the lemma: "ეზო", according to the following morphological descriptions: "N;DAT(SG)"	ეზო ეზო ეზო 
Generate the inflected form for the lemma: "ეზო", according to the following morphological descriptions: "N;ERG(PL)"	ეზო ეზო ეზო 
Generate the inflected form for the lemma: "ეზო", according to the following morphological descriptions: "N;ERG(PL;LGSPEC2)"	ეზო ეზო ეზო 
Generate the inflected form for the lemma: "ეზო", according to the following morphological descriptions: "N;ERG(SG)"	ეზო" and the following m
Generate the inflected form for the lemma: "ეზო", according to the following morphological descriptions: "N;FRML(PL)"	ეზო ეზო ეზო 
Generate the inflected form for the lemma: "ეზო", according to the following morphological descriptions: "N;FRML(SG)"	ეზო ეზო ეზო 
Generate the inflected form for the lemma: "ეზო", according to the following morphological descriptions: "N;GEN(PL)"	ეზო" ეზო ეზო
Generate the inflected form for the lemma: "ეზო", according to the following morphological descriptions: "N;GEN(PL;LGSPEC2)"	ეზო ეზო ეზო 
Generate the inflected form for the lemma: "ეზო", according to the following morphological descriptions: "N;GEN(SG)"	ეზო" ეზო" ეზ
Generate the inflected form for the lemma: "ეზო", according to the following morphological descriptions: "N;INS(PL)"	ეზო ეზო ეზო 
Generate the inflected form for the lemma: "ეზო", according to the following morphological descriptions: "N;INS(SG)"	ეზო" and the following m
Generate the inflected form for the lemma: "ეზო", according to the following morphological descriptions: "N;NOM(PL)"	ეზო ეზო ეზო 
Generate the inflected form for the lemma: "ეზო", according to the following morphological descriptions: "N;NOM(PL;LGSPEC2)"	ეზო ეზო ეზო 
Generate the inflected form for the lemma: "ეზო", according to the following morphological descriptions: "N;NOM(SG)"	ეზო" and the following m
Generate the inflected form for the lemma: "ეზო", according to the following morphological descriptions: "N;VOC(PL)"	ეზო ეზო ეზო 
Generate the inflected form for the lemma: "ეზო", according to the following morphological descriptions: "N;VOC(PL;LGSPEC2)"	ეზო ეზო ეზო 
Generate the inflected form for the lemma: "ეზო", according to the following morphological descriptions: "N;VOC(SG)"	ეზო ეზო ეზო 
Generate the inflected form for the lemma: "ეპიდემიოლოგი", according to the following morphological descriptions: "N;DAT(PL)"	ეპიდემიოლო
Generate the inflected form for the lemma: "ეპიდემიოლოგი", according to the following morphological descriptions: "N;DAT(PL;LGSPEC2)"	ეპიდემიოლო
Generate the inflected form for the lemma: "ეპიდემიოლოგი", according to the following morphological descriptions: "N;DAT(SG)"	ეპიდემიოლო
Generate the inflected form for the lemma: "ეპიდემიოლოგი", according to the following morphological descriptions: "N;ERG(PL)"	მეცნიერი ე
Generate the inflected form for the lemma: "ეპიდემიოლოგი", according to the following morphological descriptions: "N;ERG(PL;LGSPEC2)"	ეპიდემიოლო
Generate the inflected form for the lemma: "ეპიდემიოლოგი", according to the following morphological descriptions: "N;ERG(SG)"	მინისტრის 
Generate the inflected form for the lemma: "ეპიდემიოლოგი", according to the following morphological descriptions: "N;FRML(PL)"	ისი არაბეთ
Generate the inflected form for the lemma: "ეპიდემიოლოგი", according to the following morphological descriptions: "N;FRML(SG)"	ისი ეპიდემ
Generate the inflected form for the lemma: "ეპიდემიოლოგი", according to the following morphological descriptions: "N;GEN(PL)"	ისტორის მო
Generate the inflected form for the lemma: "ეპიდემიოლოგი", according to the following morphological descriptions: "N;GEN(PL;LGSPEC2)"	ეპიდემიოლო
Generate the inflected form for the lemma: "ეპიდემიოლოგი", according to the following morphological descriptions: "N;GEN(SG)"	ეპიდემიოლო
Generate the inflected form for the lemma: "ეპიდემიოლოგი", according to the following morphological descriptions: "N;INS(PL)"	ისტორის მო
Generate the inflected form for the lemma: "ეპიდემიოლოგი", according to the following morphological descriptions: "N;INS(SG)"	ეპიდემიოლო
Generate the inflected form for the lemma: "ეპიდემიოლოგი", according to the following morphological descriptions: "N;NOM(PL)"	ეპიდემიოლო
Generate the inflected form for the lemma: "ეპიდემიოლოგი", according to the following morphological descriptions: "N;NOM(PL;LGSPEC2)"	ის მეცნიერ
Generate the inflected form for the lemma: "ეპიდემიოლოგი", according to the following morphological descriptions: "N;NOM(SG)"	ეპიდემიოლო
Generate the inflected form for the lemma: "ეპიდემიოლოგი", according to the following morphological descriptions: "N;VOC(PL)"	ისი დავითი 
Generate the inflected form for the lemma: "ეპიდემიოლოგი", according to the following morphological descriptions: "N;VOC(PL;LGSPEC2)"	ის მეცნიერ
Generate the inflected form for the lemma: "ეპიდემიოლოგი", according to the following morphological descriptions: "N;VOC(SG)"	ისტორი ეპი
Generate the inflected form for the lemma: "ვაჟი", according to the following morphological descriptions: "N;DAT(PL)"	ის ვაჟი ვაჟ
Generate the inflected form for the lemma: "ვაჟი", according to the following morphological descriptions: "N;DAT(PL;LGSPEC2)"	ის ვაჟი ვაჟ
Generate the inflected form for the lemma: "ვაჟი", according to the following morphological descriptions: "N;DAT(SG)"	ის ვაჟი ვაჟ
Generate the inflected form for the lemma: "ვაჟი", according to the following morphological descriptions: "N;ERG(PL)"	ის ვაჟი ვაჟ
Generate the inflected form for the lemma: "ვაჟი", according to the following morphological descriptions: "N;ERG(PL;LGSPEC2)"	ის ვაჟი ვაჟ
Generate the inflected form for the lemma: "ვაჟი", according to the following morphological descriptions: "N;ERG(SG)"	ვაჟი" და "ვა
Generate the inflected form for the lemma: "ვაჟი", according to the following morphological descriptions: "N;FRML(PL)"	ის ვაჟი ვაჟ
Generate the inflected form for the lemma: "ვაჟი", according to the following morphological descriptions: "N;FRML(SG)"	ის ვაჟი ვაჟ
Generate the inflected form for the lemma: "ვაჟი", according to the following morphological descriptions: "N;GEN(PL)"	ის ვაჟი ვაჟ
Generate the inflected form for the lemma: "ვაჟი", according to the following morphological descriptions: "N;GEN(PL;LGSPEC2)"	ის ვაჟი ვაჟ
Generate the inflected form for the lemma: "ვაჟი", according to the following morphological descriptions: "N;GEN(SG)"	ის ვაჟი ვაჟ
Generate the inflected form for the lemma: "ვაჟი", according to the following morphological descriptions: "N;INS(PL)"	ვაჟი" და "ვა
Generate the inflected form for the lemma: "ვაჟი", according to the following morphological descriptions: "N;INS(SG)"	ვაჟი" ვაჟი ვ
Generate the inflected form for the lemma: "ვაჟი", according to the following morphological descriptions: "N;NOM(PL)"	ის ვაჟი ვაჟ
Generate the inflected form for the lemma: "ვაჟი", according to the following morphological descriptions: "N;NOM(PL;LGSPEC2)"	ის ვაჟი ვაჟ
Generate the inflected form for the lemma: "ვაჟი", according to the following morphological descriptions: "N;NOM(SG)"	ის ვაჟი ვაჟ
Generate the inflected form for the lemma: "ვაჟი", according to the following morphological descriptions: "N;VOC(PL)"	ის ვაჟი ვაჟ
Generate the inflected form for the lemma: "ვაჟი", according to the following morphological descriptions: "N;VOC(PL;LGSPEC2)"	ვაჟი ვაჟი ვ
Generate the inflected form for the lemma: "ვაჟი", according to the following morphological descriptions: "N;VOC(SG)"	ვაჟი" ვაჟი ვ
Generate the inflected form for the lemma: "ზამბახიანი", according to the following morphological descriptions: "ADJ;DAT(PL)"	ანიანი" და "
Generate the inflected form for the lemma: "ზამბახიანი", according to the following morphological descriptions: "ADJ;DAT(PL;LGSPEC2)"	ანიანი
ზამ
Generate the inflected form for the lemma: "ზამბახიანი", according to the following morphological descriptions: "ADJ;DAT(SG)"	ისი ზამბახ
Generate the inflected form for the lemma: "ზამბახიანი", according to the following morphological descriptions: "ADJ;ERG(PL)"	ისი ზამბახ
Generate the inflected form for the lemma: "ზამბახიანი", according to the following morphological descriptions: "ADJ;ERG(PL;LGSPEC2)"	ისი ზამბახ
Generate the inflected form for the lemma: "ზამბახიანი", according to the following morphological descriptions: "ADJ;ERG(SG)"	ისი ზამბახ
Generate the inflected form for the lemma: "ზამბახიანი", according to the following morphological descriptions: "ADJ;FRML(PL)"	ისი" და "ზამ
Generate the inflected form for the lemma: "ზამბახიანი", according to the following morphological descriptions: "ADJ;FRML(SG)"	ინგორის მო
Generate the inflected form for the lemma: "ზამბახიანი", according to the following morphological descriptions: "ADJ;GEN(PL)"	ისი
ზამბახ
Generate the inflected form for the lemma: "ზამბახიანი", according to the following morphological descriptions: "ADJ;GEN(PL;LGSPEC2)"	ისი
ზამბახ
Generate the inflected form for the lemma: "ზამბახიანი", according to the following morphological descriptions: "ADJ;GEN(SG)"	ისი
ზამბახ
Generate the inflected form for the lemma: "ზამბახიანი", according to the following morphological descriptions: "ADJ;INS(PL)"	ისი
ზამბახ
Generate the inflected form for the lemma: "ზამბახიანი", according to the following morphological descriptions: "ADJ;INS(SG)"	ინგორის მო
Generate the inflected form for the lemma: "ზამბახიანი", according to the following morphological descriptions: "ADJ;NOM(PL)"	ისი" და "ზამ
Generate the inflected form for the lemma: "ზამბახიანი", according to the following morphological descriptions: "ADJ;NOM(PL;LGSPEC2)"	ზამბახიანი
Generate the inflected form for the lemma: "ზამბახიანი", according to the following morphological descriptions: "ADJ;NOM(SG)"	ისი ზამბახ
Generate the inflected form for the lemma: "ზამბახიანი", according to the following morphological descriptions: "ADJ;VOC(PL)"	ანიანი" და "
Generate the inflected form for the lemma: "ზამბახიანი", according to the following morphological descriptions: "ADJ;VOC(PL;LGSPEC2)"	ზამბახიანი
Generate the inflected form for the lemma: "ზამბახიანი", according to the following morphological descriptions: "ADJ;VOC(SG)"	ისი ზამბახ
Generate the inflected form for the lemma: "თარაზო", according to the following morphological descriptions: "N;DAT(PL)"	არაზო თარა
Generate the inflected form for the lemma: "თარაზო", according to the following morphological descriptions: "N;DAT(PL;LGSPEC2)"	არაზო თარა
Generate the inflected form for the lemma: "თარაზო", according to the following morphological descriptions: "N;DAT(SG)"	არაზო თარა
Generate the inflected form for the lemma: "თარაზო", according to the following morphological descriptions: "N;ERG(PL)"	თარაზო თარ
Generate the inflected form for the lemma: "თარაზო", according to the following morphological descriptions: "N;ERG(PL;LGSPEC2)"	არაზო თარა
Generate the inflected form for the lemma: "თარაზო", according to the following morphological descriptions: "N;ERG(SG)"	თარაზო თარ
Generate the inflected form for the lemma: "თარაზო", according to the following morphological descriptions: "N;FRML(PL)"	არაზო თარა
Generate the inflected form for the lemma: "თარაზო", according to the following morphological descriptions: "N;FRML(SG)"	არაზო თარა
Generate the inflected form for the lemma: "თარაზო", according to the following morphological descriptions: "N;GEN(PL)"	თარაზო თარ
Generate the inflected form for the lemma: "თარაზო", according to the following morphological descriptions: "N;GEN(PL;LGSPEC2)"	არაზო თარა
Generate the inflected form for the lemma: "თარაზო", according to the following morphological descriptions: "N;GEN(SG)"	არაზო თარა
Generate the inflected form for the lemma: "თარაზო", according to the following morphological descriptions: "N;INS(PL)"	არაზო თარა
Generate the inflected form for the lemma: "თარაზო", according to the following morphological descriptions: "N;INS(SG)"	არაზო თარა
Generate the inflected form for the lemma: "თარაზო", according to the following morphological descriptions: "N;NOM(PL)"	თარაზო თარ
Generate the inflected form for the lemma: "თარაზო", according to the following morphological descriptions: "N;NOM(PL;LGSPEC2)"	არაზო თარა
Generate the inflected form for the lemma: "თარაზო", according to the following morphological descriptions: "N;NOM(SG)"	თარაზო თარ
Generate the inflected form for the lemma: "თარაზო", according to the following morphological descriptions: "N;VOC(PL)"	თარაზო თარ
Generate the inflected form for the lemma: "თარაზო", according to the following morphological descriptions: "N;VOC(PL;LGSPEC2)"	არაზო თარა
Generate the inflected form for the lemma: "თარაზო", according to the following morphological descriptions: "N;VOC(SG)"	არაზო თარა
Generate the inflected form for the lemma: "თეთრდება", according to the following morphological descriptions: "V;COND;NOM(1,PL)"	ანუკანაძის
Generate the inflected form for the lemma: "თეთრდება", according to the following morphological descriptions: "V;COND;NOM(1,SG)"	ანუსი და ან
Generate the inflected form for the lemma: "თეთრდება", according to the following morphological descriptions: "V;COND;NOM(2,PL)"	ანუკანაძის
Generate the inflected form for the lemma: "თეთრდება", according to the following morphological descriptions: "V;COND;NOM(3,PL)"	ანუკანაძის
Generate the inflected form for the lemma: "თეთრდება", according to the following morphological descriptions: "V;COND;NOM(3,SG)"	ანუსი და ან
Generate the inflected form for the lemma: "თეთრდება", according to the following morphological descriptions: "V;IMP;NOM(1,PL)"	ანუსი და ან
Generate the inflected form for the lemma: "თეთრდება", according to the following morphological descriptions: "V;IND;FUT;NOM(3,SG)"	თეთრდება დ
Generate the inflected form for the lemma: "თეთრდება", according to the following morphological descriptions: "V;IND;IPFV;NOM(1,PL)"	არაბები და 
Generate the inflected form for the lemma: "თეთრდება", according to the following morphological descriptions: "V;IND;IPFV;NOM(3,SG)"	თეთრდება დ
Generate the inflected form for the lemma: "თეთრდება", according to the following morphological descriptions: "V;IND;PRS;NOM(2,PL)"	არაბები და 
Generate the inflected form for the lemma: "თეთრდება", according to the following morphological descriptions: "V;IND;PRS;NOM(2,SG)"	არაბები და 
Generate the inflected form for the lemma: "თეთრდება", according to the following morphological descriptions: "V;IND;PRS;NOM(3,PL)"	არაბები და 
Generate the inflected form for the lemma: "თეთრდება", according to the following morphological descriptions: "V;IND;PRS;NOM(3,SG)"	თეთრდება დ
Generate the inflected form for the lemma: "თეთრდება", according to the following morphological descriptions: "V;IND;PST;PFV;NOM(2,SG)"	არაბები და 
Generate the inflected form for the lemma: "თეთრდება", according to the following morphological descriptions: "V;IND;PST;PFV;NOM(3,PL)"	ანგარიში დ
Generate the inflected form for the lemma: "თეთრდება", according to the following morphological descriptions: "V;IND;PST;PFV;NOM(3,SG)"	თეთრდება თ
Generate the inflected form for the lemma: "თეთრდება", according to the following morphological descriptions: "V;IND;PST;PRF;NOM(2,PL)"	ანგარიში დ
Generate the inflected form for the lemma: "თეთრდება", according to the following morphological descriptions: "V;IND;PST;PRF;NOM(2,SG)"	თეთრდება თ
Generate the inflected form for the lemma: "თეთრდება", according to the following morphological descriptions: "V;OPT;NOM(1,SG)"	არაბები და 
Generate the inflected form for the lemma: "თეთრდება", according to the following morphological descriptions: "V;SBJV;FUT;NOM(1,PL)"	ანუკანური 
Generate the inflected form for the lemma: "თეთრდება", according to the following morphological descriptions: "V;SBJV;FUT;NOM(2,PL)"	ანურის მონ
Generate the inflected form for the lemma: "თეთრდება", according to the following morphological descriptions: "V;SBJV;FUT;NOM(2,SG)"	არა და დაამ
Generate the inflected form for the lemma: "თეთრდება", according to the following morphological descriptions: "V;SBJV;FUT;NOM(3,PL)"	ანუკანა მე
Generate the inflected form for the lemma: "თეთრდება", according to the following morphological descriptions: "V;SBJV;PRF;NOM(1,SG)"	არაბები და 
Generate the inflected form for the lemma: "თეთრდება", according to the following morphological descriptions: "V;SBJV;PRS;NOM(1,PL)"	ანუკრები დ
Generate the inflected form for the lemma: "თეთრდება", according to the following morphological descriptions: "V;V.MSDR;PRF"	ისი თეთრდე
Generate the inflected form for the lemma: "ილი", according to the following morphological descriptions: "N;DAT(PL)"	ილი" ილი ილი
Generate the inflected form for the lemma: "ილი", according to the following morphological descriptions: "N;DAT(PL;LGSPEC2)"	ილი ილი ილი 
Generate the inflected form for the lemma: "ილი", according to the following morphological descriptions: "N;DAT(SG)"	ილი" ილი ილი
Generate the inflected form for the lemma: "ილი", according to the following morphological descriptions: "N;ERG(PL)"	ილი" ილი ილი
Generate the inflected form for the lemma: "ილი", according to the following morphological descriptions: "N;ERG(PL;LGSPEC2)"	ილი ილი ილი 
Generate the inflected form for the lemma: "ილი", according to the following morphological descriptions: "N;ERG(SG)"	ილი" ილი ილი
Generate the inflected form for the lemma: "ილი", according to the following morphological descriptions: "N;FRML(PL)"	ილი" ილი ილი
Generate the inflected form for the lemma: "ილი", according to the following morphological descriptions: "N;FRML(SG)"	ილი" ილი ილი
Generate the inflected form for the lemma: "ილი", according to the following morphological descriptions: "N;GEN(PL)"	ილი" ილი ილი
Generate the inflected form for the lemma: "ილი", according to the following morphological descriptions: "N;GEN(PL;LGSPEC2)"	ილი" ილი ილი
Generate the inflected form for the lemma: "ილი", according to the following morphological descriptions: "N;GEN(SG)"	ილი" ილი ილი
Generate the inflected form for the lemma: "ილი", according to the following morphological descriptions: "N;INS(PL)"	ილი" ილი ილი
Generate the inflected form for the lemma: "ილი", according to the following morphological descriptions: "N;INS(SG)"	ილი" ილი ილი
Generate the inflected form for the lemma: "ილი", according to the following morphological descriptions: "N;NOM(PL)"	ილი" ილი ილი
Generate the inflected form for the lemma: "ილი", according to the following morphological descriptions: "N;NOM(PL;LGSPEC2)"	ილი" ილი ილი
Generate the inflected form for the lemma: "ილი", according to the following morphological descriptions: "N;NOM(SG)"	ილი" and the following m
Generate the inflected form for the lemma: "ილი", according to the following morphological descriptions: "N;VOC(PL)"	ილი" ილი ილი
Generate the inflected form for the lemma: "ილი", according to the following morphological descriptions: "N;VOC(PL;LGSPEC2)"	ილი" ილი ილი
Generate the inflected form for the lemma: "ილი", according to the following morphological descriptions: "N;VOC(SG)"	ილი" ილი ილი
Generate the inflected form for the lemma: "იმპერიალისტი", according to the following morphological descriptions: "N;DAT(PL)"	იმპერიალის
Generate the inflected form for the lemma: "იმპერიალისტი", according to the following morphological descriptions: "N;DAT(PL;LGSPEC2)"	ისტორის მო
Generate the inflected form for the lemma: "იმპერიალისტი", according to the following morphological descriptions: "N;DAT(SG)"	იმპერიალის
Generate the inflected form for the lemma: "იმპერიალისტი", according to the following morphological descriptions: "N;ERG(PL)"	იმპერიალის
Generate the inflected form for the lemma: "იმპერიალისტი", according to the following morphological descriptions: "N;ERG(PL;LGSPEC2)"	ისტორის მო
Generate the inflected form for the lemma: "იმპერიალისტი", according to the following morphological descriptions: "N;ERG(SG)"	იმპერიალის
Generate the inflected form for the lemma: "იმპერიალისტი", according to the following morphological descriptions: "N;FRML(PL)"	იმპერიალის
Generate the inflected form for the lemma: "იმპერიალისტი", according to the following morphological descriptions: "N;FRML(SG)"	იმპერიალის
Generate the inflected form for the lemma: "იმპერიალისტი", according to the following morphological descriptions: "N;GEN(PL)"	იმპერიალის
Generate the inflected form for the lemma: "იმპერიალისტი", according to the following morphological descriptions: "N;GEN(PL;LGSPEC2)"	ისტორის მო
Generate the inflected form for the lemma: "იმპერიალისტი", according to the following morphological descriptions: "N;GEN(SG)"	იმპერიალის
Generate the inflected form for the lemma: "იმპერიალისტი", according to the following morphological descriptions: "N;INS(PL)"	იმპერიალის
Generate the inflected form for the lemma: "იმპერიალისტი", according to the following morphological descriptions: "N;INS(SG)"	იმპერიალის
Generate the inflected form for the lemma: "იმპერიალისტი", according to the following morphological descriptions: "N;NOM(PL)"	იმპერიალის
Generate the inflected form for the lemma: "იმპერიალისტი", according to the following morphological descriptions: "N;NOM(PL;LGSPEC2)"	იმპერიალის
Generate the inflected form for the lemma: "იმპერიალისტი", according to the following morphological descriptions: "N;NOM(SG)"	იმპერიალის
Generate the inflected form for the lemma: "იმპერიალისტი", according to the following morphological descriptions: "N;VOC(PL)"	იმპერიალის
Generate the inflected form for the lemma: "იმპერიალისტი", according to the following morphological descriptions: "N;VOC(PL;LGSPEC2)"	იმპერიალის
Generate the inflected form for the lemma: "იმპერიალისტი", according to the following morphological descriptions: "N;VOC(SG)"	იმპერიალის
Generate the inflected form for the lemma: "იმპორტი", according to the following morphological descriptions: "N;DAT(PL)"	იმპორტი
იმ
Generate the inflected form for the lemma: "იმპორტი", according to the following morphological descriptions: "N;DAT(PL;LGSPEC2)"	იმპორტი
იმ
Generate the inflected form for the lemma: "იმპორტი", according to the following morphological descriptions: "N;DAT(SG)"	იმპორტი
იმ
Generate the inflected form for the lemma: "იმპორტი", according to the following morphological descriptions: "N;ERG(PL)"	იმპორტი
იმ
Generate the inflected form for the lemma: "იმპორტი", according to the following morphological descriptions: "N;ERG(PL;LGSPEC2)"	ისი ისი ისი 
Generate the inflected form for the lemma: "იმპორტი", according to the following morphological descriptions: "N;ERG(SG)"	იმპორტი იმ
Generate the inflected form for the lemma: "იმპორტი", according to the following morphological descriptions: "N;FRML(PL)"	იმპორტი იმ
Generate the inflected form for the lemma: "იმპორტი", according to the following morphological descriptions: "N;FRML(SG)"	იმპორტი იმ
Generate the inflected form for the lemma: "იმპორტი", according to the following morphological descriptions: "N;GEN(PL)"	იმპორტი
Generate
Generate the inflected form for the lemma: "იმპორტი", according to the following morphological descriptions: "N;GEN(PL;LGSPEC2)"	ისი ისი ისი 
Generate the inflected form for the lemma: "იმპორტი", according to the following morphological descriptions: "N;GEN(SG)"	იმპორტი
Generate
Generate the inflected form for the lemma: "იმპორტი", according to the following morphological descriptions: "N;INS(PL)"	იმპორტი
იმ
Generate the inflected form for the lemma: "იმპორტი", according to the following morphological descriptions: "N;INS(SG)"	იმპორტი
იმ
Generate the inflected form for the lemma: "იმპორტი", according to the following morphological descriptions: "N;NOM(PL)"	იმპორტი იმ
Generate the inflected form for the lemma: "იმპორტი", according to the following morphological descriptions: "N;NOM(PL;LGSPEC2)"	იმპორტი
იმ
Generate the inflected form for the lemma: "იმპორტი", according to the following morphological descriptions: "N;NOM(SG)"	იმპორტი
იმ
Generate the inflected form for the lemma: "იმპორტი", according to the following morphological descriptions: "N;VOC(PL)"	იმპორტი იმ
Generate the inflected form for the lemma: "იმპორტი", according to the following morphological descriptions: "N;VOC(PL;LGSPEC2)"	იმპორტი
იმ
Generate the inflected form for the lemma: "იმპორტი", according to the following morphological descriptions: "N;VOC(SG)"	იმპორტი იმ
Generate the inflected form for the lemma: "იღება", according to the following morphological descriptions: "V;COND;NOM(1,PL)"	იღება იღებ
Generate the inflected form for the lemma: "იღება", according to the following morphological descriptions: "V;COND;NOM(3,SG)"	იღება იღებ
Generate the inflected form for the lemma: "იღება", according to the following morphological descriptions: "V;IMP;NOM(1,PL)"	იღება იღებ
Generate the inflected form for the lemma: "იღება", according to the following morphological descriptions: "V;IMP;NOM(2,PL)"	იღება იღებ
Generate the inflected form for the lemma: "იღება", according to the following morphological descriptions: "V;IND;FUT;NOM(1,SG)"	იღება იღებ
Generate the inflected form for the lemma: "იღება", according to the following morphological descriptions: "V;IND;FUT;NOM(2,SG)"	იღება იღებ
Generate the inflected form for the lemma: "იღება", according to the following morphological descriptions: "V;IND;FUT;NOM(3,PL)"	იღება იღებ
Generate the inflected form for the lemma: "იღება", according to the following morphological descriptions: "V;IND;IPFV;NOM(2,PL)"	იღება იღებ
Generate the inflected form for the lemma: "იღება", according to the following morphological descriptions: "V;IND;PRF;NOM(1,PL)"	იღება იღებ
Generate the inflected form for the lemma: "იღება", according to the following morphological descriptions: "V;IND;PRF;NOM(1,SG)"	იღება იღებ
Generate the inflected form for the lemma: "იღება", according to the following morphological descriptions: "V;IND;PRF;NOM(2,SG)"	იღება იღებ
Generate the inflected form for the lemma: "იღება", according to the following morphological descriptions: "V;IND;PRF;NOM(3,PL)"	იღება იღებ
Generate the inflected form for the lemma: "იღება", according to the following morphological descriptions: "V;IND;PRF;NOM(3,SG)"	იღება იღებ
Generate the inflected form for the lemma: "იღება", according to the following morphological descriptions: "V;IND;PRS;NOM(1,PL)"	იღება იღებ
Generate the inflected form for the lemma: "იღება", according to the following morphological descriptions: "V;IND;PRS;NOM(1,SG)"	იღება იღებ
Generate the inflected form for the lemma: "იღება", according to the following morphological descriptions: "V;IND;PRS;NOM(2,SG)"	იღება იღებ
Generate the inflected form for the lemma: "იღება", according to the following morphological descriptions: "V;IND;PST;PFV;NOM(1,PL)"	იღება იღებ
Generate the inflected form for the lemma: "იღება", according to the following morphological descriptions: "V;IND;PST;PFV;NOM(2,PL)"	იღება იღებ
Generate the inflected form for the lemma: "იღება", according to the following morphological descriptions: "V;IND;PST;PFV;NOM(3,PL)"	იღება იღებ
Generate the inflected form for the lemma: "იღება", according to the following morphological descriptions: "V;IND;PST;PRF;NOM(1,PL)"	იღება იღებ
Generate the inflected form for the lemma: "იღება", according to the following morphological descriptions: "V;IND;PST;PRF;NOM(3,PL)"	იღება იღებ
Generate the inflected form for the lemma: "იღება", according to the following morphological descriptions: "V;OPT;NOM(3,SG)"	იღება იღებ
Generate the inflected form for the lemma: "იღება", according to the following morphological descriptions: "V;SBJV;PRF;NOM(2,PL)"	იღება იღებ
Generate the inflected form for the lemma: "იღება", according to the following morphological descriptions: "V;SBJV;PRF;NOM(2,SG)"	იღება იღებ
Generate the inflected form for the lemma: "იღება", according to the following morphological descriptions: "V;SBJV;PRS;NOM(2,PL)"	იღება იღებ
Generate the inflected form for the lemma: "იღება", according to the following morphological descriptions: "V;SBJV;PRS;NOM(3,SG)"	იღება იღებ
Generate the inflected form for the lemma: "კანდიდატი", according to the following morphological descriptions: "N;DAT(PL)"	ისტორის მო
Generate the inflected form for the lemma: "კანდიდატი", according to the following morphological descriptions: "N;DAT(PL;LGSPEC2)"	ისის კანდი
Generate the inflected form for the lemma: "კანდიდატი", according to the following morphological descriptions: "N;DAT(SG)"	ისი"კანდიდ
Generate the inflected form for the lemma: "კანდიდატი", according to the following morphological descriptions: "N;ERG(PL)"	ისი"კანდიდ
Generate the inflected form for the lemma: "კანდიდატი", according to the following morphological descriptions: "N;ERG(PL;LGSPEC2)"	ისი დამატე
Generate the inflected form for the lemma: "კანდიდატი", according to the following morphological descriptions: "N;ERG(SG)"	ისი"კანდიდ
Generate the inflected form for the lemma: "კანდიდატი", according to the following morphological descriptions: "N;FRML(PL)"	კანდიდატი
Ge
Generate the inflected form for the lemma: "კანდიდატი", according to the following morphological descriptions: "N;FRML(SG)"	კანდიდატი
Ge
Generate the inflected form for the lemma: "კანდიდატი", according to the following morphological descriptions: "N;GEN(PL)"	ისტორის მო
Generate the inflected form for the lemma: "კანდიდატი", according to the following morphological descriptions: "N;GEN(PL;LGSPEC2)"	ისი დამატე
Generate the inflected form for the lemma: "კანდიდატი", according to the following morphological descriptions: "N;GEN(SG)"	ისი"კანდიდ
Generate the inflected form for the lemma: "კანდიდატი", according to the following morphological descriptions: "N;INS(PL)"	ისი"კანდიდ
Generate the inflected form for the lemma: "კანდიდატი", according to the following morphological descriptions: "N;INS(SG)"	ისი"კანდიდ
Generate the inflected form for the lemma: "კანდიდატი", according to the following morphological descriptions: "N;NOM(PL)"	კანდიდატი
Ge
Generate the inflected form for the lemma: "კანდიდატი", according to the following morphological descriptions: "N;NOM(PL;LGSPEC2)"	ისიის მერი
Generate the inflected form for the lemma: "კანდიდატი", according to the following morphological descriptions: "N;NOM(SG)"	კანდიდატი
Ge
Generate the inflected form for the lemma: "კანდიდატი", according to the following morphological descriptions: "N;VOC(PL)"	ანდიდატი" დ
Generate the inflected form for the lemma: "კანდიდატი", according to the following morphological descriptions: "N;VOC(PL;LGSPEC2)"	ისის კანდი
Generate the inflected form for the lemma: "კანდიდატი", according to the following morphological descriptions: "N;VOC(SG)"	კანდიდატი
Ge
Generate the inflected form for the lemma: "კონტური", according to the following morphological descriptions: "N;DAT(PL)"	ისტორის მო
Generate the inflected form for the lemma: "კონტური", according to the following morphological descriptions: "N;DAT(PL;LGSPEC2)"	ის მონაცემ
Generate the inflected form for the lemma: "კონტური", according to the following morphological descriptions: "N;DAT(SG)"	ისტორის მო
Generate the inflected form for the lemma: "კონტური", according to the following morphological descriptions: "N;ERG(PL)"	ისტორის მო
Generate the inflected form for the lemma: "კონტური", according to the following morphological descriptions: "N;ERG(PL;LGSPEC2)"	ის მონაცემ
Generate the inflected form for the lemma: "კონტური", according to the following morphological descriptions: "N;ERG(SG)"	კონტური კო
Generate the inflected form for the lemma: "კონტური", according to the following morphological descriptions: "N;FRML(PL)"	კონტური კო
Generate the inflected form for the lemma: "კონტური", according to the following morphological descriptions: "N;FRML(SG)"	ისი კონტურ
Generate the inflected form for the lemma: "კონტური", according to the following morphological descriptions: "N;GEN(PL)"	ისტორის მო
Generate the inflected form for the lemma: "კონტური", according to the following morphological descriptions: "N;GEN(PL;LGSPEC2)"	ის მონაცემ
Generate the inflected form for the lemma: "კონტური", according to the following morphological descriptions: "N;GEN(SG)"	ისტორის მო
Generate the inflected form for the lemma: "კონტური", according to the following morphological descriptions: "N;INS(PL)"	ისტორის მო
Generate the inflected form for the lemma: "კონტური", according to the following morphological descriptions: "N;INS(SG)"	კონტური
კო
Generate the inflected form for the lemma: "კონტური", according to the following morphological descriptions: "N;NOM(PL)"	ისტორის მო
Generate the inflected form for the lemma: "კონტური", according to the following morphological descriptions: "N;NOM(PL;LGSPEC2)"	ისი კონტურ
Generate the inflected form for the lemma: "კონტური", according to the following morphological descriptions: "N;NOM(SG)"	კონტური კო
Generate the inflected form for the lemma: "კონტური", according to the following morphological descriptions: "N;VOC(PL)"	ისტორის მო
Generate the inflected form for the lemma: "კონტური", according to the following morphological descriptions: "N;VOC(PL;LGSPEC2)"	ისი კონტურ
Generate the inflected form for the lemma: "კონტური", according to the following morphological descriptions: "N;VOC(SG)"	ისტორის მო
Generate the inflected form for the lemma: "კორიდორი", according to the following morphological descriptions: "N;DAT(PL)"	ისიის მოსა
Generate the inflected form for the lemma: "კორიდორი", according to the following morphological descriptions: "N;DAT(PL;LGSPEC2)"	კორიდორი კ
Generate the inflected form for the lemma: "კორიდორი", according to the following morphological descriptions: "N;ERG(PL)"	კორიდორი კ
Generate the inflected form for the lemma: "კორიდორი", according to the following morphological descriptions: "N;ERG(PL;LGSPEC2)"	კორიდორი კ
Generate the inflected form for the lemma: "კორიდორი", according to the following morphological descriptions: "N;ERG(SG)"	კორიდორი კ
Generate the inflected form for the lemma: "კორიდორი", according to the following morphological descriptions: "N;FRML(SG)"	ისი კორიდო
Generate the inflected form for the lemma: "კორიდორი", according to the following morphological descriptions: "N;GEN(PL)"	ისი კორიდო
Generate the inflected form for the lemma: "კორიდორი", according to the following morphological descriptions: "N;GEN(PL;LGSPEC2)"	კორიდორი კ
Generate the inflected form for the lemma: "კორიდორი", according to the following morphological descriptions: "N;GEN(SG)"	კორიდორი
Gener
Generate the inflected form for the lemma: "კორიდორი", according to the following morphological descriptions: "N;INS(PL)"	ისი კორიდო
Generate the inflected form for the lemma: "კორიდორი", according to the following morphological descriptions: "N;INS(SG)"	კორიდორი კ
Generate the inflected form for the lemma: "კორიდორი", according to the following morphological descriptions: "N;NOM(PL)"	კორიდორი კ
Generate the inflected form for the lemma: "კორიდორი", according to the following morphological descriptions: "N;NOM(PL;LGSPEC2)"	კორიდორი კ
Generate the inflected form for the lemma: "კორიდორი", according to the following morphological descriptions: "N;NOM(SG)"	კორიდორი კ
Generate the inflected form for the lemma: "კორიდორი", according to the following morphological descriptions: "N;VOC(PL)"	ისიის მოსა
Generate the inflected form for the lemma: "კორიდორი", according to the following morphological descriptions: "N;VOC(PL;LGSPEC2)"	ის მონაცემ
Generate the inflected form for the lemma: "კორიდორი", according to the following morphological descriptions: "N;VOC(SG)"	ისი კორიდო
Generate the inflected form for the lemma: "მთისწინეთი", according to the following morphological descriptions: "N;DAT(PL)"	მთისწინეთი
Generate the inflected form for the lemma: "მთისწინეთი", according to the following morphological descriptions: "N;DAT(PL;LGSPEC2)"	მთისწინეთი
Generate the inflected form for the lemma: "მთისწინეთი", according to the following morphological descriptions: "N;DAT(SG)"	მთისწინეთი
Generate the inflected form for the lemma: "მთისწინეთი", according to the following morphological descriptions: "N;ERG(PL)"	მთისწინეთი
Generate the inflected form for the lemma: "მთისწინეთი", according to the following morphological descriptions: "N;ERG(PL;LGSPEC2)"	მთისწინეთი
Generate the inflected form for the lemma: "მთისწინეთი", according to the following morphological descriptions: "N;ERG(SG)"	მთისწინეთი
Generate the inflected form for the lemma: "მთისწინეთი", according to the following morphological descriptions: "N;FRML(PL)"	მთისწინეთი
Generate the inflected form for the lemma: "მთისწინეთი", according to the following morphological descriptions: "N;FRML(SG)"	მთისწინეთი
Generate the inflected form for the lemma: "მთისწინეთი", according to the following morphological descriptions: "N;GEN(PL)"	მთისწინეთი
Generate the inflected form for the lemma: "მთისწინეთი", according to the following morphological descriptions: "N;GEN(PL;LGSPEC2)"	მთისწინეთი
Generate the inflected form for the lemma: "მთისწინეთი", according to the following morphological descriptions: "N;GEN(SG)"	მთისწინეთი
Generate the inflected form for the lemma: "მთისწინეთი", according to the following morphological descriptions: "N;INS(PL)"	მთისწინეთი
Generate the inflected form for the lemma: "მთისწინეთი", according to the following morphological descriptions: "N;INS(SG)"	მთისწინეთი
Generate the inflected form for the lemma: "მთისწინეთი", according to the following morphological descriptions: "N;NOM(PL)"	მთისწინეთი
Generate the inflected form for the lemma: "მთისწინეთი", according to the following morphological descriptions: "N;NOM(PL;LGSPEC2)"	მთისწინეთი
Generate the inflected form for the lemma: "მთისწინეთი", according to the following morphological descriptions: "N;NOM(SG)"	მთისწინეთი
Generate the inflected form for the lemma: "მთისწინეთი", according to the following morphological descriptions: "N;VOC(PL)"	მთისწინეთი
Generate the inflected form for the lemma: "მთისწინეთი", according to the following morphological descriptions: "N;VOC(PL;LGSPEC2)"	მთისწინეთი
Generate the inflected form for the lemma: "მთისწინეთი", according to the following morphological descriptions: "N;VOC(SG)"	მთისწინეთი
Generate the inflected form for the lemma: "მშვიდი", according to the following morphological descriptions: "ADJ;DAT(PL)"	ინგლისი
Generate
Generate the inflected form for the lemma: "მშვიდი", according to the following morphological descriptions: "ADJ;DAT(PL;LGSPEC2)"	ისი" მშვიდი"
Generate the inflected form for the lemma: "მშვიდი", according to the following morphological descriptions: "ADJ;DAT(SG)"	ინგლისი
მშ
Generate the inflected form for the lemma: "მშვიდი", according to the following morphological descriptions: "ADJ;ERG(PL)"	ისი" და "მშვ
Generate the inflected form for the lemma: "მშვიდი", according to the following morphological descriptions: "ADJ;ERG(PL;LGSPEC2)"	ისი" მშვიდი"
Generate the inflected form for the lemma: "მშვიდი", according to the following morphological descriptions: "ADJ;ERG(SG)"	მშვიდი" და "AD
Generate the inflected form for the lemma: "მშვიდი", according to the following morphological descriptions: "ADJ;FRML(PL)"	მშვიდი" და "
Generate the inflected form for the lemma: "მშვიდი", according to the following morphological descriptions: "ADJ;FRML(SG)"	ინგლისი
მშ
Generate the inflected form for the lemma: "მშვიდი", according to the following morphological descriptions: "ADJ;GEN(PL)"	ისი" მშვიდი"
Generate the inflected form for the lemma: "მშვიდი", according to the following morphological descriptions: "ADJ;GEN(PL;LGSPEC2)"	ისი" მშვიდი"
Generate the inflected form for the lemma: "მშვიდი", according to the following morphological descriptions: "ADJ;GEN(SG)"	მშვიდი" მშვ
Generate the inflected form for the lemma: "მშვიდი", according to the following morphological descriptions: "ADJ;INS(PL)"	ინგლისი
მშ
Generate the inflected form for the lemma: "მშვიდი", according to the following morphological descriptions: "ADJ;INS(SG)"	მშვიდი" და "
Generate the inflected form for the lemma: "მშვიდი", according to the following morphological descriptions: "ADJ;NOM(PL)"	ისი" და "მშვ
Generate the inflected form for the lemma: "მშვიდი", according to the following morphological descriptions: "ADJ;NOM(PL;LGSPEC2)"	მშვიდი" მშვ
Generate the inflected form for the lemma: "მშვიდი", according to the following morphological descriptions: "ADJ;NOM(SG)"	ისი" და "მშვ
Generate the inflected form for the lemma: "მშვიდი", according to the following morphological descriptions: "ADJ;VOC(PL)"	ისი" და "მშვ
Generate the inflected form for the lemma: "მშვიდი", according to the following morphological descriptions: "ADJ;VOC(PL;LGSPEC2)"	ისი" მშვიდი 
Generate the inflected form for the lemma: "მშვიდი", according to the following morphological descriptions: "ADJ;VOC(SG)"	ისი" და "მშვ
Generate the inflected form for the lemma: "მძინარე", according to the following morphological descriptions: "ADJ;DAT(PL)"	მძინარე". მძ
Generate the inflected form for the lemma: "მძინარე", according to the following morphological descriptions: "ADJ;DAT(PL;LGSPEC2)"	მძინარე მძ
Generate the inflected form for the lemma: "მძინარე", according to the following morphological descriptions: "ADJ;DAT(SG)"	მძინარე" და 
Generate the inflected form for the lemma: "მძინარე", according to the following morphological descriptions: "ADJ;ERG(PL)"	ანალიტიკა
Ge
Generate the inflected form for the lemma: "მძინარე", according to the following morphological descriptions: "ADJ;ERG(PL;LGSPEC2)"	მძინარე მძ
Generate the inflected form for the lemma: "მძინარე", according to the following morphological descriptions: "ADJ;ERG(SG)"	მძინარე" და 
Generate the inflected form for the lemma: "მძინარე", according to the following morphological descriptions: "ADJ;FRML(PL)"	მძინარე".
Genera
Generate the inflected form for the lemma: "მძინარე", according to the following morphological descriptions: "ADJ;FRML(SG)"	მძინარე" და 
Generate the inflected form for the lemma: "მძინარე", according to the following morphological descriptions: "ADJ;GEN(PL)"	მძინარე".
Genera
Generate the inflected form for the lemma: "მძინარე", according to the following morphological descriptions: "ADJ;GEN(PL;LGSPEC2)"	მძინარე მძ
Generate the inflected form for the lemma: "მძინარე", according to the following morphological descriptions: "ADJ;GEN(SG)"	მძინარე" და 
Generate the inflected form for the lemma: "მძინარე", according to the following morphological descriptions: "ADJ;INS(PL)"	მძინარე". მძ
Generate the inflected form for the lemma: "მძინარე", according to the following morphological descriptions: "ADJ;INS(SG)"	მძინარე" და 
Generate the inflected form for the lemma: "მძინარე", according to the following morphological descriptions: "ADJ;NOM(PL)"	ანალიტიკა
Ge
Generate the inflected form for the lemma: "მძინარე", according to the following morphological descriptions: "ADJ;NOM(PL;LGSPEC2)"	მძინარე მძ
Generate the inflected form for the lemma: "მძინარე", according to the following morphological descriptions: "ADJ;NOM(SG)"	მძინარე" და 
Generate the inflected form for the lemma: "მძინარე", according to the following morphological descriptions: "ADJ;VOC(PL)"	მძინარე". მძ
Generate the inflected form for the lemma: "მძინარე", according to the following morphological descriptions: "ADJ;VOC(PL;LGSPEC2)"	მძინარე" და 
Generate the inflected form for the lemma: "მძინარე", according to the following morphological descriptions: "ADJ;VOC(SG)"	მძინარე" და 
Generate the inflected form for the lemma: "ნამდვილი", according to the following morphological descriptions: "ADJ;DAT(PL)"	ისტორის მო
Generate the inflected form for the lemma: "ნამდვილი", according to the following morphological descriptions: "ADJ;DAT(PL;LGSPEC2)"	ისტორის მო
Generate the inflected form for the lemma: "ნამდვილი", according to the following morphological descriptions: "ADJ;DAT(SG)"	ნამდვილი" დ
Generate the inflected form for the lemma: "ნამდვილი", according to the following morphological descriptions: "ADJ;ERG(PL)"	ისტორისა დ
Generate the inflected form for the lemma: "ნამდვილი", according to the following morphological descriptions: "ADJ;ERG(PL;LGSPEC2)"	ისტორის მო
Generate the inflected form for the lemma: "ნამდვილი", according to the following morphological descriptions: "ADJ;ERG(SG)"	ნამდვილი" დ
Generate the inflected form for the lemma: "ნამდვილი", according to the following morphological descriptions: "ADJ;FRML(PL)"	ისტორის მო
Generate the inflected form for the lemma: "ნამდვილი", according to the following morphological descriptions: "ADJ;FRML(SG)"	ნამდვილი"ნ
Generate the inflected form for the lemma: "ნამდვილი", according to the following morphological descriptions: "ADJ;GEN(PL)"	ისტორისა დ
Generate the inflected form for the lemma: "ნამდვილი", according to the following morphological descriptions: "ADJ;GEN(PL;LGSPEC2)"	ისტორის მო
Generate the inflected form for the lemma: "ნამდვილი", according to the following morphological descriptions: "ADJ;GEN(SG)"	ნამდვილი". Gen
Generate the inflected form for the lemma: "ნამდვილი", according to the following morphological descriptions: "ADJ;INS(PL)"	ისტორისა დ
Generate the inflected form for the lemma: "ნამდვილი", according to the following morphological descriptions: "ADJ;INS(SG)"	ნამდვილი". Gen
Generate the inflected form for the lemma: "ნამდვილი", according to the following morphological descriptions: "ADJ;NOM(PL)"	ისტორისა დ
Generate the inflected form for the lemma: "ნამდვილი", according to the following morphological descriptions: "ADJ;NOM(PL;LGSPEC2)"	ისტორის მო
Generate the inflected form for the lemma: "ნამდვილი", according to the following morphological descriptions: "ADJ;NOM(SG)"	ნამდვილი" დ
Generate the inflected form for the lemma: "ნამდვილი", according to the following morphological descriptions: "ADJ;VOC(PL)"	ისტორის მო
Generate the inflected form for the lemma: "ნამდვილი", according to the following morphological descriptions: "ADJ;VOC(PL;LGSPEC2)"	ისტორის მო
Generate the inflected form for the lemma: "ნამდვილი", according to the following morphological descriptions: "ADJ;VOC(SG)"	ისტორის მო
Generate the inflected form for the lemma: "ოლქი", according to the following morphological descriptions: "N;DAT(PL)"	ოლქი ოლქი ო
Generate the inflected form for the lemma: "ოლქი", according to the following morphological descriptions: "N;DAT(PL;LGSPEC2)"	ისი ოლქი ოლ
Generate the inflected form for the lemma: "ოლქი", according to the following morphological descriptions: "N;DAT(SG)"	ოლქი ოლქი ო
Generate the inflected form for the lemma: "ოლქი", according to the following morphological descriptions: "N;ERG(PL)"	ოლქი ოლქი ო
Generate the inflected form for the lemma: "ოლქი", according to the following morphological descriptions: "N;ERG(PL;LGSPEC2)"	ისი ოლქი ოლ
Generate the inflected form for the lemma: "ოლქი", according to the following morphological descriptions: "N;ERG(SG)"	ლიგანი ოლქ
Generate the inflected form for the lemma: "ოლქი", according to the following morphological descriptions: "N;FRML(PL)"	ოლქი ოლქი ო
Generate the inflected form for the lemma: "ოლქი", according to the following morphological descriptions: "N;FRML(SG)"	ოლქი ოლქი ო
Generate the inflected form for the lemma: "ოლქი", according to the following morphological descriptions: "N;GEN(PL)"	ოლქი" ოლქი ო
Generate the inflected form for the lemma: "ოლქი", according to the following morphological descriptions: "N;GEN(PL;LGSPEC2)"	ისი ოლქი ოლ
Generate the inflected form for the lemma: "ოლქი", according to the following morphological descriptions: "N;GEN(SG)"	ლიგა ოლქი ო
Generate the inflected form for the lemma: "ოლქი", according to the following morphological descriptions: "N;INS(PL)"	ისი ოლქი ოლ
Generate the inflected form for the lemma: "ოლქი", according to the following morphological descriptions: "N;INS(SG)"	ლიგა ოლქი ო
Generate the inflected form for the lemma: "ოლქი", according to the following morphological descriptions: "N;NOM(PL)"	ოლქი ოლქი ო
Generate the inflected form for the lemma: "ოლქი", according to the following morphological descriptions: "N;NOM(PL;LGSPEC2)"	ისი ოლქი ოლ
Generate the inflected form for the lemma: "ოლქი", according to the following morphological descriptions: "N;NOM(SG)"	ოლქი ოლქი ო
Generate the inflected form for the lemma: "ოლქი", according to the following morphological descriptions: "N;VOC(PL)"	ოლქი" და "ოლ
Generate the inflected form for the lemma: "ოლქი", according to the following morphological descriptions: "N;VOC(PL;LGSPEC2)"	ოლქი ოლქი ო
Generate the inflected form for the lemma: "ოლქი", according to the following morphological descriptions: "N;VOC(SG)"	ოლქი ოლქი ო
Generate the inflected form for the lemma: "სამერცხული", according to the following morphological descriptions: "N;DAT(PL)"	ისი" და "სამ
Generate the inflected form for the lemma: "სამერცხული", according to the following morphological descriptions: "N;DAT(PL;LGSPEC2)"	ისიის მეცნ
Generate the inflected form for the lemma: "სამერცხული", according to the following morphological descriptions: "N;DAT(SG)"	ისი"სამერც
Generate the inflected form for the lemma: "სამერცხული", according to the following morphological descriptions: "N;ERG(PL)"	ისი" და "სამ
Generate the inflected form for the lemma: "სამერცხული", according to the following morphological descriptions: "N;ERG(PL;LGSPEC2)"	ისი მონაცე
Generate the inflected form for the lemma: "სამერცხული", according to the following morphological descriptions: "N;ERG(SG)"	ისი" და "სამ
Generate the inflected form for the lemma: "სამერცხული", according to the following morphological descriptions: "N;FRML(PL)"	სამერცხული
Generate the inflected form for the lemma: "სამერცხული", according to the following morphological descriptions: "N;FRML(SG)"	ისი"სამერც
Generate the inflected form for the lemma: "სამერცხული", according to the following morphological descriptions: "N;GEN(PL)"	ისი" სამერც
Generate the inflected form for the lemma: "სამერცხული", according to the following morphological descriptions: "N;GEN(PL;LGSPEC2)"	ისი" სამერც
Generate the inflected form for the lemma: "სამერცხული", according to the following morphological descriptions: "N;GEN(SG)"	ისი" სამერც
Generate the inflected form for the lemma: "სამერცხული", according to the following morphological descriptions: "N;INS(PL)"	ისი" და "სამ
Generate the inflected form for the lemma: "სამერცხული", according to the following morphological descriptions: "N;INS(SG)"	ისი"სამერც
Generate the inflected form for the lemma: "სამერცხული", according to the following morphological descriptions: "N;NOM(PL)"	ისი" და "სამ
Generate the inflected form for the lemma: "სამერცხული", according to the following morphological descriptions: "N;NOM(PL;LGSPEC2)"	ისი" და "სამ
Generate the inflected form for the lemma: "სამერცხული", according to the following morphological descriptions: "N;NOM(SG)"	ისი"სამერც
Generate the inflected form for the lemma: "სამერცხული", according to the following morphological descriptions: "N;VOC(PL)"	ისი" და "სამ
Generate the inflected form for the lemma: "სამერცხული", according to the following morphological descriptions: "N;VOC(PL;LGSPEC2)"	ისიის მეფე
Generate the inflected form for the lemma: "სამერცხული", according to the following morphological descriptions: "N;VOC(SG)"	ისი" და "სამ
Generate the inflected form for the lemma: "სარჩელი", according to the following morphological descriptions: "N;DAT(PL)"	სარჩელი სა
Generate the inflected form for the lemma: "სარჩელი", according to the following morphological descriptions: "N;DAT(PL;LGSPEC2)"	სარჩელი სა
Generate the inflected form for the lemma: "სარჩელი", according to the following morphological descriptions: "N;DAT(SG)"	სარჩელი სა
Generate the inflected form for the lemma: "სარჩელი", according to the following morphological descriptions: "N;ERG(PL)"	სარჩელი
სა
Generate the inflected form for the lemma: "სარჩელი", according to the following morphological descriptions: "N;ERG(PL;LGSPEC2)"	სარჩელი სა
Generate the inflected form for the lemma: "სარჩელი", according to the following morphological descriptions: "N;ERG(SG)"	სარჩელი
სა
Generate the inflected form for the lemma: "სარჩელი", according to the following morphological descriptions: "N;FRML(PL)"	სარჩელი
სა
Generate the inflected form for the lemma: "სარჩელი", according to the following morphological descriptions: "N;FRML(SG)"	სარჩელი
სა
Generate the inflected form for the lemma: "სარჩელი", according to the following morphological descriptions: "N;GEN(PL)"	სარჩელი
Generate
Generate the inflected form for the lemma: "სარჩელი", according to the following morphological descriptions: "N;GEN(PL;LGSPEC2)"	ისტორის სა
Generate the inflected form for the lemma: "სარჩელი", according to the following morphological descriptions: "N;GEN(SG)"	სარჩელი
Generate
Generate the inflected form for the lemma: "სარჩელი", according to the following morphological descriptions: "N;INS(PL)"	სარჩელი
სა
Generate the inflected form for the lemma: "სარჩელი", according to the following morphological descriptions: "N;INS(SG)"	სარჩელი
სა
Generate the inflected form for the lemma: "სარჩელი", according to the following morphological descriptions: "N;NOM(PL)"	სარჩელი სა
Generate the inflected form for the lemma: "სარჩელი", according to the following morphological descriptions: "N;NOM(PL;LGSPEC2)"	სარჩელი სა
Generate the inflected form for the lemma: "სარჩელი", according to the following morphological descriptions: "N;NOM(SG)"	სარჩელი სა
Generate the inflected form for the lemma: "სარჩელი", according to the following morphological descriptions: "N;VOC(PL)"	სარჩელი
სა
Generate the inflected form for the lemma: "სარჩელი", according to the following morphological descriptions: "N;VOC(PL;LGSPEC2)"	სარჩელი
სა
Generate the inflected form for the lemma: "სარჩელი", according to the following morphological descriptions: "N;VOC(SG)"	სარჩელი
სა
Generate the inflected form for the lemma: "საწყალი", according to the following morphological descriptions: "ADJ;DAT(PL)"	ისი" და "საწ
Generate the inflected form for the lemma: "საწყალი", according to the following morphological descriptions: "ADJ;DAT(PL;LGSPEC2)"	ალადენი
სა
Generate the inflected form for the lemma: "საწყალი", according to the following morphological descriptions: "ADJ;DAT(SG)"	ისისისისის
Generate the inflected form for the lemma: "საწყალი", according to the following morphological descriptions: "ADJ;ERG(PL)"	ისისისისის
Generate the inflected form for the lemma: "საწყალი", according to the following morphological descriptions: "ADJ;ERG(PL;LGSPEC2)"	ისი საწყალ
Generate the inflected form for the lemma: "საწყალი", according to the following morphological descriptions: "ADJ;ERG(SG)"	ისი საწყალ
Generate the inflected form for the lemma: "საწყალი", according to the following morphological descriptions: "ADJ;FRML(PL)"	ისი საწყალ
Generate the inflected form for the lemma: "საწყალი", according to the following morphological descriptions: "ADJ;FRML(SG)"	ისი საწყალ
Generate the inflected form for the lemma: "საწყალი", according to the following morphological descriptions: "ADJ;GEN(PL)"	ისისისისის
Generate the inflected form for the lemma: "საწყალი", according to the following morphological descriptions: "ADJ;GEN(PL;LGSPEC2)"	ისი საწყალ
Generate the inflected form for the lemma: "საწყალი", according to the following morphological descriptions: "ADJ;GEN(SG)"	ისი საწყალ
Generate the inflected form for the lemma: "საწყალი", according to the following morphological descriptions: "ADJ;INS(PL)"	ისი" და "საწ
Generate the inflected form for the lemma: "საწყალი", according to the following morphological descriptions: "ADJ;INS(SG)"	ისი საწყალ
Generate the inflected form for the lemma: "საწყალი", according to the following morphological descriptions: "ADJ;NOM(PL)"	ისი" და "საწ
Generate the inflected form for the lemma: "საწყალი", according to the following morphological descriptions: "ADJ;NOM(PL;LGSPEC2)"	ისი საწყალ
Generate the inflected form for the lemma: "საწყალი", according to the following morphological descriptions: "ADJ;NOM(SG)"	ისი საწყალ
Generate the inflected form for the lemma: "საწყალი", according to the following morphological descriptions: "ADJ;VOC(PL)"	ისისისისის
Generate the inflected form for the lemma: "საწყალი", according to the following morphological descriptions: "ADJ;VOC(PL;LGSPEC2)"	ისისისისის
Generate the inflected form for the lemma: "საწყალი", according to the following morphological descriptions: "ADJ;VOC(SG)"	ისი საწყალ
Generate the inflected form for the lemma: "სკანერი", according to the following morphological descriptions: "N;DAT(PL)"	სკანერი
სკ
Generate the inflected form for the lemma: "სკანერი", according to the following morphological descriptions: "N;DAT(PL;LGSPEC2)"	სკანერი სკ
Generate the inflected form for the lemma: "სკანერი", according to the following morphological descriptions: "N;DAT(SG)"	სკანერი სკ
Generate the inflected form for the lemma: "სკანერი", according to the following morphological descriptions: "N;ERG(PL)"	სკანერი სკ
Generate the inflected form for the lemma: "სკანერი", according to the following morphological descriptions: "N;ERG(PL;LGSPEC2)"	სკანერი სკ
Generate the inflected form for the lemma: "სკანერი", according to the following morphological descriptions: "N;ERG(SG)"	ისი სკანერ
Generate the inflected form for the lemma: "სკანერი", according to the following morphological descriptions: "N;FRML(PL)"	სკანერი სკ
Generate the inflected form for the lemma: "სკანერი", according to the following morphological descriptions: "N;FRML(SG)"	სკანერი სკ
Generate the inflected form for the lemma: "სკანერი", according to the following morphological descriptions: "N;GEN(PL)"	სკანერი
სკ
Generate the inflected form for the lemma: "სკანერი", according to the following morphological descriptions: "N;GEN(PL;LGSPEC2)"	სკანერი სკ
Generate the inflected form for the lemma: "სკანერი", according to the following morphological descriptions: "N;GEN(SG)"	სკანერი სკ
Generate the inflected form for the lemma: "სკანერი", according to the following morphological descriptions: "N;INS(PL)"	სკანერი
სკ
Generate the inflected form for the lemma: "სკანერი", according to the following morphological descriptions: "N;INS(SG)"	სკანერი სკ
Generate the inflected form for the lemma: "სკანერი", according to the following morphological descriptions: "N;NOM(PL)"	სკანერი სკ
Generate the inflected form for the lemma: "სკანერი", according to the following morphological descriptions: "N;NOM(PL;LGSPEC2)"	სკანერი
სკ
Generate the inflected form for the lemma: "სკანერი", according to the following morphological descriptions: "N;NOM(SG)"	სკანერი სკ
Generate the inflected form for the lemma: "სკანერი", according to the following morphological descriptions: "N;VOC(PL)"	სკანერი სკ
Generate the inflected form for the lemma: "სკანერი", according to the following morphological descriptions: "N;VOC(PL;LGSPEC2)"	სკანერი
სკ
Generate the inflected form for the lemma: "სკანერი", according to the following morphological descriptions: "N;VOC(SG)"	სკანერი სკ
Generate the inflected form for the lemma: "ტექტონა", according to the following morphological descriptions: "N;DAT(PL)"	ანგარიში ტ
Generate the inflected form for the lemma: "ტექტონა", according to the following morphological descriptions: "N;DAT(PL;LGSPEC2)"	ტექტონა ტე
Generate the inflected form for the lemma: "ტექტონა", according to the following morphological descriptions: "N;ERG(PL)"	ანგარიში ტ
Generate the inflected form for the lemma: "ტექტონა", according to the following morphological descriptions: "N;ERG(PL;LGSPEC2)"	ტექტონა ტე
Generate the inflected form for the lemma: "ტექტონა", according to the following morphological descriptions: "N;ERG(SG)"	ტექტონა ტე
Generate the inflected form for the lemma: "ტექტონა", according to the following morphological descriptions: "N;FRML(PL)"	ანგარიში ტ
Generate the inflected form for the lemma: "ტექტონა", according to the following morphological descriptions: "N;FRML(SG)"	ანგარიში ტ
Generate the inflected form for the lemma: "ტექტონა", according to the following morphological descriptions: "N;GEN(PL)"	ანგარიში დ
Generate the inflected form for the lemma: "ტექტონა", according to the following morphological descriptions: "N;GEN(PL;LGSPEC2)"	ტექტონა ტე
Generate the inflected form for the lemma: "ტექტონა", according to the following morphological descriptions: "N;GEN(SG)"	ანგარიში ტ
Generate the inflected form for the lemma: "ტექტონა", according to the following morphological descriptions: "N;INS(PL)"	ანგარიში ტ
Generate the inflected form for the lemma: "ტექტონა", according to the following morphological descriptions: "N;INS(SG)"	ტექტონა ტე
Generate the inflected form for the lemma: "ტექტონა", according to the following morphological descriptions: "N;NOM(PL)"	ანგარიში ტ
Generate the inflected form for the lemma: "ტექტონა", according to the following morphological descriptions: "N;NOM(PL;LGSPEC2)"	ტექტონა ტე
Generate the inflected form for the lemma: "ტექტონა", according to the following morphological descriptions: "N;NOM(SG)"	ანგარიში ტ
Generate the inflected form for the lemma: "ტექტონა", according to the following morphological descriptions: "N;VOC(PL)"	ანგარიში ტ
Generate the inflected form for the lemma: "ტექტონა", according to the following morphological descriptions: "N;VOC(PL;LGSPEC2)"	ტექტონა ტე
Generate the inflected form for the lemma: "უტყვი", according to the following morphological descriptions: "ADJ;DAT(PL)"	ინტერვიუ უ
Generate the inflected form for the lemma: "უტყვი", according to the following morphological descriptions: "ADJ;DAT(PL;LGSPEC2)"	ინტერვიული
Generate the inflected form for the lemma: "უტყვი", according to the following morphological descriptions: "ADJ;DAT(SG)"	ისი უტყვი უ
Generate the inflected form for the lemma: "უტყვი", according to the following morphological descriptions: "ADJ;ERG(PL)"	ისი უტყვი
უ
Generate the inflected form for the lemma: "უტყვი", according to the following morphological descriptions: "ADJ;ERG(PL;LGSPEC2)"	ინტერვიული
Generate the inflected form for the lemma: "უტყვი", according to the following morphological descriptions: "ADJ;ERG(SG)"	ინტერში უტ
Generate the inflected form for the lemma: "უტყვი", according to the following morphological descriptions: "ADJ;FRML(PL)"	ინტერვიუ უ
Generate the inflected form for the lemma: "უტყვი", according to the following morphological descriptions: "ADJ;FRML(SG)"	ინტერვიული
Generate the inflected form for the lemma: "უტყვი", according to the following morphological descriptions: "ADJ;GEN(PL)"	უტყვი უტყვ
Generate the inflected form for the lemma: "უტყვი", according to the following morphological descriptions: "ADJ;GEN(PL;LGSPEC2)"	ინტერვიული
Generate the inflected form for the lemma: "უტყვი", according to the following morphological descriptions: "ADJ;GEN(SG)"	ინტერვიუში
Generate the inflected form for the lemma: "უტყვი", according to the following morphological descriptions: "ADJ;INS(PL)"	ინტერვიუ უ
Generate the inflected form for the lemma: "უტყვი", according to the following morphological descriptions: "ADJ;INS(SG)"	ინტერში უნ
Generate the inflected form for the lemma: "უტყვი", according to the following morphological descriptions: "ADJ;NOM(PL)"	უტყვი" and "უტ
Generate the inflected form for the lemma: "უტყვი", according to the following morphological descriptions: "ADJ;NOM(PL;LGSPEC2)"	უტყვი უტყვ
Generate the inflected form for the lemma: "უტყვი", according to the following morphological descriptions: "ADJ;NOM(SG)"	უტყვი" and "უტ
Generate the inflected form for the lemma: "უტყვი", according to the following morphological descriptions: "ADJ;VOC(PL)"	ინტერვიუ უ
Generate the inflected form for the lemma: "უტყვი", according to the following morphological descriptions: "ADJ;VOC(PL;LGSPEC2)"	უტყვი" and "უტ
Generate the inflected form for the lemma: "უტყვი", according to the following morphological descriptions: "ADJ;VOC(SG)"	ინტერვიული
Generate the inflected form for the lemma: "ფრაზა", according to the following morphological descriptions: "N;DAT(PL)"	ფრაზა ფრაზ
Generate the inflected form for the lemma: "ფრაზა", according to the following morphological descriptions: "N;DAT(PL;LGSPEC2)"	ისი ფრაზა
ფ
Generate the inflected form for the lemma: "ფრაზა", according to the following morphological descriptions: "N;DAT(SG)"	აზია აზია ა
Generate the inflected form for the lemma: "ფრაზა", according to the following morphological descriptions: "N;ERG(PL)"	არქივი ფრა
Generate the inflected form for the lemma: "ფრაზა", according to the following morphological descriptions: "N;ERG(PL;LGSPEC2)"	ისი ფრაზა
ფ
Generate the inflected form for the lemma: "ფრაზა", according to the following morphological descriptions: "N;ERG(SG)"	აზია ფრაზა 
Generate the inflected form for the lemma: "ფრაზა", according to the following morphological descriptions: "N;FRML(PL)"	ის ფრაზა ფრ
Generate the inflected form for the lemma: "ფრაზა", according to the following morphological descriptions: "N;FRML(SG)"	ისი ფრაზა
ფ
Generate the inflected form for the lemma: "ფრაზა", according to the following morphological descriptions: "N;GEN(PL)"	ის ფრაზა ფრ
Generate the inflected form for the lemma: "ფრაზა", according to the following morphological descriptions: "N;GEN(PL;LGSPEC2)"	აზის მოწევ
Generate the inflected form for the lemma: "ფრაზა", according to the following morphological descriptions: "N;GEN(SG)"	აზია აზია ა
Generate the inflected form for the lemma: "ფრაზა", according to the following morphological descriptions: "N;INS(PL)"	ფრაზა ფრაზ
Generate the inflected form for the lemma: "ფრაზა", according to the following morphological descriptions: "N;INS(SG)"	ისი ფრაზა
ფ
Generate the inflected form for the lemma: "ფრაზა", according to the following morphological descriptions: "N;NOM(PL)"	ანგარიში ფ
Generate the inflected form for the lemma: "ფრაზა", according to the following morphological descriptions: "N;NOM(PL;LGSPEC2)"	აზია ფრაზა 
Generate the inflected form for the lemma: "ფრაზა", according to the following morphological descriptions: "N;NOM(SG)"	ფრაზა ფრაზ
Generate the inflected form for the lemma: "ფრაზა", according to the following morphological descriptions: "N;VOC(PL)"	აზია ფრაზა 
Generate the inflected form for the lemma: "ფრაზა", according to the following morphological descriptions: "N;VOC(PL;LGSPEC2)"	ის ფრაზა არ
Generate the inflected form for the lemma: "ფრაზა", according to the following morphological descriptions: "N;VOC(SG)"	აზია მელიქ
Generate the inflected form for the lemma: "ღერო", according to the following morphological descriptions: "N;DAT(PL)"	ღერო ღერო ღ
Generate the inflected form for the lemma: "ღერო", according to the following morphological descriptions: "N;DAT(PL;LGSPEC2)"	ღერო ღერო ღ
Generate the inflected form for the lemma: "ღერო", according to the following morphological descriptions: "N;DAT(SG)"	ღერო ღერო ღ
Generate the inflected form for the lemma: "ღერო", according to the following morphological descriptions: "N;ERG(PL)"	ღერო ღერო ღ
Generate the inflected form for the lemma: "ღერო", according to the following morphological descriptions: "N;ERG(PL;LGSPEC2)"	ღერო ღერო ღ
Generate the inflected form for the lemma: "ღერო", according to the following morphological descriptions: "N;ERG(SG)"	ღერო ღერო ღ
Generate the inflected form for the lemma: "ღერო", according to the following morphological descriptions: "N;FRML(PL)"	ღერო ღერო ღ
Generate the inflected form for the lemma: "ღერო", according to the following morphological descriptions: "N;FRML(SG)"	ღერო ღერო ღ
Generate the inflected form for the lemma: "ღერო", according to the following morphological descriptions: "N;GEN(PL)"	ღერო ღერო ღ
Generate the inflected form for the lemma: "ღერო", according to the following morphological descriptions: "N;GEN(PL;LGSPEC2)"	ღერო ღერო ღ
Generate the inflected form for the lemma: "ღერო", according to the following morphological descriptions: "N;GEN(SG)"	ღერო ღერო ღ
Generate the inflected form for the lemma: "ღერო", according to the following morphological descriptions: "N;INS(PL)"	ღერო ღერო ღ
Generate the inflected form for the lemma: "ღერო", according to the following morphological descriptions: "N;INS(SG)"	ღერო ღერო ღ
Generate the inflected form for the lemma: "ღერო", according to the following morphological descriptions: "N;NOM(PL)"	ღერო ღერო ღ
Generate the inflected form for the lemma: "ღერო", according to the following morphological descriptions: "N;NOM(PL;LGSPEC2)"	ღერო ღერო ღ
Generate the inflected form for the lemma: "ღერო", according to the following morphological descriptions: "N;NOM(SG)"	ღერო ღერო ღ
Generate the inflected form for the lemma: "ღერო", according to the following morphological descriptions: "N;VOC(PL)"	ღერო ღერო ღ
Generate the inflected form for the lemma: "ღერო", according to the following morphological descriptions: "N;VOC(PL;LGSPEC2)"	ღერო ღერო ღ
Generate the inflected form for the lemma: "ღერო", according to the following morphological descriptions: "N;VOC(SG)"	ღერო ღერო ღ
Generate the inflected form for the lemma: "ყვერული", according to the following morphological descriptions: "N;DAT(PL)"	ისი ყვერულ
Generate the inflected form for the lemma: "ყვერული", according to the following morphological descriptions: "N;DAT(PL;LGSPEC2)"	ისი ყვერულ
Generate the inflected form for the lemma: "ყვერული", according to the following morphological descriptions: "N;DAT(SG)"	ისი ყვერულ
Generate the inflected form for the lemma: "ყვერული", according to the following morphological descriptions: "N;ERG(PL)"	ისი სახელი 
Generate the inflected form for the lemma: "ყვერული", according to the following morphological descriptions: "N;ERG(PL;LGSPEC2)"	ისი სახელი 
Generate the inflected form for the lemma: "ყვერული", according to the following morphological descriptions: "N;ERG(SG)"	ისი სახელი 
Generate the inflected form for the lemma: "ყვერული", according to the following morphological descriptions: "N;FRML(PL)"	ისი ყვერულ
Generate the inflected form for the lemma: "ყვერული", according to the following morphological descriptions: "N;FRML(SG)"	ისი ყვერულ
Generate the inflected form for the lemma: "ყვერული", according to the following morphological descriptions: "N;GEN(PL)"	ისი ყვერულ
Generate the inflected form for the lemma: "ყვერული", according to the following morphological descriptions: "N;GEN(PL;LGSPEC2)"	ისი ყვერულ
Generate the inflected form for the lemma: "ყვერული", according to the following morphological descriptions: "N;GEN(SG)"	ისი ყვერულ
Generate the inflected form for the lemma: "ყვერული", according to the following morphological descriptions: "N;INS(PL)"	ისი ყვერულ
Generate the inflected form for the lemma: "ყვერული", according to the following morphological descriptions: "N;INS(SG)"	ისი ყვერულ
Generate the inflected form for the lemma: "ყვერული", according to the following morphological descriptions: "N;NOM(PL)"	ისიის მეფი
Generate the inflected form for the lemma: "ყვერული", according to the following morphological descriptions: "N;NOM(PL;LGSPEC2)"	ისი ყვერულ
Generate the inflected form for the lemma: "ყვერული", according to the following morphological descriptions: "N;NOM(SG)"	ისი ყვერულ
Generate the inflected form for the lemma: "ყვერული", according to the following morphological descriptions: "N;VOC(PL)"	ისი ყვერულ
Generate the inflected form for the lemma: "ყვერული", according to the following morphological descriptions: "N;VOC(PL;LGSPEC2)"	ისი ყვერულ
Generate the inflected form for the lemma: "ყვერული", according to the following morphological descriptions: "N;VOC(SG)"	ისი ყვერულ
Generate the inflected form for the lemma: "შხაპი", according to the following morphological descriptions: "N;DAT(PL)"	შხაპი შხაპ
Generate the inflected form for the lemma: "შხაპი", according to the following morphological descriptions: "N;DAT(PL;LGSPEC2)"	ის შხაპი შე
Generate the inflected form for the lemma: "შხაპი", according to the following morphological descriptions: "N;DAT(SG)"	შხაპი შხაპ
Generate the inflected form for the lemma: "შხაპი", according to the following morphological descriptions: "N;ERG(PL)"	შხაპი შხაპ
Generate the inflected form for the lemma: "შხაპი", according to the following morphological descriptions: "N;ERG(PL;LGSPEC2)"	შხაპი შხაპ
Generate the inflected form for the lemma: "შხაპი", according to the following morphological descriptions: "N;ERG(SG)"	შხაპი შხაპ
Generate the inflected form for the lemma: "შხაპი", according to the following morphological descriptions: "N;FRML(PL)"	შხაპი შხაპ
Generate the inflected form for the lemma: "შხაპი", according to the following morphological descriptions: "N;FRML(SG)"	შხაპი შხაპ
Generate the inflected form for the lemma: "შხაპი", according to the following morphological descriptions: "N;GEN(PL)"	ისი შხაპი შ
Generate the inflected form for the lemma: "შხაპი", according to the following morphological descriptions: "N;GEN(PL;LGSPEC2)"	შხაპი შხაპ
Generate the inflected form for the lemma: "შხაპი", according to the following morphological descriptions: "N;GEN(SG)"	ის შხაპი შე
Generate the inflected form for the lemma: "შხაპი", according to the following morphological descriptions: "N;INS(PL)"	შხაპი შხაპ
Generate the inflected form for the lemma: "შხაპი", according to the following morphological descriptions: "N;INS(SG)"	შხაპი შხაპ
Generate the inflected form for the lemma: "შხაპი", according to the following morphological descriptions: "N;NOM(PL)"	ისი შხაპი შ
Generate the inflected form for the lemma: "შხაპი", according to the following morphological descriptions: "N;NOM(PL;LGSPEC2)"	ის შხაპი შე
Generate the inflected form for the lemma: "შხაპი", according to the following morphological descriptions: "N;NOM(SG)"	ის შხაპი შე
Generate the inflected form for the lemma: "შხაპი", according to the following morphological descriptions: "N;VOC(PL)"	ისი შხაპი შ
Generate the inflected form for the lemma: "შხაპი", according to the following morphological descriptions: "N;VOC(PL;LGSPEC2)"	შხაპი შხაპ
Generate the inflected form for the lemma: "შხაპი", according to the following morphological descriptions: "N;VOC(SG)"	შხაპი შხაპ
Generate the inflected form for the lemma: "ჩქარობს", according to the following morphological descriptions: "V;COND;NOM(3,PL)"	არაულის მო
Generate the inflected form for the lemma: "ჩქარობს", according to the following morphological descriptions: "V;COND;NOM(3,SG)"	არაფერს და 
Generate the inflected form for the lemma: "ჩქარობს", according to the following morphological descriptions: "V;IND;FUT;NOM(2,SG)"	არაფერს ამ
Generate the inflected form for the lemma: "ჩქარობს", according to the following morphological descriptions: "V;IND;FUT;NOM(3,PL)"	არაულობს ჩ
Generate the inflected form for the lemma: "ჩქარობს", according to the following morphological descriptions: "V;IND;FUT;NOM(3,SG)"	არაფერს არ 
Generate the inflected form for the lemma: "ჩქარობს", according to the following morphological descriptions: "V;IND;IPFV;NOM(1,PL)"	არაფერს ამ
Generate the inflected form for the lemma: "ჩქარობს", according to the following morphological descriptions: "V;IND;IPFV;NOM(3,PL)"	არაფერს და 
Generate the inflected form for the lemma: "ჩქარობს", according to the following morphological descriptions: "V;IND;IPFV;NOM(3,SG)"	არაფერს ამ
Generate the inflected form for the lemma: "ჩქარობს", according to the following morphological descriptions: "V;IND;PRF;NOM(2,PL)"	არაფერს და
Generate the inflected form for the lemma: "ჩქარობს", according to the following morphological descriptions: "V;IND;PRF;NOM(2,SG)"	არაფერს ამ
Generate the inflected form for the lemma: "ჩქარობს", according to the following morphological descriptions: "V;IND;PRS;NOM(3,PL)"	არაფერს და 
Generate the inflected form for the lemma: "ჩქარობს", according to the following morphological descriptions: "V;IND;PST;PFV;NOM(1,PL)"	არაფერს ამ
Generate the inflected form for the lemma: "ჩქარობს", according to the following morphological descriptions: "V;IND;PST;PFV;NOM(1,SG)"	არაფერს ამ
Generate the inflected form for the lemma: "ჩქარობს", according to the following morphological descriptions: "V;IND;PST;PFV;NOM(3,PL)"	არაფერს და 
Generate the inflected form for the lemma: "ჩქარობს", according to the following morphological descriptions: "V;IND;PST;PRF;NOM(1,PL)"	არაულის მო
Generate the inflected form for the lemma: "ჩქარობს", according to the following morphological descriptions: "V;IND;PST;PRF;NOM(3,SG)"	არაფერს ამ
Generate the inflected form for the lemma: "ჩქარობს", according to the following morphological descriptions: "V;OPT;NOM(1,PL)"	არაულის მო
Generate the inflected form for the lemma: "ჩქარობს", according to the following morphological descriptions: "V;SBJV;FUT;NOM(1,SG)"	ისის ჩქარო
Generate the inflected form for the lemma: "ჩქარობს", according to the following morphological descriptions: "V;SBJV;FUT;NOM(2,PL)"	ისი ჩქარობ
Generate the inflected form for the lemma: "ჩქარობს", according to the following morphological descriptions: "V;SBJV;FUT;NOM(3,PL)"	ისი ჩქარობ
Generate the inflected form for the lemma: "ჩქარობს", according to the following morphological descriptions: "V;SBJV;FUT;NOM(3,SG)"	ისი ჩქარობ
Generate the inflected form for the lemma: "ჩქარობს", according to the following morphological descriptions: "V;SBJV;PRF;NOM(2,SG)"	ისი ჩქარობ
Generate the inflected form for the lemma: "ჩქარობს", according to the following morphological descriptions: "V;SBJV;PRF;NOM(3,PL)"	არაფერს და 
Generate the inflected form for the lemma: "ჩქარობს", according to the following morphological descriptions: "V;SBJV;PRS;NOM(2,PL)"	ისი ჩქარობ
Generate the inflected form for the lemma: "ჩქარობს", according to the following morphological descriptions: "V;SBJV;PRS;NOM(2,SG)"	ისი ჩქარობ
Generate the inflected form for the lemma: "ჩქარობს", according to the following morphological descriptions: "V;SBJV;PRS;NOM(3,PL)"	ისი ჩქარობ
Generate the inflected form for the lemma: "ცერობი", according to the following morphological descriptions: "N;DAT(PL)"	ცერობი
ცერ
Generate the inflected form for the lemma: "ცერობი", according to the following morphological descriptions: "N;DAT(PL;LGSPEC2)"	ცერობი
ცერ
Generate the inflected form for the lemma: "ცერობი", according to the following morphological descriptions: "N;DAT(SG)"	ცერობი
ცერ
Generate the inflected form for the lemma: "ცერობი", according to the following morphological descriptions: "N;ERG(PL)"	ცერობი
ცერ
Generate the inflected form for the lemma: "ცერობი", according to the following morphological descriptions: "N;ERG(PL;LGSPEC2)"	ცერობი
ცერ
Generate the inflected form for the lemma: "ცერობი", according to the following morphological descriptions: "N;ERG(SG)"	ცერობი ცერ
Generate the inflected form for the lemma: "ცერობი", according to the following morphological descriptions: "N;FRML(PL)"	ცერობი ცერ
Generate the inflected form for the lemma: "ცერობი", according to the following morphological descriptions: "N;FRML(SG)"	ცერობი ცერ
Generate the inflected form for the lemma: "ცერობი", according to the following morphological descriptions: "N;GEN(PL)"	ცერობი
ცერ
Generate the inflected form for the lemma: "ცერობი", according to the following morphological descriptions: "N;GEN(PL;LGSPEC2)"	ცერობი ცერ
Generate the inflected form for the lemma: "ცერობი", according to the following morphological descriptions: "N;GEN(SG)"	ცერობი
Generate th
Generate the inflected form for the lemma: "ცერობი", according to the following morphological descriptions: "N;INS(PL)"	ცერობი
ცერ
Generate the inflected form for the lemma: "ცერობი", according to the following morphological descriptions: "N;INS(SG)"	ცერობი
ცერ
Generate the inflected form for the lemma: "ცერობი", according to the following morphological descriptions: "N;NOM(PL)"	ცერობი ცერ
Generate the inflected form for the lemma: "ცერობი", according to the following morphological descriptions: "N;NOM(PL;LGSPEC2)"	ცერობი
ცერ
Generate the inflected form for the lemma: "ცერობი", according to the following morphological descriptions: "N;NOM(SG)"	ცერობი ცერ
Generate the inflected form for the lemma: "ცერობი", according to the following morphological descriptions: "N;VOC(PL)"	ცერობი
ცერ
Generate the inflected form for the lemma: "ცერობი", according to the following morphological descriptions: "N;VOC(PL;LGSPEC2)"	ცერობი
ცერ
Generate the inflected form for the lemma: "ცერობი", according to the following morphological descriptions: "N;VOC(SG)"	ცერობი ცერ
Generate the inflected form for the lemma: "ცური", according to the following morphological descriptions: "N;DAT(PL)"	ცური ცური ც
Generate the inflected form for the lemma: "ცური", according to the following morphological descriptions: "N;DAT(PL;LGSPEC2)"	ცური ცური ც
Generate the inflected form for the lemma: "ცური", according to the following morphological descriptions: "N;DAT(SG)"	ცური ცური ც
Generate the inflected form for the lemma: "ცური", according to the following morphological descriptions: "N;ERG(PL)"	ცური ცური ც
Generate the inflected form for the lemma: "ცური", according to the following morphological descriptions: "N;ERG(PL;LGSPEC2)"	ცური ცური ც
Generate the inflected form for the lemma: "ცური", according to the following morphological descriptions: "N;ERG(SG)"	ცური ცური ც
Generate the inflected form for the lemma: "ცური", according to the following morphological descriptions: "N;FRML(PL)"	ცური ცური ც
Generate the inflected form for the lemma: "ცური", according to the following morphological descriptions: "N;FRML(SG)"	ცური ცური ც
Generate the inflected form for the lemma: "ცური", according to the following morphological descriptions: "N;GEN(PL)"	ცური ცური ც
Generate the inflected form for the lemma: "ცური", according to the following morphological descriptions: "N;GEN(PL;LGSPEC2)"	ცური ცური ც
Generate the inflected form for the lemma: "ცური", according to the following morphological descriptions: "N;GEN(SG)"	ცური ცური ც
Generate the inflected form for the lemma: "ცური", according to the following morphological descriptions: "N;INS(PL)"	ცური ცური ც
Generate the inflected form for the lemma: "ცური", according to the following morphological descriptions: "N;INS(SG)"	ცური ცური ც
Generate the inflected form for the lemma: "ცური", according to the following morphological descriptions: "N;NOM(PL)"	ცური ცური ც
Generate the inflected form for the lemma: "ცური", according to the following morphological descriptions: "N;NOM(PL;LGSPEC2)"	ცური ცური ც
Generate the inflected form for the lemma: "ცური", according to the following morphological descriptions: "N;VOC(PL)"	ცური ცური ც
Generate the inflected form for the lemma: "ცური", according to the following morphological descriptions: "N;VOC(PL;LGSPEC2)"	ცური ცური ც
Generate the inflected form for the lemma: "ცური", according to the following morphological descriptions: "N;VOC(SG)"	ცური ცური ც
Generate the inflected form for the lemma: "წონის", according to the following morphological descriptions: "V;COND;NOM(1,PL);ACC(2,PL)"	წონის" და ამ
Generate the inflected form for the lemma: "წონის", according to the following morphological descriptions: "V;COND;NOM(1,PL);ACC(3,SG)"	წონის წონი
Generate the inflected form for the lemma: "წონის", according to the following morphological descriptions: "V;IND;IPFV;NOM(1,PL);ACC(2,PL)"	ის წონის წო
Generate the inflected form for the lemma: "წონის", according to the following morphological descriptions: "V;IND;IPFV;NOM(1,PL);ACC(3,SG)"	ის წონის წო
Generate the inflected form for the lemma: "წონის", according to the following morphological descriptions: "V;IND;IPFV;NOM(1,SG);ACC(3,PL)"	ის წონის წო
Generate the inflected form for the lemma: "წონის", according to the following morphological descriptions: "V;IND;IPFV;NOM(2,PL);ACC(3,PL)"	წონის წონი
Generate the inflected form for the lemma: "წონის", according to the following morphological descriptions: "V;IND;PRS;NOM(3,SG);ACC(2,SG)"	წონის წონი
Generate the inflected form for the lemma: "წონის", according to the following morphological descriptions: "V;IND;PRS;NOM(3,SG);ACC(3,PL)"	ანასარის წ
Generate the inflected form for the lemma: "წონის", according to the following morphological descriptions: "V;IND;PST;PFV;NOM(1,PL);ACC(3,SG)"	ის წონის წო
Generate the inflected form for the lemma: "წონის", according to the following morphological descriptions: "V;IND;PST;PFV;NOM(1,SG);ACC(2,PL)"	წონის წონი
Generate the inflected form for the lemma: "წონის", according to the following morphological descriptions: "V;IND;PST;PFV;NOM(1,SG);ACC(3,PL)"	წონის წონი
Generate the inflected form for the lemma: "წონის", according to the following morphological descriptions: "V;IND;PST;PFV;NOM(2,PL);ACC(1,PL)"	ანასარია წ
Generate the inflected form for the lemma: "წონის", according to the following morphological descriptions: "V;IND;PST;PFV;NOM(2,SG);ACC(1,PL)"	წონის წონი
Generate the inflected form for the lemma: "წონის", according to the following morphological descriptions: "V;IND;PST;PFV;NOM(3,SG);ACC(3,SG)"	ის წონის წო
Generate the inflected form for the lemma: "წონის", according to the following morphological descriptions: "V;IND;PST;PRF;NOM(1,PL);ACC(2,SG)"	ანალი 2019 წონ
Generate the inflected form for the lemma: "წონის", according to the following morphological descriptions: "V;OPT;NOM(2,SG);ACC(1,PL)"	ანასარის წ
Generate the inflected form for the lemma: "წონის", according to the following morphological descriptions: "V;OPT;NOM(3,PL);ACC(1,PL)"	ის წონის წო
Generate the inflected form for the lemma: "წონის", according to the following morphological descriptions: "V;OPT;NOM(3,PL);ACC(2,SG)"	ანგარიში წ
Generate the inflected form for the lemma: "წონის", according to the following morphological descriptions: "V;OPT;NOM(3,SG);ACC(2,PL)"	ანალი 2019 წონ
Generate the inflected form for the lemma: "წონის", according to the following morphological descriptions: "V;SBJV;FUT;NOM(1,SG);ACC(3,PL)"	წონის წონი
Generate the inflected form for the lemma: "წონის", according to the following morphological descriptions: "V;SBJV;FUT;NOM(3,PL);ACC(1,SG)"	წონის წონი
Generate the inflected form for the lemma: "წონის", according to the following morphological descriptions: "V;SBJV;FUT;NOM(3,SG);ACC(1,SG)"	წონის წონი
Generate the inflected form for the lemma: "წონის", according to the following morphological descriptions: "V;SBJV;PRF;NOM(1,PL);ACC(3,SG)"	წონის წონი
Generate the inflected form for the lemma: "წონის", according to the following morphological descriptions: "V;SBJV;PRF;NOM(2,PL);ACC(3,SG)"	წონის წონი
Generate the inflected form for the lemma: "წონის", according to the following morphological descriptions: "V;SBJV;PRF;NOM(3,PL);ACC(2,SG)"	წონის წონი
Generate the inflected form for the lemma: "წონის", according to the following morphological descriptions: "V;SBJV;PRS;NOM(2,PL);ACC(1,PL)"	წონის წონი
Generate the inflected form for the lemma: "ჭილიბი", according to the following morphological descriptions: "N;DAT(PL)"	ისი ჭილიბი 
Generate the inflected form for the lemma: "ჭილიბი", according to the following morphological descriptions: "N;DAT(PL;LGSPEC2)"	ჭილიბი ჭილ
Generate the inflected form for the lemma: "ჭილიბი", according to the following morphological descriptions: "N;DAT(SG)"	ისი ჭილიბი 
Generate the inflected form for the lemma: "ჭილიბი", according to the following morphological descriptions: "N;ERG(PL)"	ჭილიბი ჭილ
Generate the inflected form for the lemma: "ჭილიბი", according to the following morphological descriptions: "N;ERG(PL;LGSPEC2)"	ჭილიბი ჭილ
Generate the inflected form for the lemma: "ჭილიბი", according to the following morphological descriptions: "N;ERG(SG)"	ისი ჭილიბი 
Generate the inflected form for the lemma: "ჭილიბი", according to the following morphological descriptions: "N;FRML(PL)"	ისი" და "ჭილ
Generate the inflected form for the lemma: "ჭილიბი", according to the following morphological descriptions: "N;FRML(SG)"	ისი ჭილიბი 
Generate the inflected form for the lemma: "ჭილიბი", according to the following morphological descriptions: "N;GEN(PL)"	ისი" და "ჭილ
Generate the inflected form for the lemma: "ჭილიბი", according to the following morphological descriptions: "N;GEN(PL;LGSPEC2)"	ჭილიბი ჭილ
Generate the inflected form for the lemma: "ჭილიბი", according to the following morphological descriptions: "N;GEN(SG)"	ჭილიბი
Generate th
Generate the inflected form for the lemma: "ჭილიბი", according to the following morphological descriptions: "N;INS(PL)"	ისი" და "ჭილ
Generate the inflected form for the lemma: "ჭილიბი", according to the following morphological descriptions: "N;INS(SG)"	ჭილიბი ჭილ
Generate the inflected form for the lemma: "ჭილიბი", according to the following morphological descriptions: "N;NOM(PL)"	ისი" და "ჭილ
Generate the inflected form for the lemma: "ჭილიბი", according to the following morphological descriptions: "N;NOM(PL;LGSPEC2)"	ჭილიბი ჭილ
Generate the inflected form for the lemma: "ჭილიბი", according to the following morphological descriptions: "N;NOM(SG)"	ილიამი ჭილ
Generate the inflected form for the lemma: "ჭილიბი", according to the following morphological descriptions: "N;VOC(PL)"	ისი" და "ჭილ
Generate the inflected form for the lemma: "ჭილიბი", according to the following morphological descriptions: "N;VOC(PL;LGSPEC2)"	ჭილიბი ჭილ
Generate the inflected form for the lemma: "ჭილიბი", according to the following morphological descriptions: "N;VOC(SG)"	ისი ჭილიბი 
Generate the inflected form for the lemma: "ჭრის", according to the following morphological descriptions: "V;COND;NOM(2,PL);ACC(1,PL)"	ის" და ამას 
Generate the inflected form for the lemma: "ჭრის", according to the following morphological descriptions: "V;IMP;NOM(2,PL);ACC(3,PL)"	ის" და ამას 
Generate the inflected form for the lemma: "ჭრის", according to the following morphological descriptions: "V;IMP;NOM(3,SG);ACC(3,PL)"	არაფერი არ
Generate the inflected form for the lemma: "ჭრის", according to the following morphological descriptions: "V;IND;FUT;NOM(1,PL);ACC(3,PL)"	ჭრის" and the followin
Generate the inflected form for the lemma: "ჭრის", according to the following morphological descriptions: "V;IND;FUT;NOM(1,PL);ACC(3,SG)"	ჭრის" და ამა
Generate the inflected form for the lemma: "ჭრის", according to the following morphological descriptions: "V;IND;FUT;NOM(1,SG);ACC(2,SG)"	ჭრის" და ამა
Generate the inflected form for the lemma: "ჭრის", according to the following morphological descriptions: "V;IND;FUT;NOM(2,PL);ACC(3,SG)"	ჭრის" და ამა
Generate the inflected form for the lemma: "ჭრის", according to the following morphological descriptions: "V;IND;FUT;NOM(3,SG);ACC(1,SG)"	ჭრის" და ამა
Generate the inflected form for the lemma: "ჭრის", according to the following morphological descriptions: "V;IND;PRF;NOM(1,PL);ACC(2,PL)"	ის" და ამას 
Generate the inflected form for the lemma: "ჭრის", according to the following morphological descriptions: "V;IND;PRF;NOM(1,PL);ACC(2,SG)"	ის" და ამას 
Generate the inflected form for the lemma: "ჭრის", according to the following morphological descriptions: "V;IND;PRF;NOM(2,SG);ACC(1,SG)"	ჭრის" და ამა
Generate the inflected form for the lemma: "ჭრის", according to the following morphological descriptions: "V;IND;PRF;NOM(3,PL);ACC(1,PL)"	ის" და ამას 
Generate the inflected form for the lemma: "ჭრის", according to the following morphological descriptions: "V;IND;PRF;NOM(3,PL);ACC(3,SG)"	ის" და ამას 
Generate the inflected form for the lemma: "ჭრის", according to the following morphological descriptions: "V;IND;PRS;NOM(1,PL);ACC(3,PL)"	ჭრის" and the followin
Generate the inflected form for the lemma: "ჭრის", according to the following morphological descriptions: "V;IND;PRS;NOM(3,SG);ACC(1,SG)"	ჭრის" და ამა
Generate the inflected form for the lemma: "ჭრის", according to the following morphological descriptions: "V;IND;PST;PFV;NOM(3,PL);ACC(1,SG)"	ჭრის" და ამა
Generate the inflected form for the lemma: "ჭრის", according to the following morphological descriptions: "V;IND;PST;PFV;NOM(3,PL);ACC(2,SG)"	ჭრის" და ამა
Generate the inflected form for the lemma: "ჭრის", according to the following morphological descriptions: "V;IND;PST;PFV;NOM(3,SG);ACC(2,SG)"	ჭრის" according to the
Generate the inflected form for the lemma: "ჭრის", according to the following morphological descriptions: "V;IND;PST;PRF;NOM(1,PL);ACC(2,PL)"	ჭრის" and according to
Generate the inflected form for the lemma: "ჭრის", according to the following morphological descriptions: "V;IND;PST;PRF;NOM(2,PL);ACC(3,PL)"	ჭრის" and according to
Generate the inflected form for the lemma: "ჭრის", according to the following morphological descriptions: "V;OPT;NOM(3,PL);ACC(3,PL)"	ჭრის" და ამა
Generate the inflected form for the lemma: "ჭრის", according to the following morphological descriptions: "V;OPT;NOM(3,SG);ACC(1,SG)"	ის" და ამას 
Generate the inflected form for the lemma: "ჭრის", according to the following morphological descriptions: "V;SBJV;FUT;NOM(1,PL);ACC(2,PL)"	ჭრის" და ამა
Generate the inflected form for the lemma: "ჭრის", according to the following morphological descriptions: "V;SBJV;FUT;NOM(1,SG);ACC(2,PL)"	ჭრის" და ამა
Generate the inflected form for the lemma: "ჭრის", according to the following morphological descriptions: "V;SBJV;FUT;NOM(3,SG);ACC(3,SG)"	ჭრის" და ამა
Generate the inflected form for the lemma: "ჭრის", according to the following morphological descriptions: "V;SBJV;PRS;NOM(3,SG);ACC(1,PL)"	ჭრის" და ამა
Generate the inflected form for the lemma: "ხვართქლა", according to the following morphological descriptions: "N;DAT(PL)"	არაული ხვა
Generate the inflected form for the lemma: "ხვართქლა", according to the following morphological descriptions: "N;DAT(PL;LGSPEC2)"	ა ხვართქლა 
Generate the inflected form for the lemma: "ხვართქლა", according to the following morphological descriptions: "N;DAT(SG)"	ა ხვართქლა 
Generate the inflected form for the lemma: "ხვართქლა", according to the following morphological descriptions: "N;ERG(PL)"	ა ხვართქლა 
Generate the inflected form for the lemma: "ხვართქლა", according to the following morphological descriptions: "N;ERG(PL;LGSPEC2)"	ა ა ა ა ა ა ა 
Generate the inflected form for the lemma: "ხვართქლა", according to the following morphological descriptions: "N;ERG(SG)"	ა ა ა ა ა ა ა 
Generate the inflected form for the lemma: "ხვართქლა", according to the following morphological descriptions: "N;FRML(PL)"	ხვართქლა ხ
Generate the inflected form for the lemma: "ხვართქლა", according to the following morphological descriptions: "N;FRML(SG)"	ა ხვართქლა 
Generate the inflected form for the lemma: "ხვართქლა", according to the following morphological descriptions: "N;GEN(PL)"	ა ხვართქლა 
Generate the inflected form for the lemma: "ხვართქლა", according to the following morphological descriptions: "N;GEN(PL;LGSPEC2)"	ა ხვართქლა 
Generate the inflected form for the lemma: "ხვართქლა", according to the following morphological descriptions: "N;GEN(SG)"	ა ხვართქლა 
Generate the inflected form for the lemma: "ხვართქლა", according to the following morphological descriptions: "N;INS(PL)"	ა ხვართქლა 
Generate the inflected form for the lemma: "ხვართქლა", according to the following morphological descriptions: "N;INS(SG)"	არაული ხვა
Generate the inflected form for the lemma: "ხვართქლა", according to the following morphological descriptions: "N;NOM(PL)"	ა ხვართქლა 
Generate the inflected form for the lemma: "ხვართქლა", according to the following morphological descriptions: "N;NOM(PL;LGSPEC2)"	ხვართქლა ხ
Generate the inflected form for the lemma: "ხვართქლა", according to the following morphological descriptions: "N;NOM(SG)"	ა ხვართქლა 
Generate the inflected form for the lemma: "ხვართქლა", according to the following morphological descriptions: "N;VOC(PL)"	ა ხვართქლა 
Generate the inflected form for the lemma: "ხვართქლა", according to the following morphological descriptions: "N;VOC(PL;LGSPEC2)"	ხვართქლა ხ
Generate the inflected form for the lemma: "ხვართქლა", according to the following morphological descriptions: "N;VOC(SG)"	ა ხვართქლა 
Generate the inflected form for the lemma: "ხვია", according to the following morphological descriptions: "N;DAT(PL)"	ხვია ხვია ხ
Generate the inflected form for the lemma: "ხვია", according to the following morphological descriptions: "N;DAT(PL;LGSPEC2)"	ხვია ხვია ხ
Generate the inflected form for the lemma: "ხვია", according to the following morphological descriptions: "N;DAT(SG)"	ხვია ხვია ხ
Generate the inflected form for the lemma: "ხვია", according to the following morphological descriptions: "N;ERG(PL)"	ხვია ხვია ხ
Generate the inflected form for the lemma: "ხვია", according to the following morphological descriptions: "N;ERG(PL;LGSPEC2)"	ხვია ხვია ხ
Generate the inflected form for the lemma: "ხვია", according to the following morphological descriptions: "N;ERG(SG)"	ხვია ხვია ხ
Generate the inflected form for the lemma: "ხვია", according to the following morphological descriptions: "N;FRML(PL)"	ხვია" და "ხვ
Generate the inflected form for the lemma: "ხვია", according to the following morphological descriptions: "N;FRML(SG)"	ხვია ხვია ხ
Generate the inflected form for the lemma: "ხვია", according to the following morphological descriptions: "N;GEN(PL)"	ხვია" და "ხვ
Generate the inflected form for the lemma: "ხვია", according to the following morphological descriptions: "N;GEN(PL;LGSPEC2)"	ხვია ხვია ხ
Generate the inflected form for the lemma: "ხვია", according to the following morphological descriptions: "N;GEN(SG)"	ხვია ხვია ხ
Generate the inflected form for the lemma: "ხვია", according to the following morphological descriptions: "N;INS(PL)"	ხვია" და ამი
Generate the inflected form for the lemma: "ხვია", according to the following morphological descriptions: "N;INS(SG)"	ხვია ხვია ხ
Generate the inflected form for the lemma: "ხვია", according to the following morphological descriptions: "N;NOM(PL)"	ხვია ხვია ხ
Generate the inflected form for the lemma: "ხვია", according to the following morphological descriptions: "N;NOM(PL;LGSPEC2)"	ხვია ხვია ხ
Generate the inflected form for the lemma: "ხვია", according to the following morphological descriptions: "N;NOM(SG)"	ხვია ხვია ხ
Generate the inflected form for the lemma: "ხვია", according to the following morphological descriptions: "N;VOC(PL)"	ხვია ხვია ხ
Generate the inflected form for the lemma: "ხვია", according to the following morphological descriptions: "N;VOC(PL;LGSPEC2)"	ხვია ხვია ხ
Generate the inflected form for the lemma: "ხვია", according to the following morphological descriptions: "N;VOC(SG)"	ხვია ხვია ხ
Generate the inflected form for the lemma: "ხუმარა", according to the following morphological descriptions: "N;DAT(PL)"	ხუმარა ხუმ
Generate the inflected form for the lemma: "ხუმარა", according to the following morphological descriptions: "N;DAT(PL;LGSPEC2)"	არაბეთის მ
Generate the inflected form for the lemma: "ხუმარა", according to the following morphological descriptions: "N;DAT(SG)"	ხუმარა ხუმ
Generate the inflected form for the lemma: "ხუმარა", according to the following morphological descriptions: "N;ERG(PL)"	 ხუმარა ხუმ
Generate the inflected form for the lemma: "ხუმარა", according to the following morphological descriptions: "N;ERG(PL;LGSPEC2)"	 ხუმარა ხუმ
Generate the inflected form for the lemma: "ხუმარა", according to the following morphological descriptions: "N;ERG(SG)"	ხუმარა ხუმ
Generate the inflected form for the lemma: "ხუმარა", according to the following morphological descriptions: "N;FRML(PL)"	ხუმარა ხუმ
Generate the inflected form for the lemma: "ხუმარა", according to the following morphological descriptions: "N;FRML(SG)"	ხუმარა ხუმ
Generate the inflected form for the lemma: "ხუმარა", according to the following morphological descriptions: "N;GEN(PL)"	ხუმარა ხუმ
Generate the inflected form for the lemma: "ხუმარა", according to the following morphological descriptions: "N;GEN(PL;LGSPEC2)"	 ხუმარა ხუმ
Generate the inflected form for the lemma: "ხუმარა", according to the following morphological descriptions: "N;GEN(SG)"	 ხუმარა ხუმ
Generate the inflected form for the lemma: "ხუმარა", according to the following morphological descriptions: "N;INS(PL)"	არაული ხუმ
Generate the inflected form for the lemma: "ხუმარა", according to the following morphological descriptions: "N;INS(SG)"	არაბეთის ხ
Generate the inflected form for the lemma: "ხუმარა", according to the following morphological descriptions: "N;NOM(PL)"	არაბაში
Generate
Generate the inflected form for the lemma: "ხუმარა", according to the following morphological descriptions: "N;NOM(PL;LGSPEC2)"	არაბეთის მ
Generate the inflected form for the lemma: "ხუმარა", according to the following morphological descriptions: "N;NOM(SG)"	არაბაკა ხუ
Generate the inflected form for the lemma: "ხუმარა", according to the following morphological descriptions: "N;VOC(PL)"	ხუმარა ხუმ
Generate the inflected form for the lemma: "ხუმარა", according to the following morphological descriptions: "N;VOC(PL;LGSPEC2)"	ხუმარა ხუმ
Generate the inflected form for the lemma: "ხუმარა", according to the following morphological descriptions: "N;VOC(SG)"	ხუმარა ხუმ
Generate the inflected form for the lemma: "ჰქვია", according to the following morphological descriptions: "V;IND;FUT;NOM(1,PL)"	ისაა ჰქვია 
Generate the inflected form for the lemma: "ჰქვია", according to the following morphological descriptions: "V;IND;FUT;NOM(1,SG)"	ჰქვია"ჰქვი
Generate the inflected form for the lemma: "ჰქვია", according to the following morphological descriptions: "V;IND;FUT;NOM(2,PL)"	ისაა ჰქვია 
Generate the inflected form for the lemma: "ჰქვია", according to the following morphological descriptions: "V;IND;FUT;NOM(2,SG)"	ჰქვია"ჰქვი
Generate the inflected form for the lemma: "ჰქვია", according to the following morphological descriptions: "V;IND;FUT;NOM(3,PL)"	ისაა ჰქვია 
Generate the inflected form for the lemma: "ჰქვია", according to the following morphological descriptions: "V;IND;FUT;NOM(3,SG)"	ჰქვია"ჰქვი
Generate the inflected form for the lemma: "ჰქვია", according to the following morphological descriptions: "V;IND;PRF;NOM(2,PL)"	ისაა ჰქვია 
Generate the inflected form for the lemma: "ჰქვია", according to the following morphological descriptions: "V;IND;PRF;NOM(2,SG)"	ჰქვია" ჰქვი
Generate the inflected form for the lemma: "ჰქვია", according to the following morphological descriptions: "V;IND;PRF;NOM(3,PL)"	ჰქვია" და "ჰ
Generate the inflected form for the lemma: "ჰქვია", according to the following morphological descriptions: "V;IND;PRF;NOM(3,SG)"	ისაა ჰქვია 
Generate the inflected form for the lemma: "ჰქვია", according to the following morphological descriptions: "V;IND;PRS;NOM(1,PL)"	ისაა ჰქვია 
Generate the inflected form for the lemma: "ჰქვია", according to the following morphological descriptions: "V;IND;PRS;NOM(1,SG)"	ისაარსებობ
Generate the inflected form for the lemma: "ჰქვია", according to the following morphological descriptions: "V;IND;PRS;NOM(2,SG)"	ჰქვია"ჰქვი
Generate the inflected form for the lemma: "ჰქვია", according to the following morphological descriptions: "V;IND;PRS;NOM(3,PL)"	ჰქვია" და "ჰ
Generate the inflected form for the lemma: "ჰქვია", according to the following morphological descriptions: "V;IND;PRS;NOM(3,SG)"	ჰქვია"ჰქვი
Generate the inflected form for the lemma: "ჰქვია", according to the following morphological descriptions: "V;IND;PST;PFV;NOM(1,PL)"	ჰქვია" და "ჰ
Generate the inflected form for the lemma: "ჰქვია", according to the following morphological descriptions: "V;IND;PST;PFV;NOM(1,SG)"	ჰქვია" და ამ
Generate the inflected form for the lemma: "ჰქვია", according to the following morphological descriptions: "V;IND;PST;PFV;NOM(2,PL)"	ჰქვია" და "ჰ
Generate the inflected form for the lemma: "ჰქვია", according to the following morphological descriptions: "V;IND;PST;PFV;NOM(3,PL)"	ჰქვია" და "ჰ
Generate the inflected form for the lemma: "ჰქვია", according to the following morphological descriptions: "V;IND;PST;PRF;NOM(2,SG)"	ჰქვია" და ამ
Generate the inflected form for the lemma: "ჰქვია", according to the following morphological descriptions: "V;IND;PST;PRF;NOM(3,PL)"	ჰქვია" და "ჰ
Generate the inflected form for the lemma: "ჰქვია", according to the following morphological descriptions: "V;IND;PST;PRF;NOM(3,SG)"	ჰქვია" და ამ
Generate the inflected form for the lemma: "ჰქვია", according to the following morphological descriptions: "V;OPT;NOM(1,PL)"	ისაა ჰქვია 
Generate the inflected form for the lemma: "ჰქვია", according to the following morphological descriptions: "V;OPT;NOM(2,PL)"	ისაა ჰქვია 
Generate the inflected form for the lemma: "ჰქვია", according to the following morphological descriptions: "V;OPT;NOM(2,SG)"	ჰქვია" და "ჰ
Generate the inflected form for the lemma: "ჰქვია", according to the following morphological descriptions: "V;OPT;NOM(3,SG)"	ჰქვია" და "ჰ
