Generate the inflected form for the lemma: "indiciar", according to the following morphological descriptions: "V;2;PL;IND;PST;IPFV"	ido (indiciar) indiciar indici
Generate the inflected form for the lemma: "adequar", according to the following morphological descriptions: "V.PTCP;MASC;SG;PST"	er adequar adequar adequar ade
Generate the inflected form for the lemma: "desdizer", according to the following morphological descriptions: "V;2;SG;IND;PST;IPFV"	er", according to the followin
Generate the inflected form for the lemma: "refogar", according to the following morphological descriptions: "V.PTCP;PRS"	ar (refogar) (refogar) (refoga
Generate the inflected form for the lemma: "frequentar", according to the following morphological descriptions: "V;1;PL;IMP;POS"	r frequentar frequentar freque
Generate the inflected form for the lemma: "condimentar", according to the following morphological descriptions: "V;1;SG;IND;PST;PFV"	era (1992) [1] [2] [3] [4] [5]
Generate the inflected form for the lemma: "içar", according to the following morphological descriptions: "V;3;PL;SBJV;FUT"	ar" is a sentence of the lemma
Generate the inflected form for the lemma: "designar", according to the following morphological descriptions: "V;3;SG;IND;PST;IPFV"	er (1) (1) (1) (1) (1) (1) (1)
Generate the inflected form for the lemma: "ziguezaguear", according to the following morphological descriptions: "V;3;PL;IND;PST;PFV"	ar (ziguezaguear) (1)
Generate
Generate the inflected form for the lemma: "acortinar", according to the following morphological descriptions: "V;3;PL;NFIN"	ar", according to the followin
Generate the inflected form for the lemma: "estocar", according to the following morphological descriptions: "V;2;PL;COND"	ocar", according to the follow
Generate the inflected form for the lemma: "estimular", according to the following morphological descriptions: "V;1;PL;IND;PST;PFV"	estimular", according to the f
Generate the inflected form for the lemma: "harmonizar", according to the following morphological descriptions: "V;1;PL;IMP;NEG"	ar (harmonizar) (harmonizar) (
Generate the inflected form for the lemma: "sublinhar", according to the following morphological descriptions: "V;1;PL;IND;PST;IPFV"	ar sublinhar sublinhar sublinh
Generate the inflected form for the lemma: "contra-atacar", according to the following morphological descriptions: "V;2;PL;NFIN"	atacar", according to the foll
Generate the inflected form for the lemma: "pedalar", according to the following morphological descriptions: "V;1;PL;SBJV;PRS"	ar pedalar pedalar pedalar ped
Generate the inflected form for the lemma: "vitimar", according to the following morphological descriptions: "V;1;PL;COND"	er (1) (1) (1) (1) (1) (1) (1)
Generate the inflected form for the lemma: "brincar", according to the following morphological descriptions: "V;NFIN"	rar", according to the followi
Generate the inflected form for the lemma: "latinar", according to the following morphological descriptions: "V;3;SG;IND;PST;PRF"	ar (1) (1) (1) (1) (1) (1) (1)
Generate the inflected form for the lemma: "desdizer", according to the following morphological descriptions: "V;3;PL;IMP;NEG"	er desdizer desdizer desdizer 
Generate the inflected form for the lemma: "estipular", according to the following morphological descriptions: "V;3;PL;SBJV;PRS"	ar estipular estipular estipul
Generate the inflected form for the lemma: "arquejar", according to the following morphological descriptions: "V;3;PL;COND"	ar", according to the followin
Generate the inflected form for the lemma: "pregar", according to the following morphological descriptions: "V;2;PL;IND;PST;IPFV"	ar pregar pregar pregar pregar
Generate the inflected form for the lemma: "redimir", according to the following morphological descriptions: "V;1;PL;SBJV;FUT"	ir", according to the followin
Generate the inflected form for the lemma: "borrar", according to the following morphological descriptions: "V;3;PL;SBJV;PST;IPFV"	rar", according to the followi
Generate the inflected form for the lemma: "surtar", according to the following morphological descriptions: "V;1;PL;SBJV;FUT"	ar", according to the followin
Generate the inflected form for the lemma: "impregnar", according to the following morphological descriptions: "V.PTCP;PRS"	regnar", according to the foll
Generate the inflected form for the lemma: "entrar", according to the following morphological descriptions: "V;2;PL;IND;PRS"	rar entrar entrar entrar entra
Generate the inflected form for the lemma: "cagar", according to the following morphological descriptions: "V;1;SG;COND"	ar cagar cagar cagar cagar cag
Generate the inflected form for the lemma: "apedrejar", according to the following morphological descriptions: "V;3;SG;IMP;POS"	rejar (apedrejar) (apedrejar) 
Generate the inflected form for the lemma: "enfileirar", according to the following morphological descriptions: "V;2;SG;SBJV;FUT"	ar", according to the followin
Generate the inflected form for the lemma: "registar", according to the following morphological descriptions: "V;1;SG;SBJV;FUT"	er (registar) registar regista
Generate the inflected form for the lemma: "mutilar", according to the following morphological descriptions: "V;3;PL;SBJV;FUT"	ar", according to the followin
Generate the inflected form for the lemma: "indiciar", according to the following morphological descriptions: "V;3;SG;SBJV;FUT"	indiciar", according to the fo
Generate the inflected form for the lemma: "limar", according to the following morphological descriptions: "V;2;SG;SBJV;PST;IPFV"	ar (1) (1) (2) (3) (4) (5) (6)
Generate the inflected form for the lemma: "apatetar", according to the following morphological descriptions: "V;3;SG;SBJV;PST;IPFV"	ar apatetar apatetar apatetar 
Generate the inflected form for the lemma: "guardar", according to the following morphological descriptions: "V;3;PL;IMP;POS"	rar", according to the followi
Generate the inflected form for the lemma: "pagar", according to the following morphological descriptions: "V;1;SG;IND;PRS"	ar pagar pagar pagar pagar pag
Generate the inflected form for the lemma: "optar", according to the following morphological descriptions: "V;2;SG;IMP;NEG"	ar (optar) (optar) (optar) (op
Generate the inflected form for the lemma: "voltar", according to the following morphological descriptions: "V;1;SG;NFIN"	ar voltar voltar voltar voltar
Generate the inflected form for the lemma: "coevoluir", according to the following morphological descriptions: "V;2;SG;IND;PST;PFV"	evoluir", according to the fol
Generate the inflected form for the lemma: "olear", according to the following morphological descriptions: "V;2;SG;COND"	ear olear olear olear olear ol
Generate the inflected form for the lemma: "conjecturar", according to the following morphological descriptions: "V;2;PL;IMP;POS"	 form for the lemma: "conjectu
Generate the inflected form for the lemma: "raciocinar", according to the following morphological descriptions: "V;2;PL;IMP;POS"	ar raciocinar raciocinar racio
Generate the inflected form for the lemma: "secundar", according to the following morphological descriptions: "V;2;PL;NFIN"	ar", according to the followin
Generate the inflected form for the lemma: "aluviar", according to the following morphological descriptions: "V;3;PL;IND;FUT"	ar", according to the followin
Generate the inflected form for the lemma: "aventar", according to the following morphological descriptions: "V;2;PL;IND;FUT"	ar aventar aventar aventar ave
Generate the inflected form for the lemma: "vesguear", according to the following morphological descriptions: "V;1;PL;SBJV;FUT"	ar", according to the followin
Generate the inflected form for the lemma: "relacionar", according to the following morphological descriptions: "V;1;SG;IND;PRS"	erate the inflected form for t
Generate the inflected form for the lemma: "realçar", according to the following morphological descriptions: "V;2;PL;IMP;POS"	ar realçar realçar realçar 
Generate the inflected form for the lemma: "confraternizar", according to the following morphological descriptions: "V;1;SG;IND;FUT"	izar", according to the follow
Generate the inflected form for the lemma: "olear", according to the following morphological descriptions: "V;3;SG;IMP;POS"	ar (olear) (olear) (olear) (ol
Generate the inflected form for the lemma: "sangrar", according to the following morphological descriptions: "V;1;SG;IND;FUT"	rar", according to the followi
Generate the inflected form for the lemma: "polimerizar", according to the following morphological descriptions: "V;3;SG;NFIN"	izar", according to the follow
Generate the inflected form for the lemma: "anteceder", according to the following morphological descriptions: "V;1;SG;IND;FUT"	er", according to the followin
Generate the inflected form for the lemma: "delimitar", according to the following morphological descriptions: "V;1;PL;IMP;POS"	er (1) (1) (1) (1) (1) (1) (1)
Generate the inflected form for the lemma: "contrabalançar", according to the following morphological descriptions: "V;2;SG;IMP;POS"	rar contrabalançar contrabala
Generate the inflected form for the lemma: "desarrazoar", according to the following morphological descriptions: "V;1;PL;SBJV;FUT"	ar", according to the followin
Generate the inflected form for the lemma: "fallecer", according to the following morphological descriptions: "V;2;SG;SBJV;FUT"	er", according to the followin
Generate the inflected form for the lemma: "aventar", according to the following morphological descriptions: "V;2;PL;IND;PST;IPFV"	er aventar aventar aventar ave
Generate the inflected form for the lemma: "analisar", according to the following morphological descriptions: "V;1;PL;SBJV;FUT"	ar", according to the followin
Generate the inflected form for the lemma: "adoecer", according to the following morphological descriptions: "V.PTCP;PRS"	er", according to the followin
Generate the inflected form for the lemma: "arrebentar", according to the following morphological descriptions: "V;1;PL;NFIN"	rebentar", according to the fo
Generate the inflected form for the lemma: "extinguir", according to the following morphological descriptions: "V;3;PL;IND;PST;IPFV"	r extinguir extinguir extingui
Generate the inflected form for the lemma: "mastigar", according to the following morphological descriptions: "V;3;PL;IMP;POS"	ar mastigar mastigar mastigar 
Generate the inflected form for the lemma: "constatar", according to the following morphological descriptions: "V;3;PL;IND;PST;IPFV"	out the lemma: "constatar", ac
Generate the inflected form for the lemma: "filtrar", according to the following morphological descriptions: "V;3;PL;SBJV;FUT"	rar", according to the followi
Generate the inflected form for the lemma: "tosar", according to the following morphological descriptions: "V;1;PL;IND;FUT"	ar (tosar) (tosar) (tosar) (to
Generate the inflected form for the lemma: "proliferar", according to the following morphological descriptions: "V;1;PL;SBJV;PRS"	erar (proliferar) - proliferar
Generate the inflected form for the lemma: "cumprimentar", according to the following morphological descriptions: "V;1;SG;NFIN"	rata cumprimentar cumprimentar
Generate the inflected form for the lemma: "comendar", according to the following morphological descriptions: "V;3;SG;IND;FUT"	rar", according to the followi
Generate the inflected form for the lemma: "desarrazoar", according to the following morphological descriptions: "V;1;SG;IND;PST;PFV"	ar ar ar ar ar ar ar ar ar ar 
Generate the inflected form for the lemma: "sonambular", according to the following morphological descriptions: "V.PTCP;MASC;SG;PST"	aranteno (1992) (1992) (1992) 
Generate the inflected form for the lemma: "sangrar", according to the following morphological descriptions: "V;3;PL;IND;PRS"	rar (sangrar) (sangrar) (sangr
Generate the inflected form for the lemma: "adivinhar", according to the following morphological descriptions: "V;3;PL;IMP;NEG"	ar adivinhar adivinhar adivinh
Generate the inflected form for the lemma: "lambujar", according to the following morphological descriptions: "V.PTCP;FEM;SG;PST"	ar", according to the followin
Generate the inflected form for the lemma: "registrar", according to the following morphological descriptions: "V;2;SG;SBJV;FUT"	registrar", according to the f
Generate the inflected form for the lemma: "desembalar", according to the following morphological descriptions: "V;3;SG;IND;PST;IPFV"	ar desembalar desembalar desem
Generate the inflected form for the lemma: "liquefazer", according to the following morphological descriptions: "V;2;PL;IMP;NEG"	er", according to the followin
Generate the inflected form for the lemma: "sobressair", according to the following morphological descriptions: "V;1;SG;IND;FUT"	er (1995) (1995) (1996) (1997)
Generate the inflected form for the lemma: "incorporar", according to the following morphological descriptions: "V;1;PL;IMP;POS"	erar incorporar incorporar inc
Generate the inflected form for the lemma: "absceder", according to the following morphological descriptions: "V;3;SG;NFIN"	er", according to the followin
Generate the inflected form for the lemma: "escassear", according to the following morphological descriptions: "V;1;SG;SBJV;PRS"	ear (escassear) (escassear) (e
Generate the inflected form for the lemma: "registrar", according to the following morphological descriptions: "V;1;PL;IND;PST;IPFV"	er registrar registrar registr
Generate the inflected form for the lemma: "retaliar", according to the following morphological descriptions: "V.PTCP;MASC;SG;PST"	er (retaliar) (retaliar) (reta
Generate the inflected form for the lemma: "vomitar", according to the following morphological descriptions: "V;2;PL;IND;PST;PRF"	ar vomitar vomitar vomitar vom
Generate the inflected form for the lemma: "realçar", according to the following morphological descriptions: "V;1;PL;SBJV;FUT"	ar", according to the followin
Generate the inflected form for the lemma: "derrapar", according to the following morphological descriptions: "V;1;PL;IND;PRS"	rapar (derrapar) (derrapar) (d
Generate the inflected form for the lemma: "denotar", according to the following morphological descriptions: "V;2;PL;IMP;NEG"	er denotar denotar denotar den
Generate the inflected form for the lemma: "encomendar", according to the following morphological descriptions: "V;1;SG;SBJV;FUT"	rar", according to the followi
Generate the inflected form for the lemma: "escalfar", according to the following morphological descriptions: "V;3;PL;IMP;NEG"	ra escalfar escalfar escalfar 
Generate the inflected form for the lemma: "desentranhar", according to the following morphological descriptions: "V;3;PL;IND;PST;IPFV"	ar desentranhar desentranhar d
Generate the inflected form for the lemma: "amarrar", according to the following morphological descriptions: "V;2;SG;SBJV;FUT"	rar", according to the followi
Generate the inflected form for the lemma: "discar", according to the following morphological descriptions: "V;3;SG;SBJV;PRS"	ing the lemma: "discar", accor
Generate the inflected form for the lemma: "teclar", according to the following morphological descriptions: "V;3;PL;SBJV;PRS"	er (teclar) (teclar) (teclar) 
Generate the inflected form for the lemma: "alfabetizar", according to the following morphological descriptions: "V;1;PL;SBJV;PST;IPFV"	ar alfabetizar alfabetizar alf
Generate the inflected form for the lemma: "ruir", according to the following morphological descriptions: "V;1;SG;SBJV;PST;IPFV"	r ruir ruir ruir ruir ruir rui
Generate the inflected form for the lemma: "arquivar", according to the following morphological descriptions: "V;1;SG;SBJV;FUT"	ar", according to the followin
Generate the inflected form for the lemma: "terminar", according to the following morphological descriptions: "V;1;PL;IND;PST;IPFV"	er (1) (1) (2) (3) (4) (5) (6)
Generate the inflected form for the lemma: "sublinhar", according to the following morphological descriptions: "V;3;PL;IND;PST;IPFV"	ar sublinhar sublinhar sublinh
Generate the inflected form for the lemma: "resplandecer", according to the following morphological descriptions: "V;2;PL;IND;PST;PFV"	er", according to the followin
Generate the inflected form for the lemma: "talhar", according to the following morphological descriptions: "V;3;PL;NFIN"	ar (talhar) (talhar) (talhar) 
Generate the inflected form for the lemma: "ondular", according to the following morphological descriptions: "V;3;SG;SBJV;PRS"	ar (ondular) (ondular) (ondula
Generate the inflected form for the lemma: "ensaiar", according to the following morphological descriptions: "V;2;SG;SBJV;FUT"	ar", according to the followin
Generate the inflected form for the lemma: "prover", according to the following morphological descriptions: "V;3;SG;COND"	rator", according to the follo
Generate the inflected form for the lemma: "tagarelar", according to the following morphological descriptions: "V.PTCP;MASC;PL;PST"	arelar (tagarelar) (tagarelar)
Generate the inflected form for the lemma: "fallecer", according to the following morphological descriptions: "V;2;SG;SBJV;PRS"	er", according to the followin
Generate the inflected form for the lemma: "relacionar", according to the following morphological descriptions: "V;3;PL;IMP;NEG"	era de la contradicción de la
Generate the inflected form for the lemma: "concordar", according to the following morphological descriptions: "V;3;PL;IND;PST;IPFV"	er (1992) (1992) (1992) (1992)
Generate the inflected form for the lemma: "assemelhar", according to the following morphological descriptions: "V;3;PL;COND"	rar", according to the followi
Generate the inflected form for the lemma: "filtrar", according to the following morphological descriptions: "V;2;PL;SBJV;FUT"	rar", according to the followi
Generate the inflected form for the lemma: "engendrar", according to the following morphological descriptions: "V;1;SG;IND;PRS"	rar (engendrar) (engendrar) (e
Generate the inflected form for the lemma: "proliferar", according to the following morphological descriptions: "V;3;SG;SBJV;PRS"	erar (proliferar) - proliferar
Generate the inflected form for the lemma: "silenciar", according to the following morphological descriptions: "V;2;PL;IMP;NEG"	erar (silenciar) (silenciar) (
Generate the inflected form for the lemma: "denominar", according to the following morphological descriptions: "V;1;PL;IND;PRS"	er (1) (1) (2) (3) (4) (5) (6)
Generate the inflected form for the lemma: "mumificar", according to the following morphological descriptions: "V;2;PL;IMP;POS"	ing the lemma: "mumificar", ac
Generate the inflected form for the lemma: "complicar", according to the following morphological descriptions: "V;2;PL;IND;PST;PFV"	out the lemma: "complicar", ac
Generate the inflected form for the lemma: "terminar", according to the following morphological descriptions: "V;1;PL;IND;PST;PRF"	er (1) (1) (1) (1) (1) (1) (1)
Generate the inflected form for the lemma: "bombardear", according to the following morphological descriptions: "V.PTCP;FEM;PL;PST"	rator of the army and the army
Generate the inflected form for the lemma: "desossar", according to the following morphological descriptions: "V;1;SG;SBJV;PST;IPFV"	ar desossar desossar desossar 
Generate the inflected form for the lemma: "remunerar", according to the following morphological descriptions: "V;3;SG;IND;PST;PFV"	erar", according to the follow
Generate the inflected form for the lemma: "recriar", according to the following morphological descriptions: "V;2;PL;IND;PST;PRF"	riar", according to the follow
Generate the inflected form for the lemma: "enraivecer", according to the following morphological descriptions: "V;2;PL;COND"	er", according to the followin
Generate the inflected form for the lemma: "designar", according to the following morphological descriptions: "V;2;PL;IND;PST;PFV"	er", according to the followin
Generate the inflected form for the lemma: "damnar", according to the following morphological descriptions: "V;1;PL;IND;PRS"	ar damnar damnar damnar damnar
Generate the inflected form for the lemma: "adequar", according to the following morphological descriptions: "V;3;SG;IND;PST;IPFV"	er adequar adequar adequar ade
Generate the inflected form for the lemma: "complicar", according to the following morphological descriptions: "V;1;PL;SBJV;FUT"	out the lemma: "complicar", ac
Generate the inflected form for the lemma: "blasonar", according to the following morphological descriptions: "V;1;PL;IND;FUT"	ar (blasonar) (blasonar) (blas
Generate the inflected form for the lemma: "interpelar", according to the following morphological descriptions: "V;2;SG;IND;PST;PRF"	elar", according to the follow
Generate the inflected form for the lemma: "gatunar", according to the following morphological descriptions: "V;3;SG;IND;PRS"	ar gatunar gatunar gatunar gat
Generate the inflected form for the lemma: "contrair", according to the following morphological descriptions: "V;3;PL;IMP;NEG"	er (contrair) contrair contrai
Generate the inflected form for the lemma: "engastar", according to the following morphological descriptions: "V;1;SG;SBJV;PRS"	ra engastar engastar engastar 
Generate the inflected form for the lemma: "acreditar", according to the following morphological descriptions: "V;1;PL;IND;PST;PRF"	ar acreditar acreditar acredit
Generate the inflected form for the lemma: "compensar", according to the following morphological descriptions: "V;1;PL;IND;FUT"	or compensar compensar compens
Generate the inflected form for the lemma: "achatar", according to the following morphological descriptions: "V;NFIN"	ar achatar achatar achatar ach
Generate the inflected form for the lemma: "olhar", according to the following morphological descriptions: "V;2;PL;IND;PST;PFV"	ar (olhar) (olhar) (olhar) (ol
Generate the inflected form for the lemma: "talhar", according to the following morphological descriptions: "V;1;SG;NFIN"	ar", according to the followin
Generate the inflected form for the lemma: "redimir", according to the following morphological descriptions: "V.PTCP;MASC;PL;PST"	redimir", according to the fol
Generate the inflected form for the lemma: "lapidar", according to the following morphological descriptions: "V;NFIN"	ar (1) 2010-01-18 10:14:00 UTC
Generate the inflected form for the lemma: "indiciar", according to the following morphological descriptions: "V;2;SG;IND;PST;PFV"	ido (indiciar) (indiciar) (ind
Generate the inflected form for the lemma: "arquivar", according to the following morphological descriptions: "V;3;PL;IND;PST;PFV"	ar ar ar ar ar ar ar ar ar ar 
Generate the inflected form for the lemma: "arquejar", according to the following morphological descriptions: "V;2;PL;COND"	ar", according to the followin
Generate the inflected form for the lemma: "cumprir", according to the following morphological descriptions: "V;1;PL;NFIN"	r cumprir cumprir cumprir cump
Generate the inflected form for the lemma: "estipular", according to the following morphological descriptions: "V;1;PL;SBJV;PRS"	ar estipular estipular estipul
Generate the inflected form for the lemma: "encetar", according to the following morphological descriptions: "V.PTCP;MASC;SG;PST"	etar (encetar) (encetar) (ence
Generate the inflected form for the lemma: "abscindir", according to the following morphological descriptions: "V;2;SG;SBJV;PRS"	r abscindir abscindir abscindi
Generate the inflected form for the lemma: "supurar", according to the following morphological descriptions: "V;2;SG;SBJV;PST;IPFV"	ar supurar supurar supurar sup
Generate the inflected form for the lemma: "ablegar", according to the following morphological descriptions: "V;1;PL;SBJV;FUT"	erar", according to the follow
Generate the inflected form for the lemma: "resplendecer", according to the following morphological descriptions: "V.PTCP;FEM;SG;PST"	er", according to the followin
Generate the inflected form for the lemma: "charquear", according to the following morphological descriptions: "V;2;PL;IND;PST;PRF"	ar (1)
Generate the inflected 
Generate the inflected form for the lemma: "enrubescer", according to the following morphological descriptions: "V;1;SG;IND;PST;PFV"	er", according to the followin
Generate the inflected form for the lemma: "aclamar", according to the following morphological descriptions: "V;1;PL;SBJV;FUT"	ar", according to the followin
Generate the inflected form for the lemma: "anteceder", according to the following morphological descriptions: "V;3;SG;SBJV;FUT"	er", according to the followin
Generate the inflected form for the lemma: "criticar", according to the following morphological descriptions: "V;3;SG;IND;FUT"	ar", according to the followin
Generate the inflected form for the lemma: "expectorar", according to the following morphological descriptions: "V;3;SG;IND;PRS"	ararararararararararararararar
Generate the inflected form for the lemma: "comprehender", according to the following morphological descriptions: "V;1;SG;IND;FUT"	er", according to the followin
Generate the inflected form for the lemma: "inquirir", according to the following morphological descriptions: "V;2;PL;SBJV;PST;IPFV"	rir", according to the followi
Generate the inflected form for the lemma: "incorporar", according to the following morphological descriptions: "V;3;SG;IND;PRS"	er - "incorporar" - "incorpora
Generate the inflected form for the lemma: "sufocar", according to the following morphological descriptions: "V;2;PL;IND;PST;IPFV"	ocar", according to the follow
Generate the inflected form for the lemma: "estimar", according to the following morphological descriptions: "V;2;SG;IND;PRS"	era de la casa de la casa de l
Generate the inflected form for the lemma: "desentranhar", according to the following morphological descriptions: "V;3;SG;COND"	ar desentranhar desentranhar d
Generate the inflected form for the lemma: "achatar", according to the following morphological descriptions: "V;3;SG;IMP;NEG"	atar (achatar) (achatar) (acha
Generate the inflected form for the lemma: "anteceder", according to the following morphological descriptions: "V;1;PL;IND;PST;PFV"	er", according to the followin
Generate the inflected form for the lemma: "adoecer", according to the following morphological descriptions: "V.PTCP;FEM;SG;PST"	er", according to the followin
Generate the inflected form for the lemma: "interferir", according to the following morphological descriptions: "V;3;SG;SBJV;PST;IPFV"	r", according to the following
Generate the inflected form for the lemma: "protrair", according to the following morphological descriptions: "V.PTCP;FEM;PL;PST"	rair protrair protrair protrai
Generate the inflected form for the lemma: "charquear", according to the following morphological descriptions: "V;1;PL;IND;PST;PFV"	ar (1)
Generate the inflected 
Generate the inflected form for the lemma: "ousar", according to the following morphological descriptions: "V;1;SG;NFIN"	ar ousar ousar ousar ousar ous
Generate the inflected form for the lemma: "adequar", according to the following morphological descriptions: "V.PTCP;FEM;SG;PST"	er adequar adequar adequar ade
Generate the inflected form for the lemma: "denominar", according to the following morphological descriptions: "V;1;PL;IND;PST;PRF"	er (1) (1) (2) (3) (4) (5) (6)
Generate the inflected form for the lemma: "estercar", according to the following morphological descriptions: "V;3;PL;IND;FUT"	ercar", according to the follo
Generate the inflected form for the lemma: "economizar", according to the following morphological descriptions: "V.PTCP;MASC;PL;PST"	erar economizar economizar eco
Generate the inflected form for the lemma: "afundir", according to the following morphological descriptions: "V;3;SG;IND;PST;PFV"	ir afundir afundir afundir afu
Generate the inflected form for the lemma: "visitar", according to the following morphological descriptions: "V;1;SG;IND;PST;IPFV"	r visitar visitar visitar visi
Generate the inflected form for the lemma: "condecorar", according to the following morphological descriptions: "V;2;PL;COND"	erar", according to the follow
Generate the inflected form for the lemma: "adoecer", according to the following morphological descriptions: "V.PTCP;MASC;PL;PST"	er", according to the followin
Generate the inflected form for the lemma: "cumprimentar", according to the following morphological descriptions: "V;1;PL;IND;FUT"	ar cumprimentar cumprimentar c
Generate the inflected form for the lemma: "agradar", according to the following morphological descriptions: "V;2;PL;SBJV;FUT"	ar", according to the followin
Generate the inflected form for the lemma: "prevalecer", according to the following morphological descriptions: "V;1;PL;IND;PRS"	er prevalecer prevalecer preva
Generate the inflected form for the lemma: "abafar", according to the following morphological descriptions: "V.PTCP;MASC;SG;PST"	ar abafar abafar abafar abafar
Generate the inflected form for the lemma: "flutuar", according to the following morphological descriptions: "V;3;SG;IND;FUT"	ar (1) (1) (1) (1) (1) (1) (1)
Generate the inflected form for the lemma: "objetar", according to the following morphological descriptions: "V;1;PL;IND;PST;PFV"	ar", according to the followin
Generate the inflected form for the lemma: "escassear", according to the following morphological descriptions: "V.PTCP;FEM;SG;PST"	ear (escassear) (escassear) (e
Generate the inflected form for the lemma: "alojar", according to the following morphological descriptions: "V;2;PL;IND;FUT"	ojar" and the lemma: "alojar".
Generate the inflected form for the lemma: "pagar", according to the following morphological descriptions: "V;2;PL;IND;PST;IPFV"	ar pagar pagar pagar pagar pag
Generate the inflected form for the lemma: "cintar", according to the following morphological descriptions: "V;1;PL;IND;PST;IPFV"	ar cintar cintar cintar cintar
Generate the inflected form for the lemma: "tanger", according to the following morphological descriptions: "V;1;PL;IMP;NEG"	er (1) (1) (1) (1) (1) (1) (1)
Generate the inflected form for the lemma: "consolidar", according to the following morphological descriptions: "V;3;SG;IND;PST;IPFV"	olidar (consolidar) (consolida
Generate the inflected form for the lemma: "amaynar", according to the following morphological descriptions: "V;1;SG;IND;PRS"	ar amaynar amaynar amaynar ama
Generate the inflected form for the lemma: "condenar", according to the following morphological descriptions: "V;3;SG;IND;FUT"	 form for the lemma: "condenar
Generate the inflected form for the lemma: "desistir", according to the following morphological descriptions: "V;2;SG;SBJV;PRS"	ra desistir desistir desistir 
Generate the inflected form for the lemma: "frequentar", according to the following morphological descriptions: "V;3;PL;SBJV;FUT"	r", according to the following
Generate the inflected form for the lemma: "brincar", according to the following morphological descriptions: "V;1;PL;SBJV;PRS"	rar", according to the followi
Generate the inflected form for the lemma: "visitar", according to the following morphological descriptions: "V;1;PL;SBJV;FUT"	r", according to the following
Generate the inflected form for the lemma: "vocalizar", according to the following morphological descriptions: "V;1;SG;IND;PRS"	rar", according to the followi
Generate the inflected form for the lemma: "safar", according to the following morphological descriptions: "V;3;PL;IND;PST;PRF"	ar", according to the followin
Generate the inflected form for the lemma: "pregar", according to the following morphological descriptions: "V;3;SG;IND;PST;IPFV"	ar pregar pregar pregar pregar
Generate the inflected form for the lemma: "encarcerar", according to the following morphological descriptions: "V;1;SG;SBJV;FUT"	rar", according to the followi
Generate the inflected form for the lemma: "talhar", according to the following morphological descriptions: "V;3;SG;IMP;NEG"	ar talhar talhar talhar talhar
Generate the inflected form for the lemma: "saturar", according to the following morphological descriptions: "V;3;PL;IND;PST;PFV"	ar saturar saturar saturar sat
Generate the inflected form for the lemma: "remunerar", according to the following morphological descriptions: "V;2;PL;IND;PRS"	erar (remunerar) - remunerar (
Generate the inflected form for the lemma: "anotar", according to the following morphological descriptions: "V;2;SG;IND;PST;PFV"	ar" and "anotar". The lemma is
Generate the inflected form for the lemma: "apregoar", according to the following morphological descriptions: "V;1;SG;COND"	ar apregoar apregoar apregoar 
Generate the inflected form for the lemma: "sonambular", according to the following morphological descriptions: "V;2;SG;IMP;NEG"	arante the sonambular form for
Generate the inflected form for the lemma: "marchar", according to the following morphological descriptions: "V;1;SG;IND;FUT"	ar", according to the followin
Generate the inflected form for the lemma: "seguir", according to the following morphological descriptions: "V;3;SG;IND;FUT"	er er er er er er er er er er 
Generate the inflected form for the lemma: "inquirir", according to the following morphological descriptions: "V;1;PL;SBJV;FUT"	rir", according to the followi
Generate the inflected form for the lemma: "proliferar", according to the following morphological descriptions: "V;1;PL;IMP;NEG"	erar (proliferar) (proliferar)
Generate the inflected form for the lemma: "desentranhar", according to the following morphological descriptions: "V;3;PL;IND;FUT"	ar desentranhar desentranhar d
Generate the inflected form for the lemma: "escavar", according to the following morphological descriptions: "V;1;PL;SBJV;FUT"	r", according to the following
Generate the inflected form for the lemma: "ascender", according to the following morphological descriptions: "V;3;PL;IND;PST;PFV"	er", according to the followin
Generate the inflected form for the lemma: "segmentar", according to the following morphological descriptions: "V;2;SG;IND;PST;IPFV"	er (1997) (1997) (1998) (1999)
Generate the inflected form for the lemma: "desvairar", according to the following morphological descriptions: "V;3;PL;SBJV;PST;IPFV"	rar", according to the followi
Generate the inflected form for the lemma: "ascender", according to the following morphological descriptions: "V;2;SG;SBJV;PST;IPFV"	er", according to the followin
Generate the inflected form for the lemma: "condecorar", according to the following morphological descriptions: "V;3;PL;IND;PRS"	er (1) (1) (1) (1) (1) (1) (1)
Generate the inflected form for the lemma: "afundir", according to the following morphological descriptions: "V;2;SG;COND"	ir afundir afundir afundir afu
Generate the inflected form for the lemma: "escravizar", according to the following morphological descriptions: "V;1;SG;IND;PRS"	ravizar", according to the fol
Generate the inflected form for the lemma: "regularizar", according to the following morphological descriptions: "V;3;SG;IND;PST;PRF"	erar", according to the follow
Generate the inflected form for the lemma: "revelar", according to the following morphological descriptions: "V;1;PL;IND;PST;PFV"	ar revelar revelar revelar rev
Generate the inflected form for the lemma: "entrar", according to the following morphological descriptions: "V.PTCP;PRS"	rar", according to the followi
Generate the inflected form for the lemma: "vir", according to the following morphological descriptions: "V;1;PL;SBJV;PST;IPFV"	ir vir vir vir vir vir vir vir
Generate the inflected form for the lemma: "pescar", according to the following morphological descriptions: "V;2;SG;NFIN"	er (pescar) (pescar) (pescar) 
Generate the inflected form for the lemma: "bombardear", according to the following morphological descriptions: "V;1;SG;NFIN"	rator", according to the follo
Generate the inflected form for the lemma: "colorar", according to the following morphological descriptions: "V;2;PL;SBJV;PRS"	er (colorar) colorar colorar c
Generate the inflected form for the lemma: "surtar", according to the following morphological descriptions: "V;2;SG;SBJV;PRS"	ar surtar surtar surtar surtar
Generate the inflected form for the lemma: "arrebentar", according to the following morphological descriptions: "V;3;PL;IND;PST;PFV"	ar e ar e a r e a r e a r e a 
Generate the inflected form for the lemma: "mastigar", according to the following morphological descriptions: "V;2;PL;SBJV;PRS"	ar (1) 2010-01-11 14:14:00 UTC
Generate the inflected form for the lemma: "enrubescer", according to the following morphological descriptions: "V;1;PL;IND;PRS"	er enrubescer enrubescer enrub
Generate the inflected form for the lemma: "privilegiar", according to the following morphological descriptions: "V;2;SG;SBJV;PST;IPFV"	rar", according to the followi
Generate the inflected form for the lemma: "desossar", according to the following morphological descriptions: "V;NFIN"	ar", according to the followin
Generate the inflected form for the lemma: "deificar", according to the following morphological descriptions: "V;3;SG;SBJV;FUT"	icar", according to the follow
Generate the inflected form for the lemma: "vesguear", according to the following morphological descriptions: "V;3;PL;SBJV;PRS"	ar vesguear vesguear vesguear 
Generate the inflected form for the lemma: "alucinar", according to the following morphological descriptions: "V;2;PL;IMP;NEG"	ar (alucinar) (alucinar) (aluc
Generate the inflected form for the lemma: "printar", according to the following morphological descriptions: "V;3;PL;IND;PST;IPFV"	ar printar printar printar pri
Generate the inflected form for the lemma: "simpatizar", according to the following morphological descriptions: "V;1;SG;IND;FUT"	izar", according to the follow
Generate the inflected form for the lemma: "ondular", according to the following morphological descriptions: "V;2;SG;SBJV;FUT"	ar", according to the followin
Generate the inflected form for the lemma: "sobressair", according to the following morphological descriptions: "V;1;SG;SBJV;PRS"	er (1) (1) (1) (1) (1) (1) (1)
Generate the inflected form for the lemma: "escassear", according to the following morphological descriptions: "V;2;SG;SBJV;PST;IPFV"	ear (escassear) (escassear) (e
Generate the inflected form for the lemma: "maltar", according to the following morphological descriptions: "V;2;SG;IMP;NEG"	ar (1999) - Maltar (1999) - Ma
Generate the inflected form for the lemma: "delinear", according to the following morphological descriptions: "V;1;PL;SBJV;PRS"	ear (1) (1) (1) (1) (1) (1) (1
Generate the inflected form for the lemma: "desistir", according to the following morphological descriptions: "V;2;PL;SBJV;PRS"	resistir", according to the fo
Generate the inflected form for the lemma: "secundar", according to the following morphological descriptions: "V;2;PL;SBJV;PRS"	ar 2010-01-11 14:14:00 UTC #10
Generate the inflected form for the lemma: "ensaiar", according to the following morphological descriptions: "V;2;PL;IND;PST;PRF"	rar", according to the followi
Generate the inflected form for the lemma: "analisar", according to the following morphological descriptions: "V;2;SG;IND;PRS"	ar analisar analisar analisar 
Generate the inflected form for the lemma: "sonambular", according to the following morphological descriptions: "V;2;PL;COND"	;COND". The lemma is a sonambu
Generate the inflected form for the lemma: "alucinar", according to the following morphological descriptions: "V;1;PL;IND;PRS"	ar (alucinar) alucinar alucina
Generate the inflected form for the lemma: "comprehender", according to the following morphological descriptions: "V;2;PL;SBJV;PRS"	er (1) (1) (1) (1) (1) (1) (1)
Generate the inflected form for the lemma: "molestar", according to the following morphological descriptions: "V;1;PL;NFIN"	ar (1) (1) (1) (1) (1) (1) (1)
Generate the inflected form for the lemma: "biotransformar", according to the following morphological descriptions: "V;1;PL;IMP;POS"	rar (biotransformar) biotransf
Generate the inflected form for the lemma: "pagar", according to the following morphological descriptions: "V;1;PL;COND"	ar pagar pagar pagar pagar pag
Generate the inflected form for the lemma: "designar", according to the following morphological descriptions: "V;1;PL;IND;PST;PFV"	er designar designar designar 
Generate the inflected form for the lemma: "engendrar", according to the following morphological descriptions: "V;2;SG;IMP;POS"	rar (engendrar) (engendrar) (e
Generate the inflected form for the lemma: "jazer", according to the following morphological descriptions: "V;3;PL;IND;PRS"	azer", according to the follow
Generate the inflected form for the lemma: "tratar", according to the following morphological descriptions: "V;1;PL;SBJV;PRS"	ar (tratar) (tratar) (tratar) 
Generate the inflected form for the lemma: "instigar", according to the following morphological descriptions: "V.PTCP;MASC;PL;PST"	rar instigar instigar instigar
Generate the inflected form for the lemma: "leiloar", according to the following morphological descriptions: "V;3;PL;SBJV;FUT"	ar" and "leiloar". The lemma i
Generate the inflected form for the lemma: "uivar", according to the following morphological descriptions: "V;2;PL;IND;PST;PRF"	organizer for the lemma: "uiva
Generate the inflected form for the lemma: "ludibriar", according to the following morphological descriptions: "V;2;SG;IMP;NEG"	riar", according to the follow
Generate the inflected form for the lemma: "complicar", according to the following morphological descriptions: "V;1;PL;IMP;NEG"	er (1) 2010-01-11 10:00:00 UTC
Generate the inflected form for the lemma: "açacalar", according to the following morphological descriptions: "V.PTCP;FEM;SG;PST"	ar", according to the followin
Generate the inflected form for the lemma: "escravizar", according to the following morphological descriptions: "V;1;SG;COND"	ravizar", according to the fol
Generate the inflected form for the lemma: "colorar", according to the following morphological descriptions: "V;1;PL;SBJV;PST;IPFV"	er (1) (1) (1) (1) (1) (1) (1)
Generate the inflected form for the lemma: "cagar", according to the following morphological descriptions: "V;NFIN"	ar", according to the followin
Generate the inflected form for the lemma: "alucinar", according to the following morphological descriptions: "V.PTCP;FEM;SG;PST"	ar (alucinar) alucinar alucina
Generate the inflected form for the lemma: "blogar", according to the following morphological descriptions: "V;2;PL;COND"	ar", according to the followin
Generate the inflected form for the lemma: "enrubescer", according to the following morphological descriptions: "V;2;PL;SBJV;FUT"	rescer", according to the foll
Generate the inflected form for the lemma: "cagar", according to the following morphological descriptions: "V;2;SG;SBJV;PST;IPFV"	ar cagar cagar cagar cagar cag
Generate the inflected form for the lemma: "conjecturar", according to the following morphological descriptions: "V;3;SG;COND"	rar (conjecturar) conjecturar 
Generate the inflected form for the lemma: "assoprar", according to the following morphological descriptions: "V;3;PL;IMP;POS"	rar assoprar assoprar assoprar
Generate the inflected form for the lemma: "destratar", according to the following morphological descriptions: "V;3;SG;IMP;NEG"	ratar (destratar) (destratar) 
Generate the inflected form for the lemma: "crochetar", according to the following morphological descriptions: "V;2;SG;IND;PST;IPFV"	etar (crochetar) (crochetar) (
Generate the inflected form for the lemma: "aquaplanar", according to the following morphological descriptions: "V;3;PL;IND;PST;IPFV"	anar (anar) (anar) (anar) (ana
Generate the inflected form for the lemma: "surtar", according to the following morphological descriptions: "V;1;SG;COND"	ar surtar surtar surtar surtar
Generate the inflected form for the lemma: "silenciar", according to the following morphological descriptions: "V;3;PL;SBJV;PRS"	rar (silenciar) (silenciar) (s
Generate the inflected form for the lemma: "latir", according to the following morphological descriptions: "V;3;SG;SBJV;PRS"	atir latir latir latir latir l
Generate the inflected form for the lemma: "frequentar", according to the following morphological descriptions: "V;NFIN"	requentar", according to the f
Generate the inflected form for the lemma: "içar", according to the following morphological descriptions: "V;1;PL;IND;FUT"	ar" is a sentence of the lemma
Generate the inflected form for the lemma: "sinterizar", according to the following morphological descriptions: "V;3;SG;IND;PRS"	izar", according to the follow
Generate the inflected form for the lemma: "flutuar", according to the following morphological descriptions: "V;2;SG;SBJV;FUT"	ar", according to the followin
Generate the inflected form for the lemma: "leiloar", according to the following morphological descriptions: "V;1;SG;IND;PST;IPFV"	ar (1)
Generate the inflected 
Generate the inflected form for the lemma: "blogar", according to the following morphological descriptions: "V;3;PL;IND;PST;PFV"	ar", according to the followin
Generate the inflected form for the lemma: "lambujar", according to the following morphological descriptions: "V;2;SG;NFIN"	ar", according to the followin
Generate the inflected form for the lemma: "printar", according to the following morphological descriptions: "V;2;PL;IND;FUT"	ar printar printar printar pri
Generate the inflected form for the lemma: "impregnar", according to the following morphological descriptions: "V;2;PL;IMP;POS"	er (1) (1) (1) (1) (1) (1) (1)
Generate the inflected form for the lemma: "attentar", according to the following morphological descriptions: "V;1;SG;IND;PST;PRF"	ar attentar attentar attentar 
Generate the inflected form for the lemma: "arianizar", according to the following morphological descriptions: "V;2;PL;IMP;NEG"	arianizar (arianizar) (arianiz
Generate the inflected form for the lemma: "marchar", according to the following morphological descriptions: "V;3;PL;IND;FUT"	ar", according to the followin
Generate the inflected form for the lemma: "arquejar", according to the following morphological descriptions: "V;1;PL;IMP;POS"	ar ar ar ar ar ar ar ar ar ar 
Generate the inflected form for the lemma: "encriptar", according to the following morphological descriptions: "V;2;SG;SBJV;PST;IPFV"	riptar", according to the foll
Generate the inflected form for the lemma: "manjar", according to the following morphological descriptions: "V;2;PL;IND;PST;PRF"	anjar", according to the follo
Generate the inflected form for the lemma: "alocar", according to the following morphological descriptions: "V;2;SG;IND;PST;PFV"	ocar", according to the follow
Generate the inflected form for the lemma: "vesguear", according to the following morphological descriptions: "V;3;PL;SBJV;FUT"	ar", according to the followin
Generate the inflected form for the lemma: "encetar", according to the following morphological descriptions: "V;3;PL;SBJV;PST;IPFV"	etar", according to the follow
Generate the inflected form for the lemma: "eliminar", according to the following morphological descriptions: "V;2;SG;IMP;NEG"	er er er er er er er er er er 
Generate the inflected form for the lemma: "ziguezaguear", according to the following morphological descriptions: "V;1;PL;SBJV;FUT"	ar", according to the followin
Generate the inflected form for the lemma: "bombardear", according to the following morphological descriptions: "V;3;SG;SBJV;PST;IPFV"	r (bombardear) (bombardear) (b
Generate the inflected form for the lemma: "ladrar", according to the following morphological descriptions: "V;1;SG;IND;PST;PRF"	ar", according to the followin
Generate the inflected form for the lemma: "amamentar", according to the following morphological descriptions: "V.PTCP;MASC;PL;PST"	ar amamentar amamentar amament
Generate the inflected form for the lemma: "protrair", according to the following morphological descriptions: "V;3;PL;IMP;POS"	rair (protrair) (protrair) (pr
Generate the inflected form for the lemma: "menosprezar", according to the following morphological descriptions: "V;2;SG;IND;FUT"	rezar", according to the follo
Generate the inflected form for the lemma: "botar", according to the following morphological descriptions: "V;3;SG;IMP;POS"	ar (1992) [1] [2] [3] [4] [5] 
Generate the inflected form for the lemma: "ascender", according to the following morphological descriptions: "V;1;PL;IND;FUT"	er", according to the followin
Generate the inflected form for the lemma: "ruir", according to the following morphological descriptions: "V;3;PL;NFIN"	r ruir ruir ruir ruir ruir rui
Generate the inflected form for the lemma: "munir", according to the following morphological descriptions: "V;1;PL;NFIN"	ir munir munir munir munir mun
Generate the inflected form for the lemma: "estimular", according to the following morphological descriptions: "V;3;PL;SBJV;PRS"	ar (estimular) estimular estim
Generate the inflected form for the lemma: "bombardear", according to the following morphological descriptions: "V;1;SG;IND;FUT"	rator", according to the follo
Generate the inflected form for the lemma: "escassear", according to the following morphological descriptions: "V;3;PL;IND;FUT"	ear", according to the followi
Generate the inflected form for the lemma: "registrar", according to the following morphological descriptions: "V;2;PL;NFIN"	er", according to the followin
Generate the inflected form for the lemma: "maquinar", according to the following morphological descriptions: "V;2;SG;SBJV;PRS"	ar maquinar maquinar maquinar 
Generate the inflected form for the lemma: "embasar", according to the following morphological descriptions: "V;3;SG;IMP;NEG"	ar embasar embasar embasar emb
Generate the inflected form for the lemma: "sonambular", according to the following morphological descriptions: "V;2;PL;IMP;POS"	arante the lemma: "sonambular"
Generate the inflected form for the lemma: "frequentar", according to the following morphological descriptions: "V;2;SG;SBJV;FUT"	r", according to the following
Generate the inflected form for the lemma: "comprehender", according to the following morphological descriptions: "V;2;SG;NFIN"	er", according to the followin
Generate the inflected form for the lemma: "lambujar", according to the following morphological descriptions: "V;1;PL;SBJV;PRS"	ar (1) 2010-01-11 10:00:00 UTC
Generate the inflected form for the lemma: "crescer", according to the following morphological descriptions: "V;1;PL;IND;PST;PFV"	er", according to the followin
Generate the inflected form for the lemma: "leiloar", according to the following morphological descriptions: "V;3;SG;IND;FUT"	ar" and "leiloar".
Generate th
Generate the inflected form for the lemma: "antidotar", according to the following morphological descriptions: "V;NFIN"	idotar", according to the foll
Generate the inflected form for the lemma: "sufocar", according to the following morphological descriptions: "V;1;SG;COND"	ocar", according to the follow
Generate the inflected form for the lemma: "rufar", according to the following morphological descriptions: "V;2;PL;IND;PST;PFV"	ar (rufar) (rufar) (rufar) (ru
Generate the inflected form for the lemma: "estrumar", according to the following morphological descriptions: "V.PTCP;MASC;SG;PST"	ar (estrumar) estrumar estruma
Generate the inflected form for the lemma: "registar", according to the following morphological descriptions: "V;2;SG;IND;PST;PRF"	er (1) (1) (1) (1) (1) (1) (1)
Generate the inflected form for the lemma: "postular", according to the following morphological descriptions: "V.PTCP;FEM;SG;PST"	ar 2010-01-11 10:00:00 UTC # 1
Generate the inflected form for the lemma: "anabolizar", according to the following morphological descriptions: "V;2;PL;SBJV;PRS"	ar anabolizar anabolizar anabo
Generate the inflected form for the lemma: "printar", according to the following morphological descriptions: "V;2;SG;COND"	ar printar printar printar pri
Generate the inflected form for the lemma: "desvairar", according to the following morphological descriptions: "V;NFIN"	rar", according to the followi
Generate the inflected form for the lemma: "desrespeitar", according to the following morphological descriptions: "V.PTCP;MASC;SG;PST"	respeitar", according to the f
Generate the inflected form for the lemma: "prover", according to the following morphological descriptions: "V;2;SG;SBJV;PST;IPFV"	r prover prover prover prover 
Generate the inflected form for the lemma: "comichar", according to the following morphological descriptions: "V;1;PL;IND;PST;IPFV"	ar (ar) (ar) (ar) (ar) (ar) (a
Generate the inflected form for the lemma: "telhar", according to the following morphological descriptions: "V;1;PL;IMP;NEG"	ar (1) (1) (1) (1) (1) (1) (1)
Generate the inflected form for the lemma: "assemelhar", according to the following morphological descriptions: "V;3;SG;IMP;POS"	ar assemelhar assemelhar assem
Generate the inflected form for the lemma: "simpatizar", according to the following morphological descriptions: "V;1;SG;SBJV;PST;IPFV"	izar", according to the follow
Generate the inflected form for the lemma: "deliciar", according to the following morphological descriptions: "V;3;PL;COND"	er (1992) (1992) (1992) (1992)
Generate the inflected form for the lemma: "flutuar", according to the following morphological descriptions: "V;1;SG;SBJV;PST;IPFV"	ar (1) (1) (1) (1) (1) (1) (1)
Generate the inflected form for the lemma: "ladrar", according to the following morphological descriptions: "V;3;PL;IND;PST;PFV"	ar", according to the followin
Generate the inflected form for the lemma: "expectorar", according to the following morphological descriptions: "V;1;SG;NFIN"	ar" and the following morpholo
Generate the inflected form for the lemma: "munir", according to the following morphological descriptions: "V;2;SG;NFIN"	ir munir munir munir munir mun
Generate the inflected form for the lemma: "destratar", according to the following morphological descriptions: "V;3;PL;IND;PST;PFV"	ratar", according to the follo
Generate the inflected form for the lemma: "estocar", according to the following morphological descriptions: "V;3;SG;IND;PST;PRF"	ocar", according to the follow
Generate the inflected form for the lemma: "kickar", according to the following morphological descriptions: "V;1;PL;SBJV;PST;IPFV"	ar kickar kickar kickar kickar
Generate the inflected form for the lemma: "ponderar", according to the following morphological descriptions: "V;3;PL;SBJV;FUT"	rar", according to the followi
Generate the inflected form for the lemma: "desarmar", according to the following morphological descriptions: "V;1;SG;IND;PRS"	r desarmar desarmar desarmar d
Generate the inflected form for the lemma: "terminar", according to the following morphological descriptions: "V.PTCP;FEM;PL;PST"	er (1) (1) (1) (1) (1) (1) (1)
Generate the inflected form for the lemma: "antidotar", according to the following morphological descriptions: "V;3;SG;IMP;NEG"	ar antidotar antidotar antidot
Generate the inflected form for the lemma: "remunerar", according to the following morphological descriptions: "V;1;PL;IND;PST;IPFV"	erar", according to the follow
Generate the inflected form for the lemma: "vomitar", according to the following morphological descriptions: "V;1;SG;NFIN"	ar vomitar vomitar vomitar vom
Generate the inflected form for the lemma: "ponderar", according to the following morphological descriptions: "V;2;SG;IMP;NEG"	rar", according to the followi
Generate the inflected form for the lemma: "vesguear", according to the following morphological descriptions: "V.PTCP;MASC;PL;PST"	ar (vesguear) (vesguear) (vesg
Generate the inflected form for the lemma: "analisar", according to the following morphological descriptions: "V;2;SG;COND"	ar analisar analisar analisar 
Generate the inflected form for the lemma: "realçar", according to the following morphological descriptions: "V.PTCP;MASC;PL;PST"	ar", according to the followin
Generate the inflected form for the lemma: "arquivar", according to the following morphological descriptions: "V;1;SG;IND;PST;PFV"	ar ar ar ar ar ar ar ar ar ar 
Generate the inflected form for the lemma: "secundar", according to the following morphological descriptions: "V;3;SG;IND;PST;PFV"	ar 2018-01-18 14:14:00
Generat
Generate the inflected form for the lemma: "adjudicar", according to the following morphological descriptions: "V;2;PL;IND;PST;PFV"	ar adjudicar adjudicar adjudic
Generate the inflected form for the lemma: "arianizar", according to the following morphological descriptions: "V;1;SG;COND"	ing and designing a set of the
Generate the inflected form for the lemma: "açacalar", according to the following morphological descriptions: "V;2;SG;IMP;NEG"	ararararararararararararararar
Generate the inflected form for the lemma: "marchar", according to the following morphological descriptions: "V;2;SG;NFIN"	ar", according to the followin
Generate the inflected form for the lemma: "desrespeitar", according to the following morphological descriptions: "V;2;PL;IND;PST;PRF"	erar desrespeitar desrespeitar
Generate the inflected form for the lemma: "estimular", according to the following morphological descriptions: "V;2;PL;SBJV;PST;IPFV"	ar (estimular) estimular estim
Generate the inflected form for the lemma: "abafar", according to the following morphological descriptions: "V;2;SG;NFIN"	ar", according to the followin
Generate the inflected form for the lemma: "sobressair", according to the following morphological descriptions: "V;3;PL;COND"	er (1995) (1995) (1995) (1995)
Generate the inflected form for the lemma: "desentranhar", according to the following morphological descriptions: "V;1;PL;IND;FUT"	ar desentranhar desentranhar d
Generate the inflected form for the lemma: "blasonar", according to the following morphological descriptions: "V;1;PL;IMP;NEG"	ar (blasonar) (blasonar) (blas
Generate the inflected form for the lemma: "arrebentar", according to the following morphological descriptions: "V;3;SG;SBJV;PRS"	rebentar (arrebentar) (arreben
Generate the inflected form for the lemma: "simbolizar", according to the following morphological descriptions: "V;3;SG;NFIN"	izar", according to the follow
Generate the inflected form for the lemma: "acortinar", according to the following morphological descriptions: "V;3;SG;IND;FUT"	ar", according to the followin
Generate the inflected form for the lemma: "crochetar", according to the following morphological descriptions: "V;3;SG;IND;PST;PFV"	etar", according to the follow
Generate the inflected form for the lemma: "açacalar", according to the following morphological descriptions: "V;2;SG;IND;PRS"	ararararararararararararararar
Generate the inflected form for the lemma: "cumprimentar", according to the following morphological descriptions: "V;1;SG;IND;FUT"	ar (ar) (ar) (ar) (ar) (ar) (a
Generate the inflected form for the lemma: "vincular", according to the following morphological descriptions: "V;1;PL;IND;PRS"	ar vincular vincular vincular 
Generate the inflected form for the lemma: "latir", according to the following morphological descriptions: "V;1;SG;SBJV;PST;IPFV"	ir latir latir latir latir lat
Generate the inflected form for the lemma: "agradar", according to the following morphological descriptions: "V;2;SG;SBJV;PRS"	ar agradar agradar agradar agr
Generate the inflected form for the lemma: "silenciar", according to the following morphological descriptions: "V.PTCP;FEM;SG;PST"	rar", according to the followi
Generate the inflected form for the lemma: "derrapar", according to the following morphological descriptions: "V;2;SG;COND"	rapar", according to the follo
Generate the inflected form for the lemma: "desentranhar", according to the following morphological descriptions: "V;2;SG;IND;PST;PFV"	ar desentranhar desentranhar d
Generate the inflected form for the lemma: "botar", according to the following morphological descriptions: "V;3;SG;IND;PST;PRF"	ar", according to the followin
Generate the inflected form for the lemma: "escavar", according to the following morphological descriptions: "V;1;SG;IND;PRS"	r escavar escavar escavar esca
Generate the inflected form for the lemma: "sobressair", according to the following morphological descriptions: "V;3;SG;COND"	out the lemma: "sobressair".
G
Generate the inflected form for the lemma: "zumbificar", according to the following morphological descriptions: "V;1;SG;SBJV;PST;IPFV"	ificar", according to the foll
Generate the inflected form for the lemma: "confraternizar", according to the following morphological descriptions: "V;2;SG;SBJV;PST;IPFV"	izar", according to the follow
Generate the inflected form for the lemma: "parcelar", according to the following morphological descriptions: "V;3;SG;SBJV;PST;IPFV"	ar 2019-01-19 14:14:00
Generat
Generate the inflected form for the lemma: "prender", according to the following morphological descriptions: "V;2;SG;COND"	render", according to the foll
Generate the inflected form for the lemma: "sociabilizar", according to the following morphological descriptions: "V;2;PL;SBJV;PST;IPFV"	izar", according to the follow
Generate the inflected form for the lemma: "alocar", according to the following morphological descriptions: "V;1;PL;COND"	ocar", according to the follow
Generate the inflected form for the lemma: "comprehender", according to the following morphological descriptions: "V;1;SG;SBJV;PRS"	er", according to the followin
Generate the inflected form for the lemma: "fatorar", according to the following morphological descriptions: "V;3;PL;NFIN"	ar", according to the followin
Generate the inflected form for the lemma: "terminar", according to the following morphological descriptions: "V;3;SG;IMP;POS"	er (1992) (1992) (1992) (1992)
Generate the inflected form for the lemma: "adoecer", according to the following morphological descriptions: "V;2;SG;COND"	er", according to the followin
Generate the inflected form for the lemma: "agradar", according to the following morphological descriptions: "V;1;PL;IND;PRS"	ar agradar agradar agradar agr
Generate the inflected form for the lemma: "retaliar", according to the following morphological descriptions: "V;3;SG;NFIN"	er (1) (1) (1) (1) (1) (1) (1)
Generate the inflected form for the lemma: "vomitar", according to the following morphological descriptions: "V;3;SG;IND;PST;PFV"	ar vomitar vomitar vomitar vom
Generate the inflected form for the lemma: "resplandecer", according to the following morphological descriptions: "V;1;PL;COND"	er", according to the followin
Generate the inflected form for the lemma: "designar", according to the following morphological descriptions: "V;3;SG;SBJV;FUT"	r", according to the following
Generate the inflected form for the lemma: "adjudicar", according to the following morphological descriptions: "V;1;SG;SBJV;PRS"	ar adjudicar adjudicar adjudic
Generate the inflected form for the lemma: "adivinhar", according to the following morphological descriptions: "V;2;PL;IND;FUT"	ar adivinhar adivinhar adivinh
Generate the inflected form for the lemma: "instigar", according to the following morphological descriptions: "V;2;SG;SBJV;PRS"	rar instigar instigar instigar
Generate the inflected form for the lemma: "inquirir", according to the following morphological descriptions: "V;3;PL;IMP;POS"	rir", according to the followi
Generate the inflected form for the lemma: "mutilar", according to the following morphological descriptions: "V;3;PL;IND;PST;IPFV"	ar (1)
Generate the inflected 
Generate the inflected form for the lemma: "entrar", according to the following morphological descriptions: "V;1;SG;COND"	rar", according to the followi
Generate the inflected form for the lemma: "denominar", according to the following morphological descriptions: "V;1;SG;IND;FUT"	enominar" and "denominar".
Gen
Generate the inflected form for the lemma: "guarnecer", according to the following morphological descriptions: "V;2;SG;IND;PST;PFV"	er", according to the followin
Generate the inflected form for the lemma: "desentranhar", according to the following morphological descriptions: "V;2;PL;IND;PST;PRF"	ar desentranhar desentranhar d
Generate the inflected form for the lemma: "desdizer", according to the following morphological descriptions: "V;1;SG;NFIN"	er", according to the followin
Generate the inflected form for the lemma: "arquivar", according to the following morphological descriptions: "V;1;PL;IND;PST;PRF"	ar ar ar ar ar ar ar ar ar ar 
Generate the inflected form for the lemma: "seguir", according to the following morphological descriptions: "V;1;SG;SBJV;PRS"	er seguir seguir seguir seguir
Generate the inflected form for the lemma: "redimir", according to the following morphological descriptions: "V;3;SG;IND;PST;PFV"	ir", according to the followin
Generate the inflected form for the lemma: "tretar", according to the following morphological descriptions: "V;2;SG;SBJV;FUT"	ar", according to the followin
Generate the inflected form for the lemma: "teorizar", according to the following morphological descriptions: "V;2;PL;IND;PST;IPFV"	erar", according to the follow
Generate the inflected form for the lemma: "escassear", according to the following morphological descriptions: "V;3;SG;IND;PST;PFV"	ear", according to the followi
Generate the inflected form for the lemma: "impregnar", according to the following morphological descriptions: "V;3;SG;IND;PST;PRF"	regnar", according to the foll
Generate the inflected form for the lemma: "açacalar", according to the following morphological descriptions: "V;1;SG;IND;PST;IPFV"	ararararararararararararararar
Generate the inflected form for the lemma: "encomendar", according to the following morphological descriptions: "V;2;PL;IND;PST;IPFV"	rarararararararararararararara
Generate the inflected form for the lemma: "festar", according to the following morphological descriptions: "V;3;SG;IND;PST;IPFV"	ar festar festar festar festar
Generate the inflected form for the lemma: "encetar", according to the following morphological descriptions: "V;3;SG;IND;FUT"	etar", according to the follow
Generate the inflected form for the lemma: "tanger", according to the following morphological descriptions: "V;2;PL;SBJV;PST;IPFV"	er (1) (1) (1) (1) (1) (1) (1)
Generate the inflected form for the lemma: "encetar", according to the following morphological descriptions: "V;2;PL;IMP;NEG"	etar (encetar) (encetar) (ence
Generate the inflected form for the lemma: "instigar", according to the following morphological descriptions: "V;3;PL;SBJV;PST;IPFV"	rar", according to the followi
Generate the inflected form for the lemma: "maltar", according to the following morphological descriptions: "V;1;SG;SBJV;PST;IPFV"	ar (1) 2018 (1) 2019 (1) 2019 
Generate the inflected form for the lemma: "entrar", according to the following morphological descriptions: "V;3;PL;NFIN"	rar", according to the followi
Generate the inflected form for the lemma: "visar", according to the following morphological descriptions: "V;3;PL;IND;PST;PRF"	ar", according to the followin
Generate the inflected form for the lemma: "consolidar", according to the following morphological descriptions: "V;3;SG;SBJV;PST;IPFV"	; consolidar; consolidar conso
Generate the inflected form for the lemma: "cumprir", according to the following morphological descriptions: "V;2;SG;NFIN"	r cumprir cumprir cumprir cump
Generate the inflected form for the lemma: "afundir", according to the following morphological descriptions: "V;3;SG;NFIN"	ir afundir afundir afundir afu
Generate the inflected form for the lemma: "expectorar", according to the following morphological descriptions: "V.PTCP;MASC;SG;PST"	ararararararararararararararar
Generate the inflected form for the lemma: "criticar", according to the following morphological descriptions: "V;2;SG;IMP;POS"	ar (criticar) (criticar) (crit
Generate the inflected form for the lemma: "desarranjar", according to the following morphological descriptions: "V.PTCP;FEM;PL;PST"	ranjar", according to the foll
Generate the inflected form for the lemma: "refogar", according to the following morphological descriptions: "V;2;SG;SBJV;PST;IPFV"	ogar (refogar) (refogar) (refo
Generate the inflected form for the lemma: "ziguezaguear", according to the following morphological descriptions: "V;1;SG;IND;PRS"	ar (ziguezaguear) (1) (1) (1) 
Generate the inflected form for the lemma: "bebericar", according to the following morphological descriptions: "V;2;SG;SBJV;PRS"	inflected form for the lemma: 
Generate the inflected form for the lemma: "publicitar", according to the following morphological descriptions: "V;3;SG;IND;PST;IPFV"	er (1992) (1992) (1992) (1992)
Generate the inflected form for the lemma: "blasonar", according to the following morphological descriptions: "V;2;PL;COND"	ar (1996) (1996) (1997) (1998)
Generate the inflected form for the lemma: "inquirir", according to the following morphological descriptions: "V.PTCP;FEM;PL;PST"	rir", according to the followi
Generate the inflected form for the lemma: "estimar", according to the following morphological descriptions: "V;2;SG;IND;FUT"	era de la palabra de la palabr
Generate the inflected form for the lemma: "uivar", according to the following morphological descriptions: "V;2;SG;SBJV;FUT"	ivar", according to the follow
Generate the inflected form for the lemma: "cuidar", according to the following morphological descriptions: "V;2;SG;IND;FUT"	ar", according to the followin
Generate the inflected form for the lemma: "absceder", according to the following morphological descriptions: "V;2;PL;IND;PST;IPFV"	er", according to the followin
Generate the inflected form for the lemma: "alucinar", according to the following morphological descriptions: "V;1;SG;IND;FUT"	ar (alucinar) (alucinar) (aluc
Generate the inflected form for the lemma: "designar", according to the following morphological descriptions: "V;3;PL;IND;PRS"	er designar designar designar 
Generate the inflected form for the lemma: "aquaplanar", according to the following morphological descriptions: "V;3;PL;IND;PRS"	anar (anar) (anar) (anar) (ana
Generate the inflected form for the lemma: "deixar", according to the following morphological descriptions: "V;2;PL;IND;PST;PFV"	er er er er er er er er er er 
Generate the inflected form for the lemma: "agachar", according to the following morphological descriptions: "V;1;SG;IND;PST;PFV"	ar agachar agachar agachar aga
Generate the inflected form for the lemma: "simpatizar", according to the following morphological descriptions: "V;1;PL;IND;PST;IPFV"	izar", according to the follow
Generate the inflected form for the lemma: "pegar", according to the following morphological descriptions: "V;2;PL;IND;PST;PFV"	ar", according to the followin
Generate the inflected form for the lemma: "rufar", according to the following morphological descriptions: "V;2;PL;IND;PST;PRF"	ar (rufar) (rufar) (rufar) (ru
Generate the inflected form for the lemma: "estercar", according to the following morphological descriptions: "V.PTCP;PRS"	ra (1872-1942) - Santa Cruz (1
Generate the inflected form for the lemma: "instigar", according to the following morphological descriptions: "V;3;PL;NFIN"	rar", according to the followi
Generate the inflected form for the lemma: "citar", according to the following morphological descriptions: "V.PTCP;MASC;PL;PST"	 1 2 3 4 5 6 7 8 9 10 11 12 13
Generate the inflected form for the lemma: "mumificar", according to the following morphological descriptions: "V;3;SG;SBJV;PRS"	icar", according to the follow
Generate the inflected form for the lemma: "antidotar", according to the following morphological descriptions: "V;3;PL;IND;PST;PRF"	otar (antidotar) (antidotar) (
Generate the inflected form for the lemma: "bombardear", according to the following morphological descriptions: "V;2;PL;SBJV;FUT"	rator", according to the follo
Generate the inflected form for the lemma: "predominar", according to the following morphological descriptions: "V.PTCP;MASC;SG;PST"	er (1992) (1992) (1992) (1992)
Generate the inflected form for the lemma: "concordar", according to the following morphological descriptions: "V;3;PL;NFIN"	rar", according to the followi
Generate the inflected form for the lemma: "estocar", according to the following morphological descriptions: "V;1;SG;IND;FUT"	ocar", according to the follow
Generate the inflected form for the lemma: "visitar", according to the following morphological descriptions: "V;2;SG;IMP;POS"	r visitar visitar visitar visi
Generate the inflected form for the lemma: "designar", according to the following morphological descriptions: "V;3;PL;SBJV;PRS"	er designar designar designar 
Generate the inflected form for the lemma: "proceder", according to the following morphological descriptions: "V;3;SG;IMP;NEG"	er", according to the followin
Generate the inflected form for the lemma: "safar", according to the following morphological descriptions: "V;1;SG;COND"	ar (safar) (safar) (safar) (sa
Generate the inflected form for the lemma: "enramalhetar", according to the following morphological descriptions: "V;2;PL;COND"	ar enramalhetar enramalhetar e
Generate the inflected form for the lemma: "confraternizar", according to the following morphological descriptions: "V;2;PL;IMP;POS"	izar", according to the follow
Generate the inflected form for the lemma: "impregnar", according to the following morphological descriptions: "V;2;PL;NFIN"	regnar", according to the foll
Generate the inflected form for the lemma: "abafar", according to the following morphological descriptions: "V;2;PL;IND;PST;PFV"	ar", according to the followin
Generate the inflected form for the lemma: "deixar", according to the following morphological descriptions: "V;3;SG;IND;PST;PRF"	reign of the lemma: "deixar", 
Generate the inflected form for the lemma: "abafar", according to the following morphological descriptions: "V;2;SG;IMP;POS"	ar abafar abafar abafar abafar
Generate the inflected form for the lemma: "existir", according to the following morphological descriptions: "V;2;PL;COND"	r existir existir existir exis
Generate the inflected form for the lemma: "vir", according to the following morphological descriptions: "V;3;PL;IND;PST;PRF"	ir", according to the followin
Generate the inflected form for the lemma: "deliciar", according to the following morphological descriptions: "V;1;PL;SBJV;PRS"	er (1)
Generate the inflected 
Generate the inflected form for the lemma: "saturar", according to the following morphological descriptions: "V;2;PL;IMP;POS"	ar saturar saturar saturar sat
Generate the inflected form for the lemma: "auferir", according to the following morphological descriptions: "V;3;SG;IND;PRS"	re auferir auferir auferir auf
Generate the inflected form for the lemma: "regularizar", according to the following morphological descriptions: "V.PTCP;MASC;SG;PST"	erar (regularizar) (regulariza
Generate the inflected form for the lemma: "corroborar", according to the following morphological descriptions: "V;3;SG;IMP;POS"	rar (corroborar)) - corroborar
Generate the inflected form for the lemma: "harmonizar", according to the following morphological descriptions: "V;1;SG;SBJV;PRS"	ar (harmonizar) (harmonizar) (
Generate the inflected form for the lemma: "auguriar", according to the following morphological descriptions: "V;2;PL;IND;FUT"	ar auguriar auguriar auguriar 
Generate the inflected form for the lemma: "vir", according to the following morphological descriptions: "V;2;PL;SBJV;PRS"	ir vir vir vir vir vir vir vir
Generate the inflected form for the lemma: "reiterar", according to the following morphological descriptions: "V;3;PL;IMP;NEG"	erar (reiterar) (reiterar) (re
Generate the inflected form for the lemma: "alfabetizar", according to the following morphological descriptions: "V;3;PL;COND"	ar alfabetizar alfabetizar alf
Generate the inflected form for the lemma: "pisotear", according to the following morphological descriptions: "V;1;PL;NFIN"	ear (pisotear) is a pisotear i
Generate the inflected form for the lemma: "estipular", according to the following morphological descriptions: "V;2;SG;SBJV;FUT"	ar", according to the followin
Generate the inflected form for the lemma: "ensaboar", according to the following morphological descriptions: "V;2;SG;IND;FUT"	ar ensaboar ensaboar ensaboar 
Generate the inflected form for the lemma: "talhar", according to the following morphological descriptions: "V;2;SG;SBJV;FUT"	ar", according to the followin
Generate the inflected form for the lemma: "criticar", according to the following morphological descriptions: "V;2;PL;SBJV;PST;IPFV"	ar (criticar) criticar critica
Generate the inflected form for the lemma: "terminar", according to the following morphological descriptions: "V;2;SG;COND"	er (1992) (1992) (1992) (1992)
Generate the inflected form for the lemma: "derrapar", according to the following morphological descriptions: "V;2;PL;IND;PRS"	rapar (derrapar) (derrapar) (d
Generate the inflected form for the lemma: "brincar", according to the following morphological descriptions: "V;1;PL;IND;PRS"	rar brincar brincar brincar br
Generate the inflected form for the lemma: "retinir", according to the following morphological descriptions: "V;2;SG;SBJV;PRS"	er retinir retinir retinir ret
Generate the inflected form for the lemma: "enramalhetar", according to the following morphological descriptions: "V;2;SG;SBJV;PST;IPFV"	ar enramalhetar enramalhetar e
Generate the inflected form for the lemma: "estercar", according to the following morphological descriptions: "V;1;PL;SBJV;PST;IPFV"	ercar", according to the follo
Generate the inflected form for the lemma: "maltar", according to the following morphological descriptions: "V;2;PL;IND;FUT"	ar (1999) - Malta (1999) - Mal
Generate the inflected form for the lemma: "commandar", according to the following morphological descriptions: "V;NFIN"	 commandar commandar commandar
Generate the inflected form for the lemma: "gatunar", according to the following morphological descriptions: "V;2;SG;SBJV;PST;IPFV"	ar gatunar gatunar gatunar gat
Generate the inflected form for the lemma: "amancebar", according to the following morphological descriptions: "V;3;PL;NFIN"	ar", according to the followin
Generate the inflected form for the lemma: "deixar", according to the following morphological descriptions: "V;1;PL;SBJV;PRS"	ra de deixar de deixar de deix
Generate the inflected form for the lemma: "bombardear", according to the following morphological descriptions: "V;2;SG;IMP;NEG"	er (bombardear) (bombardear) (
Generate the inflected form for the lemma: "escravizar", according to the following morphological descriptions: "V;1;SG;SBJV;FUT"	ravizar", according to the fol
Generate the inflected form for the lemma: "amaynar", according to the following morphological descriptions: "V;2;PL;SBJV;PST;IPFV"	ar amaynar amaynar amaynar ama
Generate the inflected form for the lemma: "delimitar", according to the following morphological descriptions: "V;3;SG;NFIN"	er (1992) (1992) (1992) (1992)
Generate the inflected form for the lemma: "sociabilizar", according to the following morphological descriptions: "V;2;PL;IMP;POS"	izar", according to the follow
Generate the inflected form for the lemma: "blasonar", according to the following morphological descriptions: "V;2;PL;SBJV;PST;IPFV"	ar (blasonar) (blasonar) (blas
Generate the inflected form for the lemma: "tosar", according to the following morphological descriptions: "V;2;PL;IND;FUT"	ar (tosar) (tosar) (tosar) (to
Generate the inflected form for the lemma: "encriptar", according to the following morphological descriptions: "V;2;PL;SBJV;PRS"	riptar", according to the foll
Generate the inflected form for the lemma: "administrar", according to the following morphological descriptions: "V;1;PL;IND;FUT"	rar". The following inflected 
Generate the inflected form for the lemma: "ousar", according to the following morphological descriptions: "V;2;PL;IND;FUT"	ar ousar ousar ousar ousar ous
Generate the inflected form for the lemma: "escassear", according to the following morphological descriptions: "V;2;PL;SBJV;FUT"	er", according to the followin
Generate the inflected form for the lemma: "adoecer", according to the following morphological descriptions: "V;3;SG;IND;PST;PRF"	er", according to the followin
Generate the inflected form for the lemma: "existir", according to the following morphological descriptions: "V;2;PL;SBJV;PST;IPFV"	r existir existir existir exis
Generate the inflected form for the lemma: "escassear", according to the following morphological descriptions: "V.PTCP;PRS"	rear escassear escassear escas
Generate the inflected form for the lemma: "estipular", according to the following morphological descriptions: "V;3;SG;IMP;POS"	ar estipular estipular estipul
Generate the inflected form for the lemma: "estrumar", according to the following morphological descriptions: "V;3;PL;IND;PRS"	era de la letra de la letra de
Generate the inflected form for the lemma: "incorporar", according to the following morphological descriptions: "V;2;SG;IND;PST;PRF"	orar incorporar incorporar inc
Generate the inflected form for the lemma: "contrabalançar", according to the following morphological descriptions: "V;1;PL;NFIN"	rar", according to the followi
Generate the inflected form for the lemma: "aparafusar", according to the following morphological descriptions: "V;3;PL;NFIN"	arafusar", according to the fo
Generate the inflected form for the lemma: "contra-atacar", according to the following morphological descriptions: "V;2;PL;IND;PST;IPFV"	atacar", according to the foll
Generate the inflected form for the lemma: "ablegar", according to the following morphological descriptions: "V;1;PL;NFIN"	rar", according to the followi
Generate the inflected form for the lemma: "patentear", according to the following morphological descriptions: "V;3;SG;IND;PST;IPFV"	ar patentear patentear patente
Generate the inflected form for the lemma: "lesmar", according to the following morphological descriptions: "V;1;SG;IND;PRS"	er - er - er - er - er - er - 
Generate the inflected form for the lemma: "adoecer", according to the following morphological descriptions: "V;1;PL;SBJV;FUT"	er", according to the followin
Generate the inflected form for the lemma: "tilintar", according to the following morphological descriptions: "V;3;PL;IND;PRS"	ar ar ar ar ar ar ar ar ar ar 
Generate the inflected form for the lemma: "condenar", according to the following morphological descriptions: "V;2;PL;IND;PRS"	 form for the lemma: "condenar
Generate the inflected form for the lemma: "ensaboar", according to the following morphological descriptions: "V;2;PL;IND;FUT"	ar ensaboar ensaboar ensaboar 
Generate the inflected form for the lemma: "commandar", according to the following morphological descriptions: "V;3;SG;COND"	 form for the lemma: "commanda
Generate the inflected form for the lemma: "delinear", according to the following morphological descriptions: "V;1;PL;IND;PST;PFV"	ear (1)
Generate the inflected
Generate the inflected form for the lemma: "ziguezaguear", according to the following morphological descriptions: "V;3;PL;SBJV;PRS"	ar (ziguezaguear) (ziguezaguea
Generate the inflected form for the lemma: "colorar", according to the following morphological descriptions: "V;3;PL;SBJV;FUT"	ar", according to the followin
Generate the inflected form for the lemma: "impregnar", according to the following morphological descriptions: "V;2;SG;SBJV;PST;IPFV"	regnar", according to the foll
Generate the inflected form for the lemma: "sinterizar", according to the following morphological descriptions: "V;1;PL;SBJV;PST;IPFV"	izar", according to the follow
Generate the inflected form for the lemma: "atenazar", according to the following morphological descriptions: "V;2;PL;NFIN"	ar", according to the followin
Generate the inflected form for the lemma: "teorizar", according to the following morphological descriptions: "V;3;SG;IND;FUT"	erizar", according to the foll
Generate the inflected form for the lemma: "alocar", according to the following morphological descriptions: "V;2;PL;IMP;POS"	ar alocar alocar alocar alocar
Generate the inflected form for the lemma: "sociabilizar", according to the following morphological descriptions: "V;3;PL;SBJV;FUT"	izar", according to the follow
Generate the inflected form for the lemma: "antidotar", according to the following morphological descriptions: "V;1;SG;IND;PST;PFV"	otar (antidotar) (antidotar) (
Generate the inflected form for the lemma: "conjecturar", according to the following morphological descriptions: "V;3;SG;IND;PRS"	 form for the lemma: "conjectu
Generate the inflected form for the lemma: "tilintar", according to the following morphological descriptions: "V;3;PL;COND"	ar ar ar ar ar ar ar ar ar ar 
Generate the inflected form for the lemma: "ascender", according to the following morphological descriptions: "V;3;SG;NFIN"	er", according to the followin
Generate the inflected form for the lemma: "aquaplanar", according to the following morphological descriptions: "V;2;PL;IND;PRS"	anar (anar) (anar) (anar) (ana
Generate the inflected form for the lemma: "incorporar", according to the following morphological descriptions: "V;2;PL;IMP;NEG"	er (1992) (1992) (1992) (1992)
Generate the inflected form for the lemma: "talhar", according to the following morphological descriptions: "V;2;SG;IND;PST;PRF"	ar (talhar) (talhar) (talhar) 
Generate the inflected form for the lemma: "silenciar", according to the following morphological descriptions: "V;2;PL;IND;PST;PFV"	ir (silenciar) (silenciar) (si
Generate the inflected form for the lemma: "reiterar", according to the following morphological descriptions: "V;1;PL;SBJV;FUT"	rar" and "reiterar". The lemma
Generate the inflected form for the lemma: "contrair", according to the following morphological descriptions: "V;1;SG;IND;PST;PRF"	r contrair contrair contrair c
Generate the inflected form for the lemma: "privilegiar", according to the following morphological descriptions: "V;1;PL;SBJV;FUT"	rar", according to the followi
Generate the inflected form for the lemma: "expectorar", according to the following morphological descriptions: "V;1;SG;COND"	ar", according to the followin
Generate the inflected form for the lemma: "attentar", according to the following morphological descriptions: "V;1;PL;SBJV;FUT"	ar", according to the followin
Generate the inflected form for the lemma: "expectorar", according to the following morphological descriptions: "V;3;PL;IND;PST;PFV"	erar", according to the follow
Generate the inflected form for the lemma: "sinterizar", according to the following morphological descriptions: "V;3;PL;IND;PST;PRF"	izar", according to the follow
Generate the inflected form for the lemma: "desdizer", according to the following morphological descriptions: "V;1;PL;IND;PRS"	er desdizer desdizer desdizer 
Generate the inflected form for the lemma: "estimular", according to the following morphological descriptions: "V;1;SG;COND"	estimular", according to the f
Generate the inflected form for the lemma: "saturar", according to the following morphological descriptions: "V;3;PL;NFIN"	ar", according to the followin
Generate the inflected form for the lemma: "protrair", according to the following morphological descriptions: "V;3;PL;IND;PST;PFV"	rair", according to the follow
Generate the inflected form for the lemma: "registar", according to the following morphological descriptions: "V;3;PL;IND;FUT"	er (1995) (1995) (1996) (1997)
Generate the inflected form for the lemma: "ousar", according to the following morphological descriptions: "V;3;PL;IND;PST;PRF"	ar ousar ousar ousar ousar ous
Generate the inflected form for the lemma: "barbear", according to the following morphological descriptions: "V;1;PL;IND;PRS"	arbear", according to the foll
Generate the inflected form for the lemma: "torrar", according to the following morphological descriptions: "V;3;PL;IND;PRS"	rar", according to the followi
Generate the inflected form for the lemma: "kickar", according to the following morphological descriptions: "V;3;PL;NFIN"	ar", according to the followin
Generate the inflected form for the lemma: "liquefazer", according to the following morphological descriptions: "V;1;SG;IND;PST;PRF"	er", according to the followin
Generate the inflected form for the lemma: "munir", according to the following morphological descriptions: "V;1;SG;NFIN"	ir munir munir munir munir mun
Generate the inflected form for the lemma: "attentar", according to the following morphological descriptions: "V;1;SG;IND;FUT"	ar attentar attentar attentar 
Generate the inflected form for the lemma: "liderar", according to the following morphological descriptions: "V.PTCP;FEM;PL;PST"	erar" and "liderar". The lemma
Generate the inflected form for the lemma: "grudar", according to the following morphological descriptions: "V;2;SG;IND;PRS"	ar grudar grudar grudar grudar
Generate the inflected form for the lemma: "vesguear", according to the following morphological descriptions: "V;3;SG;SBJV;PRS"	ar vesguear vesguear vesguear 
Generate the inflected form for the lemma: "sortear", according to the following morphological descriptions: "V;1;SG;IND;PST;IPFV"	r sortear sortear sortear sort
Generate the inflected form for the lemma: "arquejar", according to the following morphological descriptions: "V;2;SG;IND;PST;IPFV"	ar (arquejar))
Generate the in
Generate the inflected form for the lemma: "arseniar", according to the following morphological descriptions: "V;3;PL;SBJV;PRS"	out the day and the day of the
Generate the inflected form for the lemma: "entrar", according to the following morphological descriptions: "V;1;SG;SBJV;FUT"	rar", according to the followi
Generate the inflected form for the lemma: "kickar", according to the following morphological descriptions: "V;1;PL;COND"	ar kickar kickar kickar kickar
Generate the inflected form for the lemma: "recompensar", according to the following morphological descriptions: "V;1;PL;IND;FUT"	er (1) (1) (1) (1) (1) (1) (1)
Generate the inflected form for the lemma: "vir", according to the following morphological descriptions: "V;2;SG;SBJV;PST;IPFV"	ir vir vir vir vir vir vir vir
Generate the inflected form for the lemma: "implicar", according to the following morphological descriptions: "V;3;SG;COND"	ar implicar implicar implicar 
Generate the inflected form for the lemma: "apreciar", according to the following morphological descriptions: "V;2;PL;IND;PST;PRF"	rar", according to the followi
Generate the inflected form for the lemma: "enramalhetar", according to the following morphological descriptions: "V;1;SG;SBJV;FUT"	ar", according to the followin
Generate the inflected form for the lemma: "festar", according to the following morphological descriptions: "V;1;SG;SBJV;PST;IPFV"	ar festar festar festar festar
Generate the inflected form for the lemma: "pescar", according to the following morphological descriptions: "V;3;SG;IND;PRS"	er pescar pescar pescar pescar
Generate the inflected form for the lemma: "enfileirar", according to the following morphological descriptions: "V;2;SG;IND;PST;IPFV"	rar (enfileirar) (enfileirar) 
Generate the inflected form for the lemma: "aclamar", according to the following morphological descriptions: "V;1;PL;IMP;NEG"	ar (aclamar) (aclamar) (aclama
Generate the inflected form for the lemma: "teclar", according to the following morphological descriptions: "V;2;PL;IND;PST;PRF"	er", according to the followin
Generate the inflected form for the lemma: "derrapar", according to the following morphological descriptions: "V;2;SG;IMP;POS"	rapar (derrapar) (derrapar) (d
Generate the inflected form for the lemma: "sortear", according to the following morphological descriptions: "V;3;SG;COND"	r sortear sortear sortear sort
Generate the inflected form for the lemma: "saltear", according to the following morphological descriptions: "V;3;PL;IND;PST;PFV"	ar", according to the followin
Generate the inflected form for the lemma: "sufocar", according to the following morphological descriptions: "V;3;SG;IND;PST;PFV"	ocar", according to the follow
Generate the inflected form for the lemma: "agachar", according to the following morphological descriptions: "V;2;PL;IMP;NEG"	ar agachar agachar agachar aga
Generate the inflected form for the lemma: "arianizar", according to the following morphological descriptions: "V;3;PL;NFIN"	inizar", according to the foll
Generate the inflected form for the lemma: "registrar", according to the following morphological descriptions: "V;3;PL;IND;PRS"	er (registrar) registrar regis
Generate the inflected form for the lemma: "aparafusar", according to the following morphological descriptions: "V.PTCP;FEM;SG;PST"	arafusar (aparafusar) (aparafu
Generate the inflected form for the lemma: "cuidar", according to the following morphological descriptions: "V;3;SG;COND"	ar cuidar cuidar cuidar cuidar
Generate the inflected form for the lemma: "arquejar", according to the following morphological descriptions: "V;3;SG;IND;PST;PRF"	ar", according to the followin
Generate the inflected form for the lemma: "vesguear", according to the following morphological descriptions: "V;1;SG;NFIN"	ar vesguear vesguear vesguear 
Generate the inflected form for the lemma: "estimar", according to the following morphological descriptions: "V;2;PL;COND"	ordinary (estimar) estimar (es
Generate the inflected form for the lemma: "cotejar", according to the following morphological descriptions: "V;1;PL;SBJV;PST;IPFV"	rar", according to the followi
Generate the inflected form for the lemma: "denominar", according to the following morphological descriptions: "V;2;SG;SBJV;FUT"	er denominar denominar denomin
Generate the inflected form for the lemma: "desentranhar", according to the following morphological descriptions: "V;3;SG;IND;PST;IPFV"	ar desentranhar desentranhar d
Generate the inflected form for the lemma: "inflamar", according to the following morphological descriptions: "V;1;SG;SBJV;PRS"	ar (inflamar) (inflamar) (infl
Generate the inflected form for the lemma: "condecorar", according to the following morphological descriptions: "V;1;PL;IMP;POS"	erar condecorar condecorar con
Generate the inflected form for the lemma: "ascender", according to the following morphological descriptions: "V;2;SG;NFIN"	er", according to the followin
Generate the inflected form for the lemma: "acreditar", according to the following morphological descriptions: "V;2;SG;SBJV;PRS"	ar acreditar acreditar acredit
Generate the inflected form for the lemma: "compensar", according to the following morphological descriptions: "V;2;PL;IMP;POS"	er (1) (1) (1) (1) (1) (1) (1)
Generate the inflected form for the lemma: "prender", according to the following morphological descriptions: "V;3;SG;IND;PRS"	er (prender) (prender) (prende
Generate the inflected form for the lemma: "tanger", according to the following morphological descriptions: "V;2;SG;IMP;NEG"	er (1) (1) (1) (1) (1) (1) (1)
Generate the inflected form for the lemma: "desiludir", according to the following morphological descriptions: "V;3;SG;SBJV;PRS"	r desiludir desiludir desiludi
Generate the inflected form for the lemma: "discar", according to the following morphological descriptions: "V;2;SG;IMP;POS"	ing the lemma: "discar", accor
Generate the inflected form for the lemma: "entabuar", according to the following morphological descriptions: "V;1;SG;IND;PST;PFV"	ar entabuar entabuar entabuar 
Generate the inflected form for the lemma: "recompensar", according to the following morphological descriptions: "V.PTCP;FEM;PL;PST"	er (recompensar) recompensar r
Generate the inflected form for the lemma: "rimar", according to the following morphological descriptions: "V;2;PL;IND;PST;PFV"	ar (ar) rimar (ar) rimar (ar) 
Generate the inflected form for the lemma: "crescer", according to the following morphological descriptions: "V;3;SG;SBJV;PST;IPFV"	rescer", according to the foll
Generate the inflected form for the lemma: "menstruar", according to the following morphological descriptions: "V;2;PL;IND;PST;IPFV"	ar (1)
Generate the inflected 
Generate the inflected form for the lemma: "manjar", according to the following morphological descriptions: "V;1;PL;IND;PRS"	anjar (1) (1) (1) (1) (1) (1) 
Generate the inflected form for the lemma: "comendar", according to the following morphological descriptions: "V;1;PL;IND;PST;PFV"	rar", according to the followi
Generate the inflected form for the lemma: "sobresair", according to the following morphological descriptions: "V;3;SG;IND;FUT"	air sobresair sobresair sobres
Generate the inflected form for the lemma: "menosprezar", according to the following morphological descriptions: "V;1;SG;IND;PST;PRF"	rezar", according to the follo
Generate the inflected form for the lemma: "alegar", according to the following morphological descriptions: "V;3;PL;IMP;NEG"	ar alegar alegar alegar alegar
Generate the inflected form for the lemma: "alojar", according to the following morphological descriptions: "V;2;SG;NFIN"	ar", according to the followin
Generate the inflected form for the lemma: "estipular", according to the following morphological descriptions: "V;2;SG;SBJV;PRS"	ar estipular estipular estipul
Generate the inflected form for the lemma: "copular", according to the following morphological descriptions: "V.PTCP;FEM;SG;PST"	ar (ar) (ar) (ar) (ar) (ar) (a
Generate the inflected form for the lemma: "adivinhar", according to the following morphological descriptions: "V;2;PL;SBJV;PRS"	ar adivinhar adivinhar adivinh
Generate the inflected form for the lemma: "arianizar", according to the following morphological descriptions: "V;1;PL;IMP;NEG"	arianizar (arianizar) (arianiz
Generate the inflected form for the lemma: "munir", according to the following morphological descriptions: "V;3;SG;IND;PST;IPFV"	ir munir munir munir munir mun
Generate the inflected form for the lemma: "aclamar", according to the following morphological descriptions: "V;3;PL;IND;FUT"	ar aclamar aclamar aclamar acl
Generate the inflected form for the lemma: "sortear", according to the following morphological descriptions: "V;1;PL;SBJV;FUT"	r", according to the following
Generate the inflected form for the lemma: "fluorar", according to the following morphological descriptions: "V;1;SG;IND;PST;PFV"	erar fluorar fluorar fluorar f
Generate the inflected form for the lemma: "papar", according to the following morphological descriptions: "V;3;PL;SBJV;FUT"	ar", according to the followin
Generate the inflected form for the lemma: "attentar", according to the following morphological descriptions: "V;1;SG;SBJV;PST;IPFV"	ar attentar attentar attentar 
Generate the inflected form for the lemma: "compensar", according to the following morphological descriptions: "V;2;PL;SBJV;PST;IPFV"	er (1992) (1992) (1992) (1992)
Generate the inflected form for the lemma: "derrapar", according to the following morphological descriptions: "V.PTCP;PRS"	rapar derrapar derrapar derrap
Generate the inflected form for the lemma: "delimitar", according to the following morphological descriptions: "V;1;SG;IND;FUT"	er (1992) (1992) (1992) (1992)
Generate the inflected form for the lemma: "doar", according to the following morphological descriptions: "V;1;SG;NFIN"	ar doar doar doar doar doar do
Generate the inflected form for the lemma: "privilegiar", according to the following morphological descriptions: "V;2;SG;IMP;POS"	r privilegiar privilegiar priv
Generate the inflected form for the lemma: "achatar", according to the following morphological descriptions: "V;1;PL;SBJV;PRS"	atar (achatar) (achatar) (acha
Generate the inflected form for the lemma: "rimar", according to the following morphological descriptions: "V;3;SG;IND;PST;PRF"	ar (ar) rimar (ar) rimar (ar) 
Generate the inflected form for the lemma: "abarcar", according to the following morphological descriptions: "V;2;SG;IND;PST;PFV"	arcar", according to the follo
Generate the inflected form for the lemma: "deliciar", according to the following morphological descriptions: "V;3;SG;IND;PST;PFV"	ir (deliciar) (deliciar) (deli
Generate the inflected form for the lemma: "simbolizar", according to the following morphological descriptions: "V;2;SG;IMP;POS"	rar (simbolizar) (simbolizar) 
Generate the inflected form for the lemma: "registrar", according to the following morphological descriptions: "V;3;PL;SBJV;PST;IPFV"	rar", according to the followi
Generate the inflected form for the lemma: "amancebar", according to the following morphological descriptions: "V;2;PL;IMP;NEG"	ebar", according to the follow
Generate the inflected form for the lemma: "formigar", according to the following morphological descriptions: "V;3;SG;IND;PST;PFV"	er (1992) (1992) (1992) (1992)
Generate the inflected form for the lemma: "guardar", according to the following morphological descriptions: "V;3;PL;COND"	rar", according to the followi
Generate the inflected form for the lemma: "safar", according to the following morphological descriptions: "V;1;PL;IND;FUT"	ar", according to the followin
Generate the inflected form for the lemma: "depenar", according to the following morphological descriptions: "V;3;PL;NFIN"	enar", according to the follow
Generate the inflected form for the lemma: "talhar", according to the following morphological descriptions: "V;3;PL;SBJV;FUT"	ar", according to the followin
Generate the inflected form for the lemma: "expectorar", according to the following morphological descriptions: "V;3;SG;IND;PST;IPFV"	erar expectorar expectorar exp
Generate the inflected form for the lemma: "vomitar", according to the following morphological descriptions: "V;1;SG;IND;PST;PFV"	ar vomitar vomitar vomitar vom
Generate the inflected form for the lemma: "algemar", according to the following morphological descriptions: "V;3;SG;IMP;POS"	ar (ar) mar (ar) mar (ar) mar 
Generate the inflected form for the lemma: "resplandecer", according to the following morphological descriptions: "V;1;PL;IND;PST;IPFV"	er", according to the followin
Generate the inflected form for the lemma: "talhar", according to the following morphological descriptions: "V.PTCP;MASC;PL;PST"	ar (talhar) (talhar) (talhar) 
Generate the inflected form for the lemma: "raciocinar", according to the following morphological descriptions: "V;2;SG;IND;PRS"	ar (raciocinar) (raciocinar) (
Generate the inflected form for the lemma: "estocar", according to the following morphological descriptions: "V;2;SG;SBJV;PRS"	ocar", according to the follow
Generate the inflected form for the lemma: "tretar", according to the following morphological descriptions: "V;3;PL;NFIN"	ar (tretar) (tretar) (tretar) 
Generate the inflected form for the lemma: "atenazar", according to the following morphological descriptions: "V;2;SG;IMP;POS"	ar atenazar atenazar atenazar 
Generate the inflected form for the lemma: "formigar", according to the following morphological descriptions: "V;3;PL;IND;PRS"	ar (1) 2010-01-11 10:00:00 UTC
Generate the inflected form for the lemma: "fluorar", according to the following morphological descriptions: "V;2;PL;SBJV;PRS"	ar fluorar fluorar fluorar flu
Generate the inflected form for the lemma: "gatunar", according to the following morphological descriptions: "V;1;SG;IND;PRS"	ar gatunar gatunar gatunar gat
Generate the inflected form for the lemma: "arrebentar", according to the following morphological descriptions: "V;1;SG;IND;PRS"	rebentar (arrebentar) (arreben
Generate the inflected form for the lemma: "postular", according to the following morphological descriptions: "V;1;SG;SBJV;PST;IPFV"	; postular; postular; postular
Generate the inflected form for the lemma: "indiciar", according to the following morphological descriptions: "V;3;SG;NFIN"	indiciar", according to the fo
Generate the inflected form for the lemma: "saturar", according to the following morphological descriptions: "V;2;PL;IND;PRS"	ar saturar saturar saturar sat
Generate the inflected form for the lemma: "aclamar", according to the following morphological descriptions: "V;1;SG;COND"	ar aclamar aclamar aclamar acl
Generate the inflected form for the lemma: "tratar", according to the following morphological descriptions: "V;3;SG;IND;PST;PFV"	ratar", according to the follo
Generate the inflected form for the lemma: "encabular", according to the following morphological descriptions: "V.PTCP;PRS"	ar (encabular) encabular encab
Generate the inflected form for the lemma: "latinar", according to the following morphological descriptions: "V;1;SG;IND;PST;PRF"	ar (1) (1) (1) (1) (1) (1) (1)
Generate the inflected form for the lemma: "comichar", according to the following morphological descriptions: "V;1;PL;NFIN"	ar (comichar) (comichar) (comi
Generate the inflected form for the lemma: "apedrejar", according to the following morphological descriptions: "V;3;PL;IND;PST;IPFV"	ar apedrejar apedrejar apedrej
Generate the inflected form for the lemma: "contrabalançar", according to the following morphological descriptions: "V;2;PL;IMP;NEG"	rar contrabalançar contrabala
Generate the inflected form for the lemma: "ruir", according to the following morphological descriptions: "V;1;SG;IND;PST;PRF"	r ruir ruir ruir ruir ruir rui
Generate the inflected form for the lemma: "rimar", according to the following morphological descriptions: "V;NFIN"	in" and "rimar". The lemma is 
Generate the inflected form for the lemma: "pagar", according to the following morphological descriptions: "V;3;PL;NFIN"	ar pagar pagar pagar pagar pag
Generate the inflected form for the lemma: "contactar", according to the following morphological descriptions: "V;3;SG;IND;PST;PFV"	r (contactar) contactar contac
Generate the inflected form for the lemma: "depenar", according to the following morphological descriptions: "V;3;PL;IMP;POS"	enar depenar depenar depenar d
Generate the inflected form for the lemma: "retardar", according to the following morphological descriptions: "V;2;SG;IND;PRS"	retardar (retardar) (retardar)
Generate the inflected form for the lemma: "copular", according to the following morphological descriptions: "V;3;SG;SBJV;PST;IPFV"	ar (ar) (ar) (ar) (ar) (ar) (a
Generate the inflected form for the lemma: "prevalecer", according to the following morphological descriptions: "V;2;SG;NFIN"	er", according to the followin
Generate the inflected form for the lemma: "commandar", according to the following morphological descriptions: "V.PTCP;PRS"	 the lemma: "commandar", accor
Generate the inflected form for the lemma: "encabular", according to the following morphological descriptions: "V;1;SG;SBJV;FUT"	ar", according to the followin
Generate the inflected form for the lemma: "condenar", according to the following morphological descriptions: "V;3;PL;SBJV;FUT"	 form for the lemma: "condenar
Generate the inflected form for the lemma: "simpatizar", according to the following morphological descriptions: "V;NFIN"	izar", according to the follow
Generate the inflected form for the lemma: "instigar", according to the following morphological descriptions: "V;1;PL;IMP;POS"	instigar", according to the fo
Generate the inflected form for the lemma: "aplainar", according to the following morphological descriptions: "V;2;SG;IND;FUT"	ar", according to the followin
Generate the inflected form for the lemma: "vesguear", according to the following morphological descriptions: "V.PTCP;PRS"	ar vesguear vesguear vesguear 
Generate the inflected form for the lemma: "deixar", according to the following morphological descriptions: "V;1;PL;IND;FUT"	rais de deixar de deixar de de
Generate the inflected form for the lemma: "pegar", according to the following morphological descriptions: "V;3;SG;SBJV;FUT"	ar", according to the followin
Generate the inflected form for the lemma: "molestar", according to the following morphological descriptions: "V;1;SG;IND;PST;PRF"	er", according to the followin
Generate the inflected form for the lemma: "antidotar", according to the following morphological descriptions: "V;2;PL;SBJV;PRS"	ar antidotar antidotar antidot
Generate the inflected form for the lemma: "desiludir", according to the following morphological descriptions: "V;2;PL;COND"	r desiludir desiludir desiludi
Generate the inflected form for the lemma: "inflamar", according to the following morphological descriptions: "V;2;SG;SBJV;FUT"	ar", according to the followin
Generate the inflected form for the lemma: "lambujar", according to the following morphological descriptions: "V;1;PL;COND"	ar (1990) (1990) (1990) (1990)
Generate the inflected form for the lemma: "proliferar", according to the following morphological descriptions: "V;2;PL;IND;PRS"	erar (proliferar) - proliferar
Generate the inflected form for the lemma: "tosar", according to the following morphological descriptions: "V;2;PL;IMP;NEG"	ar (tosar) (tosar) (tosar) (to
Generate the inflected form for the lemma: "confraternizar", according to the following morphological descriptions: "V;2;PL;IND;FUT"	izar", according to the follow
Generate the inflected form for the lemma: "torpedear", according to the following morphological descriptions: "V;2;PL;SBJV;PRS"	ear (torpedear) (torpedear) (t
Generate the inflected form for the lemma: "revelar", according to the following morphological descriptions: "V;2;SG;IND;PRS"	ar revelar revelar revelar rev
Generate the inflected form for the lemma: "papar", according to the following morphological descriptions: "V;1;SG;IND;FUT"	ar", according to the followin
Generate the inflected form for the lemma: "olear", according to the following morphological descriptions: "V;2;PL;NFIN"	ar (olear) (olear) (olear) (ol
Generate the inflected form for the lemma: "publicitar", according to the following morphological descriptions: "V;3;SG;IND;PRS"	er (1992) (1992) (1992) (1992)
Generate the inflected form for the lemma: "tretar", according to the following morphological descriptions: "V;1;SG;COND"	ar (1992) - Tretar (1992) - Tr
Generate the inflected form for the lemma: "proliferar", according to the following morphological descriptions: "V.PTCP;FEM;PL;PST"	erar proliferar proliferar pro
Generate the inflected form for the lemma: "condenar", according to the following morphological descriptions: "V;2;PL;IND;PST;IPFV"	 form for the lemma: "condenar
Generate the inflected form for the lemma: "estocar", according to the following morphological descriptions: "V;3;PL;SBJV;FUT"	ocar", according to the follow
Generate the inflected form for the lemma: "cagar", according to the following morphological descriptions: "V;3;SG;IMP;NEG"	ar (cagar) (cagar) (cagar) (ca
Generate the inflected form for the lemma: "derrapar", according to the following morphological descriptions: "V;2;SG;IND;PST;IPFV"	rapar", according to the follo
Generate the inflected form for the lemma: "açacalar", according to the following morphological descriptions: "V;2;PL;SBJV;PRS"	ar", according to the followin
Generate the inflected form for the lemma: "desvairar", according to the following morphological descriptions: "V;1;SG;SBJV;PST;IPFV"	rar", according to the followi
Generate the inflected form for the lemma: "sangrar", according to the following morphological descriptions: "V;2;PL;IND;FUT"	rar", according to the followi
Generate the inflected form for the lemma: "volver", according to the following morphological descriptions: "V.PTCP;MASC;SG;PST"	er", according to the followin
Generate the inflected form for the lemma: "papar", according to the following morphological descriptions: "V;2;PL;IND;PRS"	ar (1)
Generate the inflected 
Generate the inflected form for the lemma: "corroborar", according to the following morphological descriptions: "V;3;SG;SBJV;FUT"	rar", according to the followi
Generate the inflected form for the lemma: "pisotear", according to the following morphological descriptions: "V;1;PL;SBJV;PRS"	ear (1) (1) (1) (1) (1) (1) (1
Generate the inflected form for the lemma: "attentar", according to the following morphological descriptions: "V;3;SG;COND"	ar attentar attentar attentar 
Generate the inflected form for the lemma: "teorizar", according to the following morphological descriptions: "V;3;PL;SBJV;PST;IPFV"	orizar". The lemma is a spanis
Generate the inflected form for the lemma: "extinguir", according to the following morphological descriptions: "V;1;SG;IND;PST;IPFV"	r extinguir extinguir extingui
Generate the inflected form for the lemma: "proliferar", according to the following morphological descriptions: "V;3;PL;IND;PRS"	erar (proliferar) - proliferar
Generate the inflected form for the lemma: "derrapar", according to the following morphological descriptions: "V;3;PL;COND"	rapar", according to the follo
Generate the inflected form for the lemma: "reiterar", according to the following morphological descriptions: "V;3;SG;IND;PST;IPFV"	rar" and "reiterar". The lemma
Generate the inflected form for the lemma: "tosar", according to the following morphological descriptions: "V;1;SG;IND;PST;IPFV"	ar tosar tosar tosar tosar tos
Generate the inflected form for the lemma: "remunerar", according to the following morphological descriptions: "V;2;SG;IND;PST;PFV"	erar", according to the follow
Generate the inflected form for the lemma: "eliminar", according to the following morphological descriptions: "V;3;PL;SBJV;PRS"	er eliminar eliminar eliminar 
Generate the inflected form for the lemma: "rastrejar", according to the following morphological descriptions: "V;2;SG;NFIN"	ar", according to the followin
Generate the inflected form for the lemma: "supurar", according to the following morphological descriptions: "V;1;PL;SBJV;PRS"	ar supurar supurar supurar sup
Generate the inflected form for the lemma: "estocar", according to the following morphological descriptions: "V;2;PL;IND;PST;PFV"	ocar", according to the follow
Generate the inflected form for the lemma: "indiciar", according to the following morphological descriptions: "V;2;PL;IMP;POS"	era de la palabra de la palabr
Generate the inflected form for the lemma: "ensaboar", according to the following morphological descriptions: "V;2;SG;IMP;POS"	ar ensaboar ensaboar ensaboar 
Generate the inflected form for the lemma: "pegar", according to the following morphological descriptions: "V;3;PL;IMP;POS"	ar (pegar) (pegar) (pegar) (pe
Generate the inflected form for the lemma: "alojar", according to the following morphological descriptions: "V;1;PL;IND;PST;IPFV"	ojar" and the lemma: "alojar".
Generate the inflected form for the lemma: "sonambular", according to the following morphological descriptions: "V;3;PL;SBJV;PRS"	arante the sonambular form for
Generate the inflected form for the lemma: "formigar", according to the following morphological descriptions: "V;3;SG;SBJV;FUT"	er", according to the followin
Generate the inflected form for the lemma: "engendrar", according to the following morphological descriptions: "V;3;SG;IND;PST;PFV"	rar", according to the followi
Generate the inflected form for the lemma: "latinar", according to the following morphological descriptions: "V;2;PL;IND;FUT"	ar (1995) (1995) (1995) (1995)
Generate the inflected form for the lemma: "vomitar", according to the following morphological descriptions: "V;3;PL;SBJV;PRS"	ar vomitar vomitar vomitar vom
Generate the inflected form for the lemma: "conjecturar", according to the following morphological descriptions: "V;1;SG;IND;PRS"	 form for the lemma: "conjectu
Generate the inflected form for the lemma: "excetuar", according to the following morphological descriptions: "V;2;PL;IMP;NEG"	er er er er er er er er er er 
Generate the inflected form for the lemma: "desafogar", according to the following morphological descriptions: "V;2;SG;IMP;POS"	ar desafogar desafogar desafog
Generate the inflected form for the lemma: "kickar", according to the following morphological descriptions: "V;3;PL;SBJV;FUT"	ar", according to the followin
Generate the inflected form for the lemma: "existir", according to the following morphological descriptions: "V;1;PL;IMP;NEG"	er er er er er er er er er er 
Generate the inflected form for the lemma: "indiciar", according to the following morphological descriptions: "V;3;PL;COND"	indiciar", according to the fo
Generate the inflected form for the lemma: "aquaplanar", according to the following morphological descriptions: "V;2;PL;SBJV;PRS"	anar (anar) (anar) (anar) (ana
Generate the inflected form for the lemma: "postular", according to the following morphological descriptions: "V;2;PL;IND;PRS"	ar 2010-01-11 10:00:00 UTC #10
Generate the inflected form for the lemma: "pregar", according to the following morphological descriptions: "V;2;SG;IMP;NEG"	ar pregar pregar pregar pregar
Generate the inflected form for the lemma: "guarnecer", according to the following morphological descriptions: "V;2;PL;IND;PRS"	er", according to the followin
Generate the inflected form for the lemma: "designar", according to the following morphological descriptions: "V;1;SG;SBJV;PRS"	er designar designar designar 
Generate the inflected form for the lemma: "desafogar", according to the following morphological descriptions: "V;3;PL;NFIN"	ar", according to the followin
Generate the inflected form for the lemma: "latinar", according to the following morphological descriptions: "V;3;SG;SBJV;PRS"	ar (1) 2010-04-20 10:00:00 UTC
Generate the inflected form for the lemma: "pagar", according to the following morphological descriptions: "V;2;PL;IND;PST;PRF"	ar pagar pagar pagar pagar pag
Generate the inflected form for the lemma: "alocar", according to the following morphological descriptions: "V;1;SG;IND;PRS"	ocar (1)
Generate the inflecte
Generate the inflected form for the lemma: "ostracizar", according to the following morphological descriptions: "V;1;PL;SBJV;PST;IPFV"	racizar", according to the fol
Generate the inflected form for the lemma: "finalizar", according to the following morphological descriptions: "V.PTCP;PRS"	rar", according to the followi
Generate the inflected form for the lemma: "expectorar", according to the following morphological descriptions: "V;1;SG;IND;PST;PRF"	erar", according to the follow
Generate the inflected form for the lemma: "rufar", according to the following morphological descriptions: "V;1;PL;IND;PST;PRF"	ar (1) rufar (1) rufar (1) ruf
Generate the inflected form for the lemma: "extinguir", according to the following morphological descriptions: "V.PTCP;FEM;PL;PST"	er extinguir extinguir extingu
Generate the inflected form for the lemma: "proceder", according to the following morphological descriptions: "V;2;SG;SBJV;PRS"	er", according to the followin
Generate the inflected form for the lemma: "brunir", according to the following morphological descriptions: "V;2;SG;SBJV;PRS"	r brunir brunir brunir brunir 
Generate the inflected form for the lemma: "bombardear", according to the following morphological descriptions: "V;1;PL;NFIN"	rator", according to the follo
Generate the inflected form for the lemma: "redimir", according to the following morphological descriptions: "V;3;SG;IND;PRS"	ir redimir redimir redimir red
Generate the inflected form for the lemma: "recompensar", according to the following morphological descriptions: "V;1;PL;COND"	er (1) (1) (1) (1) (1) (1) (1)
Generate the inflected form for the lemma: "assemelhar", according to the following morphological descriptions: "V;1;SG;IND;PST;IPFV"	rar assemelhar assemelhar asse
Generate the inflected form for the lemma: "lesmar", according to the following morphological descriptions: "V;3;PL;SBJV;PST;IPFV"	er (1992) (1992) (1992) (1992)
Generate the inflected form for the lemma: "arseniar", according to the following morphological descriptions: "V;3;SG;SBJV;PRS"	out the day and the day of the
Generate the inflected form for the lemma: "recompensar", according to the following morphological descriptions: "V;2;PL;IND;PST;PRF"	er (recompensar) recompensar r
Generate the inflected form for the lemma: "visar", according to the following morphological descriptions: "V;1;PL;IND;PST;PRF"	ar", according to the followin
Generate the inflected form for the lemma: "adoecer", according to the following morphological descriptions: "V;3;SG;SBJV;PST;IPFV"	er", according to the followin
Generate the inflected form for the lemma: "entabuar", according to the following morphological descriptions: "V;1;PL;IND;PST;PRF"	ar", according to the followin
Generate the inflected form for the lemma: "arseniar", according to the following morphological descriptions: "V;1;PL;IND;PST;PRF"	arseniar (arseniar) (arseniar)
Generate the inflected form for the lemma: "arquivar", according to the following morphological descriptions: "V;1;SG;SBJV;PST;IPFV"	ar ar ar ar ar ar ar ar ar ar 
Generate the inflected form for the lemma: "remunerar", according to the following morphological descriptions: "V;NFIN"	rar", according to the followi
Generate the inflected form for the lemma: "tilintar", according to the following morphological descriptions: "V;2;PL;IND;FUT"	ar ar ar ar ar ar ar ar ar ar 
Generate the inflected form for the lemma: "arquejar", according to the following morphological descriptions: "V;1;PL;IND;PST;PRF"	ar", according to the followin
Generate the inflected form for the lemma: "estimar", according to the following morphological descriptions: "V;3;PL;IND;PST;PRF"	rar", according to the followi
Generate the inflected form for the lemma: "amarrar", according to the following morphological descriptions: "V;3;PL;SBJV;FUT"	rar", according to the followi
Generate the inflected form for the lemma: "entrar", according to the following morphological descriptions: "V;NFIN"	rar", according to the followi
Generate the inflected form for the lemma: "lambujar", according to the following morphological descriptions: "V;2;PL;COND"	ar (1990) (1990) (1990) (1990)
Generate the inflected form for the lemma: "jazer", according to the following morphological descriptions: "V;2;SG;IND;PST;PFV"	er", according to the followin
Generate the inflected form for the lemma: "contrabalançar", according to the following morphological descriptions: "V;1;SG;SBJV;PRS"	rar", according to the followi
Generate the inflected form for the lemma: "commandar", according to the following morphological descriptions: "V;1;SG;COND"	 form for the lemma: "commanda
Generate the inflected form for the lemma: "barbear", according to the following morphological descriptions: "V;2;PL;IMP;NEG"	ar (1)
Generate the inflected 
Generate the inflected form for the lemma: "cumprimentar", according to the following morphological descriptions: "V;2;PL;COND"	rationalization of the lemma: 
Generate the inflected form for the lemma: "engastar", according to the following morphological descriptions: "V;1;SG;NFIN"	ar engastar engastar engastar 
Generate the inflected form for the lemma: "rufar", according to the following morphological descriptions: "V;3;PL;SBJV;FUT"	ar", according to the followin
Generate the inflected form for the lemma: "estercar", according to the following morphological descriptions: "V;3;SG;IND;PST;PFV"	ercar", according to the follo
Generate the inflected form for the lemma: "luctar", according to the following morphological descriptions: "V;3;SG;IND;PST;PFV"	rarararararararararararararara
Generate the inflected form for the lemma: "expectorar", according to the following morphological descriptions: "V;3;SG;IND;FUT"	ar" and the lemma: "expectorar
Generate the inflected form for the lemma: "remunerar", according to the following morphological descriptions: "V;1;PL;IND;FUT"	erar", according to the follow
Generate the inflected form for the lemma: "abocanhar", according to the following morphological descriptions: "V.PTCP;FEM;SG;PST"	anhar (abocanhar) (abocanhar) 
Generate the inflected form for the lemma: "abscindir", according to the following morphological descriptions: "V;2;PL;SBJV;PST;IPFV"	ir abscindir abscindir abscind
Generate the inflected form for the lemma: "revelar", according to the following morphological descriptions: "V;2;PL;IMP;POS"	ar revelar revelar revelar rev
Generate the inflected form for the lemma: "escavar", according to the following morphological descriptions: "V;1;SG;IND;PST;PFV"	r", according to the following
Generate the inflected form for the lemma: "conjecturar", according to the following morphological descriptions: "V;2;SG;IND;PST;PRF"	rar (conjecturar) conjecturar 
Generate the inflected form for the lemma: "agachar", according to the following morphological descriptions: "V;1;PL;IND;PST;PFV"	ar agachar agachar agachar aga
Generate the inflected form for the lemma: "maltar", according to the following morphological descriptions: "V;3;SG;SBJV;PST;IPFV"	ar (1999) - Maltar (1999) - Ma
Generate the inflected form for the lemma: "ruir", according to the following morphological descriptions: "V;1;PL;NFIN"	r ruir ruir ruir ruir ruir rui
Generate the inflected form for the lemma: "tosar", according to the following morphological descriptions: "V;1;SG;COND"	ar tosar tosar tosar tosar tos
Generate the inflected form for the lemma: "aventar", according to the following morphological descriptions: "V;2;SG;IND;PST;PRF"	er aventar aventar aventar ave
Generate the inflected form for the lemma: "abarcar", according to the following morphological descriptions: "V.PTCP;FEM;SG;PST"	rar abarcar abarcar abarcar ab
Generate the inflected form for the lemma: "simpatizar", according to the following morphological descriptions: "V;2;SG;IND;PST;PFV"	izar", according to the follow
Generate the inflected form for the lemma: "deixar", according to the following morphological descriptions: "V;3;PL;COND"	redeixar", according to the fo
Generate the inflected form for the lemma: "desiludir", according to the following morphological descriptions: "V;3;SG;SBJV;PST;IPFV"	ir desiludir" (according to th
Generate the inflected form for the lemma: "tratar", according to the following morphological descriptions: "V;2;PL;IND;PST;IPFV"	ratar", according to the follo
Generate the inflected form for the lemma: "respirar", according to the following morphological descriptions: "V;3;PL;SBJV;PST;IPFV"	respirar", according to the fo
Generate the inflected form for the lemma: "vomitar", according to the following morphological descriptions: "V;3;PL;IND;PST;PRF"	ar vomitar vomitar vomitar vom
Generate the inflected form for the lemma: "registar", according to the following morphological descriptions: "V;1;PL;SBJV;PST;IPFV"	er (1) (1) (1) (1) (1) (1) (1)
Generate the inflected form for the lemma: "assoprar", according to the following morphological descriptions: "V;2;SG;IND;FUT"	rar assoprar assoprar assoprar
Generate the inflected form for the lemma: "içar", according to the following morphological descriptions: "V;3;PL;IND;FUT"	ar" is a sentence of the lemma
Generate the inflected form for the lemma: "inquirir", according to the following morphological descriptions: "V;1;PL;COND"	rir", according to the followi
Generate the inflected form for the lemma: "aclamar", according to the following morphological descriptions: "V;1;PL;SBJV;PST;IPFV"	ar aclamar aclamar aclamar acl
Generate the inflected form for the lemma: "aplainar", according to the following morphological descriptions: "V;3;PL;SBJV;FUT"	ar", according to the followin
Generate the inflected form for the lemma: "apoteosar", according to the following morphological descriptions: "V;2;SG;IND;PST;PFV"	ar apoteosar apoteosar apoteos
Generate the inflected form for the lemma: "saltear", according to the following morphological descriptions: "V;2;SG;IND;PRS"	ar (saltear) (saltear) (saltea
Generate the inflected form for the lemma: "concordar", according to the following morphological descriptions: "V;1;PL;IND;PRS"	er (1) (1) (1) (1) (1) (1) (1)
Generate the inflected form for the lemma: "reiterar", according to the following morphological descriptions: "V;1;SG;COND"	erar" and "reiterar". The lemm
Generate the inflected form for the lemma: "confraternizar", according to the following morphological descriptions: "V;3;PL;SBJV;PST;IPFV"	izar", according to the follow
Generate the inflected form for the lemma: "afundir", according to the following morphological descriptions: "V;3;SG;IMP;POS"	ir afundir afundir afundir afu
Generate the inflected form for the lemma: "apreciar", according to the following morphological descriptions: "V;3;SG;NFIN"	reciar", according to the foll
Generate the inflected form for the lemma: "vomitar", according to the following morphological descriptions: "V;2;SG;IND;FUT"	ar", according to the followin
Generate the inflected form for the lemma: "arrebentar", according to the following morphological descriptions: "V;2;SG;IND;PST;PFV"	rebentar (arrebentar) (arreben
Generate the inflected form for the lemma: "incorporar", according to the following morphological descriptions: "V;3;PL;IND;FUT"	er (1995) (1995) (1996) (1997)
Generate the inflected form for the lemma: "ligar", according to the following morphological descriptions: "V;2;PL;SBJV;PST;IPFV"	ar (1) (1) (1) (1) (1) (1) (1)
Generate the inflected form for the lemma: "desdizer", according to the following morphological descriptions: "V;3;PL;SBJV;PRS"	er", according to the followin
Generate the inflected form for the lemma: "objetar", according to the following morphological descriptions: "V;1;SG;SBJV;PST;IPFV"	ar (objetar) (objetar) (objeta
Generate the inflected form for the lemma: "mastigar", according to the following morphological descriptions: "V;2;PL;IND;PRS"	ar (mastigar) mastigar mastiga
Generate the inflected form for the lemma: "desistir", according to the following morphological descriptions: "V;1;PL;IND;PRS"	er desistir desistir desistir 
Generate the inflected form for the lemma: "charquear", according to the following morphological descriptions: "V.PTCP;MASC;PL;PST"	ar (charquear) (charquear) (ch
Generate the inflected form for the lemma: "crescer", according to the following morphological descriptions: "V;2;SG;IMP;NEG"	er", according to the followin
Generate the inflected form for the lemma: "alucinar", according to the following morphological descriptions: "V;2;PL;IMP;POS"	ar (alucinar) (alucinar) (aluc
Generate the inflected form for the lemma: "blogar", according to the following morphological descriptions: "V;3;SG;SBJV;FUT"	ar" and the lemma: "blogar". T
Generate the inflected form for the lemma: "pegar", according to the following morphological descriptions: "V;2;SG;IND;FUT"	ar", according to the followin
Generate the inflected form for the lemma: "talhar", according to the following morphological descriptions: "V.PTCP;FEM;PL;PST"	ar (talhar) (talhar) (talhar) 
Generate the inflected form for the lemma: "comichar", according to the following morphological descriptions: "V;1;PL;SBJV;FUT"	ar", according to the followin
Generate the inflected form for the lemma: "destratar", according to the following morphological descriptions: "V;2;PL;IND;FUT"	ratar", according to the follo
Generate the inflected form for the lemma: "contrabalançar", according to the following morphological descriptions: "V;NFIN"	rar", according to the followi
Generate the inflected form for the lemma: "auguriar", according to the following morphological descriptions: "V;2;PL;IND;PST;PFV"	ar auguriar auguriar auguriar 
Generate the inflected form for the lemma: "desarrazoar", according to the following morphological descriptions: "V;1;SG;IND;FUT"	ar ar ar ar ar ar ar ar ar ar 
Generate the inflected form for the lemma: "concordar", according to the following morphological descriptions: "V;2;PL;NFIN"	rar", according to the followi
Generate the inflected form for the lemma: "objetar", according to the following morphological descriptions: "V;1;PL;NFIN"	ar", according to the followin
Generate the inflected form for the lemma: "antidotar", according to the following morphological descriptions: "V.PTCP;FEM;PL;PST"	ar antidotar antidotar antidot
Generate the inflected form for the lemma: "desarmar", according to the following morphological descriptions: "V;3;SG;NFIN"	rar", according to the followi
Generate the inflected form for the lemma: "indiciar", according to the following morphological descriptions: "V;3;PL;IND;PST;PFV"	ido (indiciar) indiciar indici
Generate the inflected form for the lemma: "delinear", according to the following morphological descriptions: "V;1;PL;IMP;POS"	ear (1) (1) (1) (1) (1) (1) (1
Generate the inflected form for the lemma: "sociabilizar", according to the following morphological descriptions: "V;3;PL;IMP;POS"	izar", according to the follow
Generate the inflected form for the lemma: "copular", according to the following morphological descriptions: "V;1;SG;SBJV;PRS"	ar (ar) (ar) (ar) (ar) (ar) (a
Generate the inflected form for the lemma: "resplandecer", according to the following morphological descriptions: "V;3;PL;IND;PST;PRF"	er", according to the followin
Generate the inflected form for the lemma: "criticar", according to the following morphological descriptions: "V;2;SG;IND;PST;PRF"	ar", according to the followin
Generate the inflected form for the lemma: "direcionar", according to the following morphological descriptions: "V;1;SG;SBJV;FUT"	ar", according to the followin
Generate the inflected form for the lemma: "teclar", according to the following morphological descriptions: "V;3;PL;IMP;POS"	er (1) (1) (1) (1) (1) (1) (1)
Generate the inflected form for the lemma: "desarranjar", according to the following morphological descriptions: "V;1;SG;IND;PST;PRF"	ranjar", according to the foll
Generate the inflected form for the lemma: "transitar", according to the following morphological descriptions: "V;2;SG;IND;FUT"	ransitar", according to the fo
Generate the inflected form for the lemma: "protrair", according to the following morphological descriptions: "V;1;PL;IND;PST;PRF"	rair protrair protrair protrai
Generate the inflected form for the lemma: "commandar", according to the following morphological descriptions: "V;1;PL;SBJV;PST;IPFV"	 form for the lemma: "commanda
Generate the inflected form for the lemma: "decrescer", according to the following morphological descriptions: "V;1;PL;IND;PST;PFV"	er", according to the followin
Generate the inflected form for the lemma: "vincular", according to the following morphological descriptions: "V;2;SG;SBJV;PST;IPFV"	ar 2019-04-11 14:14:04
Generat
Generate the inflected form for the lemma: "liquefazer", according to the following morphological descriptions: "V;1;SG;SBJV;FUT"	r", according to the following
Generate the inflected form for the lemma: "acreditar", according to the following morphological descriptions: "V;1;PL;IND;PST;IPFV"	ar acreditar acreditar acredit
Generate the inflected form for the lemma: "munir", according to the following morphological descriptions: "V;NFIN"	ir", according to the followin
Generate the inflected form for the lemma: "punguear", according to the following morphological descriptions: "V;1;PL;COND"	ar", according to the followin
Generate the inflected form for the lemma: "desafogar", according to the following morphological descriptions: "V;3;SG;IND;PRS"	ar desafogar desafogar desafog
Generate the inflected form for the lemma: "telar", according to the following morphological descriptions: "V;3;PL;IND;PST;IPFV"	ar (1)
Generate the inflected 
Generate the inflected form for the lemma: "interferir", according to the following morphological descriptions: "V;2;SG;SBJV;FUT"	r", according to the following
Generate the inflected form for the lemma: "consternar", according to the following morphological descriptions: "V;3;PL;IMP;NEG"	rar", according to the followi
Generate the inflected form for the lemma: "polimerizar", according to the following morphological descriptions: "V;2;SG;SBJV;PST;IPFV"	izar", according to the follow
Generate the inflected form for the lemma: "visitar", according to the following morphological descriptions: "V;1;SG;IND;PST;PRF"	r", according to the following
Generate the inflected form for the lemma: "assemelhar", according to the following morphological descriptions: "V;1;SG;SBJV;PRS"	rar assemelhar assemelhar asse
Generate the inflected form for the lemma: "saturar", according to the following morphological descriptions: "V;1;PL;IMP;POS"	ar saturar saturar saturar sat
Generate the inflected form for the lemma: "revelar", according to the following morphological descriptions: "V;1;SG;IND;PRS"	ar revelar revelar revelar rev
Generate the inflected form for the lemma: "amancebar", according to the following morphological descriptions: "V;3;PL;IND;FUT"	ar", according to the followin
Generate the inflected form for the lemma: "ablegar", according to the following morphological descriptions: "V;3;PL;IND;PST;PRF"	rarararararararararararararara
Generate the inflected form for the lemma: "agradar", according to the following morphological descriptions: "V;3;SG;SBJV;PRS"	ar agradar agradar agradar agr
Generate the inflected form for the lemma: "entabuar", according to the following morphological descriptions: "V;2;SG;SBJV;PST;IPFV"	ar entabuar entabuar entabuar 
Generate the inflected form for the lemma: "deixar", according to the following morphological descriptions: "V;1;SG;SBJV;PRS"	ra de deixar de deixar de deix
Generate the inflected form for the lemma: "eliminar", according to the following morphological descriptions: "V;3;SG;IND;PST;IPFV"	er eliminar eliminar eliminar 
Generate the inflected form for the lemma: "encarcerar", according to the following morphological descriptions: "V;2;PL;COND"	rar", according to the followi
Generate the inflected form for the lemma: "expedir", according to the following morphological descriptions: "V.PTCP;FEM;PL;PST"	er expedir expedir expedir exp
Generate the inflected form for the lemma: "surtar", according to the following morphological descriptions: "V;3;PL;COND"	ar surtar surtar surtar surtar
Generate the inflected form for the lemma: "barbear", according to the following morphological descriptions: "V;2;SG;SBJV;FUT"	ar", according to the followin
Generate the inflected form for the lemma: "ousar", according to the following morphological descriptions: "V;2;SG;IND;PST;PFV"	ar ousar ousar ousar ousar ous
Generate the inflected form for the lemma: "saturar", according to the following morphological descriptions: "V;3;PL;IND;PST;PRF"	ar saturar saturar saturar sat
Generate the inflected form for the lemma: "ensaiar", according to the following morphological descriptions: "V;1;SG;SBJV;PST;IPFV"	ra ensaiar ensaiar ensaiar ens
Generate the inflected form for the lemma: "analisar", according to the following morphological descriptions: "V;2;SG;SBJV;PRS"	ar analisar analisar analisar 
Generate the inflected form for the lemma: "convencer", according to the following morphological descriptions: "V;2;SG;COND"	er", according to the followin
Generate the inflected form for the lemma: "reconsiderar", according to the following morphological descriptions: "V;NFIN"	rar", according to the followi
Generate the inflected form for the lemma: "aventar", according to the following morphological descriptions: "V;2;PL;SBJV;PRS"	ar aventar aventar aventar ave
Generate the inflected form for the lemma: "comendar", according to the following morphological descriptions: "V;2;PL;SBJV;FUT"	rar", according to the followi
Generate the inflected form for the lemma: "zumbificar", according to the following morphological descriptions: "V.PTCP;MASC;SG;PST"	ificar", according to the foll
Generate the inflected form for the lemma: "papar", according to the following morphological descriptions: "V;3;SG;IND;PST;IPFV"	ar papar papar papar papar pap
Generate the inflected form for the lemma: "engendrar", according to the following morphological descriptions: "V;3;PL;IMP;POS"	rar", according to the followi
Generate the inflected form for the lemma: "escavar", according to the following morphological descriptions: "V;1;SG;SBJV;FUT"	r", according to the following
Generate the inflected form for the lemma: "escravizar", according to the following morphological descriptions: "V;3;PL;IND;PRS"	ravizar", according to the fol
Generate the inflected form for the lemma: "tagarelar", according to the following morphological descriptions: "V;3;SG;SBJV;FUT"	arelar", according to the foll
Generate the inflected form for the lemma: "desarranjar", according to the following morphological descriptions: "V;3;PL;IND;PST;PFV"	ranjar", according to the foll
Generate the inflected form for the lemma: "desarranjar", according to the following morphological descriptions: "V;1;PL;NFIN"	ranjar", according to the foll
Generate the inflected form for the lemma: "papar", according to the following morphological descriptions: "V;3;PL;SBJV;PRS"	ar (ar) papar (ar) papar (ar) 
Generate the inflected form for the lemma: "mastigar", according to the following morphological descriptions: "V;1;PL;IND;PRS"	ar (1) (1) (1) (1) (1) (1) (1)
Generate the inflected form for the lemma: "ziguezaguear", according to the following morphological descriptions: "V;2;SG;IND;PST;PFV"	ar (ziguezaguear) (1)
Generate
Generate the inflected form for the lemma: "pisotear", according to the following morphological descriptions: "V;1;PL;SBJV;FUT"	ear", according to the followi
Generate the inflected form for the lemma: "eliminar", according to the following morphological descriptions: "V;2;SG;IND;PST;IPFV"	er eliminar eliminar eliminar 
Generate the inflected form for the lemma: "registar", according to the following morphological descriptions: "V;1;SG;NFIN"	er (1) (1) (1) (1) (1) (1) (1)
Generate the inflected form for the lemma: "aquaplanar", according to the following morphological descriptions: "V;3;PL;NFIN"	anar", according to the follow
Generate the inflected form for the lemma: "menstruar", according to the following morphological descriptions: "V;3;PL;IND;PST;PFV"	ar", according to the followin
Generate the inflected form for the lemma: "pretender", according to the following morphological descriptions: "V;1;PL;IND;PST;PRF"	er", according to the followin
Generate the inflected form for the lemma: "volver", according to the following morphological descriptions: "V;NFIN"	r", according to the following
Generate the inflected form for the lemma: "terminar", according to the following morphological descriptions: "V;3;PL;SBJV;PRS"	er (1) 2010-06-11 14:14:00 UTC
Generate the inflected form for the lemma: "teclar", according to the following morphological descriptions: "V;2;SG;IND;PRS"	er (1) (1) (1) (1) (1) (1) (1)
Generate the inflected form for the lemma: "bombardear", according to the following morphological descriptions: "V;2;SG;IND;FUT"	rator", according to the follo
Generate the inflected form for the lemma: "enramalhetar", according to the following morphological descriptions: "V;1;PL;IND;PST;IPFV"	ar enramalhetar enramalhetar e
Generate the inflected form for the lemma: "talhar", according to the following morphological descriptions: "V;1;SG;SBJV;FUT"	ar", according to the followin
Generate the inflected form for the lemma: "tilintar", according to the following morphological descriptions: "V;2;SG;IND;PST;PFV"	ar ar ar ar ar ar ar ar ar ar 
Generate the inflected form for the lemma: "menstruar", according to the following morphological descriptions: "V;3;PL;COND"	ar", according to the followin
Generate the inflected form for the lemma: "recompensar", according to the following morphological descriptions: "V;3;SG;IND;PST;IPFV"	er (1992) (1992) (1992) (1992)
Generate the inflected form for the lemma: "expectorar", according to the following morphological descriptions: "V;2;SG;IMP;POS"	ararararararararararararararar
Generate the inflected form for the lemma: "vincular", according to the following morphological descriptions: "V.PTCP;MASC;SG;PST"	ar (ar) (ar) (ar) (ar) (ar) (a
Generate the inflected form for the lemma: "grudar", according to the following morphological descriptions: "V;1;PL;SBJV;FUT"	rar", according to the followi
Generate the inflected form for the lemma: "içar", according to the following morphological descriptions: "V;3;SG;IND;FUT"	ar", according to the followin
Generate the inflected form for the lemma: "fatorar", according to the following morphological descriptions: "V;1;SG;NFIN"	ar", according to the followin
Generate the inflected form for the lemma: "alocar", according to the following morphological descriptions: "V;3;SG;SBJV;PST;IPFV"	ocar", according to the follow
Generate the inflected form for the lemma: "inquirir", according to the following morphological descriptions: "V;3;PL;IMP;NEG"	rir", according to the followi
Generate the inflected form for the lemma: "amancebar", according to the following morphological descriptions: "V;1;SG;SBJV;PRS"	ebar", according to the follow
Generate the inflected form for the lemma: "pescar", according to the following morphological descriptions: "V;1;PL;IMP;NEG"	er (pescar) (pescar) (pescar) 
Generate the inflected form for the lemma: "miscrar", according to the following morphological descriptions: "V;3;SG;IND;PST;PRF"	er (1992) (1992) (1992) (1992)
Generate the inflected form for the lemma: "alegar", according to the following morphological descriptions: "V;3;PL;SBJV;FUT"	ar", according to the followin
Generate the inflected form for the lemma: "proceder", according to the following morphological descriptions: "V;2;PL;NFIN"	r", according to the following
Generate the inflected form for the lemma: "festar", according to the following morphological descriptions: "V.PTCP;PRS"	ra festar festar festar festar
Generate the inflected form for the lemma: "vesguear", according to the following morphological descriptions: "V;2;PL;IND;PST;PRF"	ar", according to the followin
Generate the inflected form for the lemma: "desossar", according to the following morphological descriptions: "V;3;SG;IMP;NEG"	ar desossar desossar desossar 
Generate the inflected form for the lemma: "retinir", according to the following morphological descriptions: "V;NFIN"	ir", according to the followin
Generate the inflected form for the lemma: "abocanhar", according to the following morphological descriptions: "V;2;PL;NFIN"	anhar (abocanhar) (abocanhar) 
Generate the inflected form for the lemma: "ondular", according to the following morphological descriptions: "V;1;SG;SBJV;PRS"	ar (1) 2010-10-20 10:00:00 UTC
Generate the inflected form for the lemma: "administrar", according to the following morphological descriptions: "V;3;SG;IND;PRS"	er (1992) [1] [2] [3] [4] [5] 
Generate the inflected form for the lemma: "abarcar", according to the following morphological descriptions: "V;2;SG;SBJV;FUT"	arcar", according to the follo
Generate the inflected form for the lemma: "decrescer", according to the following morphological descriptions: "V;3;PL;SBJV;PRS"	er", according to the followin
Generate the inflected form for the lemma: "sociabilizar", according to the following morphological descriptions: "V;1;PL;NFIN"	izar", according to the follow
Generate the inflected form for the lemma: "indiciar", according to the following morphological descriptions: "V;1;PL;NFIN"	indiciar", according to the fo
Generate the inflected form for the lemma: "maquinar", according to the following morphological descriptions: "V;3;SG;COND"	ar (1999) (1999) (1999) (1999)
Generate the inflected form for the lemma: "entabuar", according to the following morphological descriptions: "V;2;SG;SBJV;FUT"	ar", according to the followin
Generate the inflected form for the lemma: "analisar", according to the following morphological descriptions: "V;2;SG;IND;PST;PFV"	ar analisar analisar analisar 
Generate the inflected form for the lemma: "ruir", according to the following morphological descriptions: "V;2;PL;SBJV;PRS"	r ruir ruir ruir ruir ruir rui
Generate the inflected form for the lemma: "sufocar", according to the following morphological descriptions: "V;3;SG;NFIN"	ocar", according to the follow
Generate the inflected form for the lemma: "attentar", according to the following morphological descriptions: "V;1;SG;SBJV;FUT"	ar", according to the followin
Generate the inflected form for the lemma: "cumprimentar", according to the following morphological descriptions: "V;2;PL;NFIN"	rata cumprimentar cumprimentar
Generate the inflected form for the lemma: "complicar", according to the following morphological descriptions: "V;1;PL;SBJV;PST;IPFV"	er (1) (1) (1) (1) (1) (1) (1)
Generate the inflected form for the lemma: "registar", according to the following morphological descriptions: "V;2;PL;IND;PRS"	er (1) (1) (1) (1) (1) (1) (1)
Generate the inflected form for the lemma: "torrar", according to the following morphological descriptions: "V;2;PL;SBJV;FUT"	rar", according to the followi
Generate the inflected form for the lemma: "reiterar", according to the following morphological descriptions: "V.PTCP;FEM;PL;PST"	rar", according to the followi
Generate the inflected form for the lemma: "miscrar", according to the following morphological descriptions: "V;2;SG;IMP;POS"	er (1992) [1] [2] [3] [4] [5] 
Generate the inflected form for the lemma: "inquirir", according to the following morphological descriptions: "V;1;SG;IND;PRS"	r inquirir inquirir inquirir i
Generate the inflected form for the lemma: "cuidar", according to the following morphological descriptions: "V;2;PL;SBJV;PST;IPFV"	ar cuidar cuidar cuidar cuidar
Generate the inflected form for the lemma: "estrumar", according to the following morphological descriptions: "V;2;PL;NFIN"	ar", according to the followin
Generate the inflected form for the lemma: "sobressair", according to the following morphological descriptions: "V;3;PL;IND;PST;PRF"	er (1992) (1992) (1992) (1992)
Generate the inflected form for the lemma: "apatetar", according to the following morphological descriptions: "V;2;PL;IMP;POS"	ar apatetar apatetar apatetar 
Generate the inflected form for the lemma: "contrair", according to the following morphological descriptions: "V;3;SG;COND"	rairairairairairairairairairai
Generate the inflected form for the lemma: "apoteosar", according to the following morphological descriptions: "V;3;SG;IMP;NEG"	ar (apoteosar) apoteosar (apot
Generate the inflected form for the lemma: "escravizar", according to the following morphological descriptions: "V;2;SG;NFIN"	ravizar", according to the fol
Generate the inflected form for the lemma: "flutuar", according to the following morphological descriptions: "V;3;PL;IND;PST;IPFV"	ar (1)
Generate the inflected 
Generate the inflected form for the lemma: "assignalar", according to the following morphological descriptions: "V;1;SG;SBJV;PST;IPFV"	alar (assignalar) (assignalar)
Generate the inflected form for the lemma: "munir", according to the following morphological descriptions: "V;2;SG;IND;PST;IPFV"	ir munir munir munir munir mun
Generate the inflected form for the lemma: "zumbificar", according to the following morphological descriptions: "V;3;SG;SBJV;FUT"	ificar", according to the foll
Generate the inflected form for the lemma: "munir", according to the following morphological descriptions: "V;2;SG;IND;PST;PRF"	ir munir munir munir munir mun
Generate the inflected form for the lemma: "talhar", according to the following morphological descriptions: "V;3;PL;IND;PST;IPFV"	ar (talhar) (talhar) (talhar) 
Generate the inflected form for the lemma: "telhar", according to the following morphological descriptions: "V;3;PL;IND;FUT"	ar (1) (1) (1) (1) (1) (1) (1)
Generate the inflected form for the lemma: "designar", according to the following morphological descriptions: "V;1;PL;IMP;NEG"	er (1) (1) (1) (1) (1) (1) (1)
Generate the inflected form for the lemma: "predominar", according to the following morphological descriptions: "V;2;PL;SBJV;PST;IPFV"	er 2019 - 10 - 12 - 13 - 14 - 
Generate the inflected form for the lemma: "copular", according to the following morphological descriptions: "V;2;SG;NFIN"	ar", according to the followin
Generate the inflected form for the lemma: "predominar", according to the following morphological descriptions: "V;3;PL;IND;FUT"	er 2010 - 10 - 11 - 12 - 13 - 
Generate the inflected form for the lemma: "abscindir", according to the following morphological descriptions: "V;NFIN"	ir", according to the followin
Generate the inflected form for the lemma: "contrabalançar", according to the following morphological descriptions: "V;3;SG;IND;FUT"	ra de contrabalançar (contrab
Generate the inflected form for the lemma: "simpatizar", according to the following morphological descriptions: "V;2;SG;COND"	izar", according to the follow
Generate the inflected form for the lemma: "fluorar", according to the following morphological descriptions: "V;3;PL;IMP;NEG"	ar fluorar fluorar fluorar flu
Generate the inflected form for the lemma: "ocorrer", according to the following morphological descriptions: "V;1;PL;NFIN"	rer", according to the followi
Generate the inflected form for the lemma: "liquefazer", according to the following morphological descriptions: "V;2;SG;IND;PRS"	er", according to the followin
Generate the inflected form for the lemma: "ligar", according to the following morphological descriptions: "V;3;SG;SBJV;PRS"	ar (ar) (ar) (ar) (ar) (ar) (a
Generate the inflected form for the lemma: "comprehender", according to the following morphological descriptions: "V;2;PL;IND;PST;PRF"	er", according to the followin
Generate the inflected form for the lemma: "desarranjar", according to the following morphological descriptions: "V;2;PL;IND;PST;PRF"	ranjar", according to the foll
Generate the inflected form for the lemma: "mutilar", according to the following morphological descriptions: "V;2;PL;SBJV;PST;IPFV"	ar (1)
Generate the inflected 
Generate the inflected form for the lemma: "visitar", according to the following morphological descriptions: "V;2;SG;SBJV;FUT"	r", according to the following
Generate the inflected form for the lemma: "encomendar", according to the following morphological descriptions: "V.PTCP;MASC;PL;PST"	rara encomendar encomendar enc
Generate the inflected form for the lemma: "alegar", according to the following morphological descriptions: "V;1;SG;IND;PST;IPFV"	ar alegar alegar alegar alegar
Generate the inflected form for the lemma: "jazer", according to the following morphological descriptions: "V.PTCP;FEM;SG;PST"	er", according to the followin
Generate the inflected form for the lemma: "convencer", according to the following morphological descriptions: "V;2;PL;IND;PST;PFV"	er", according to the followin
Generate the inflected form for the lemma: "escavar", according to the following morphological descriptions: "V;2;SG;IMP;POS"	ra escavar escavar escavar esc
Generate the inflected form for the lemma: "vesguear", according to the following morphological descriptions: "V;1;PL;NFIN"	ar", according to the followin
Generate the inflected form for the lemma: "encharcar", according to the following morphological descriptions: "V.PTCP;PRS"	rcar", according to the follow
Generate the inflected form for the lemma: "copular", according to the following morphological descriptions: "V;2;PL;IND;FUT"	ar", according to the followin
Generate the inflected form for the lemma: "achatar", according to the following morphological descriptions: "V;3;SG;IND;PST;PRF"	atar", according to the follow
Generate the inflected form for the lemma: "remunerar", according to the following morphological descriptions: "V;3;PL;IMP;POS"	erar (remunerar) - remunerar (
Generate the inflected form for the lemma: "estipular", according to the following morphological descriptions: "V;1;SG;SBJV;PST;IPFV"	ar estipular estipular estipul
Generate the inflected form for the lemma: "resplendecer", according to the following morphological descriptions: "V;3;SG;IND;FUT"	er", according to the followin
Generate the inflected form for the lemma: "papar", according to the following morphological descriptions: "V;3;SG;IND;FUT"	ar", according to the followin
Generate the inflected form for the lemma: "engastar", according to the following morphological descriptions: "V;3;PL;IND;PST;PFV"	ar engastar engastar engastar 
Generate the inflected form for the lemma: "mutilar", according to the following morphological descriptions: "V;1;PL;IND;PRS"	ar (1) (1) (1) (1) (1) (1) (1)
Generate the inflected form for the lemma: "nublar", according to the following morphological descriptions: "V;3;PL;SBJV;FUT"	ar", according to the followin
Generate the inflected form for the lemma: "capotar", according to the following morphological descriptions: "V;2;SG;IND;PST;IPFV"	ar (1)
Generate the inflected 
Generate the inflected form for the lemma: "damnar", according to the following morphological descriptions: "V;2;PL;NFIN"	ar damnar damnar damnar damnar
Generate the inflected form for the lemma: "afundir", according to the following morphological descriptions: "V;3;PL;SBJV;PRS"	ir afundir afundir afundir afu
Generate the inflected form for the lemma: "simbolizar", according to the following morphological descriptions: "V;3;SG;IMP;POS"	rar (simbolizar))
Generate the
Generate the inflected form for the lemma: "resplandecer", according to the following morphological descriptions: "V;3;SG;COND"	er", according to the followin
Generate the inflected form for the lemma: "desenrolar", according to the following morphological descriptions: "V;2;SG;IMP;POS"	erolar (desenrolar) (desenrola
Generate the inflected form for the lemma: "fluorar", according to the following morphological descriptions: "V;2;SG;IMP;NEG"	ar (fluorar) fluorar fluorar f
Generate the inflected form for the lemma: "denominar", according to the following morphological descriptions: "V;2;SG;COND"	er (1996) (1996) (1997) (1998)
Generate the inflected form for the lemma: "anotar", according to the following morphological descriptions: "V;3;SG;IND;PST;IPFV"	ar anotar anotar anotar anotar
Generate the inflected form for the lemma: "crescer", according to the following morphological descriptions: "V;2;PL;IND;PST;IPFV"	rescer", according to the foll
Generate the inflected form for the lemma: "olhar", according to the following morphological descriptions: "V;NFIN"	ar", according to the followin
Generate the inflected form for the lemma: "apedrejar", according to the following morphological descriptions: "V;2;SG;IMP;NEG"	erar apedrejar apedrejar apedr
Generate the inflected form for the lemma: "escravizar", according to the following morphological descriptions: "V;2;SG;IND;PST;PFV"	ravizar", according to the fol
Generate the inflected form for the lemma: "pôr", according to the following morphological descriptions: "V;2;PL;IND;PST;PRF"	ôr", according to the followi
Generate the inflected form for the lemma: "pescar", according to the following morphological descriptions: "V;3;PL;IND;PST;PFV"	er pescar pescar pescar pescar
Generate the inflected form for the lemma: "surtar", according to the following morphological descriptions: "V;NFIN"	ar surtar surtar surtar surtar
Generate the inflected form for the lemma: "pisotear", according to the following morphological descriptions: "V;3;SG;COND"	ear (pisotear) (pisotear) (pis
Generate the inflected form for the lemma: "agachar", according to the following morphological descriptions: "V;1;PL;COND"	ar agachar agachar agachar aga
Generate the inflected form for the lemma: "estimular", according to the following morphological descriptions: "V;2;PL;SBJV;FUT"	estimular", according to the f
Generate the inflected form for the lemma: "optar", according to the following morphological descriptions: "V;3;PL;IMP;NEG"	ar optar optar optar optar opt
Generate the inflected form for the lemma: "polimerizar", according to the following morphological descriptions: "V;3;PL;IND;FUT"	indicator for the lemma: "poli
Generate the inflected form for the lemma: "escalfar", according to the following morphological descriptions: "V.PTCP;FEM;SG;PST"	ra escalfar escalfar escalfar 
Generate the inflected form for the lemma: "instigar", according to the following morphological descriptions: "V;3;SG;IND;PST;IPFV"	rarararararararararararararara
