indiciar V;2;PL;IND;PST;IPFV	 i n d i n d i n d i n d i p i
adequar V.PTCP;MASC;SG;PST	 V. PTCP;MASC;SG;PST;PST;PST;P
desdizer V;2;SG;IND;PST;IPFV	like 1 like 1 like 1 like 1 li
refogar V.PTCP;PRS	efogar V.PTCP;PRSefogar V.PTCP
frequentar V;1;PL;IMP;POS	resultados de estudo para estu
condimentar V;1;SG;IND;PST;PFV	estructural V;1;SG;IND;PST;PFV
içar V;3;PL;SBJV;FUT	 comentários V;3;PL;SBJV;FUTe
designar V;3;SG;IND;PST;IPFV	direccion de la etiqueta V;3;S
ziguezaguear V;3;PL;IND;PST;PFV	ar V;3;PL;IND;PST;PFVersion 3.
acortinar V;3;PL;NFIN	acortinar V;3;PL;NFINer V;3;PL
estocar V;2;PL;COND	 PL COND PL COND PL COND PL CO
estimular V;1;PL;IND;PST;PFV	;1;PL;IND;PST;PF V;1;PL;IND;PS
harmonizar V;1;PL;IMP;NEG	 tenor 100 100 100 100 100 100
sublinhar V;1;PL;IND;PST;IPFV	 Para algun descriptor de la s
contra-atacar V;2;PL;NFIN	 a pesar de la posición de la
pedalar V;1;PL;SBJV;PRS	e pedalar V;1;PL;SBJV;PRSn 1;P
vitimar V;1;PL;COND	Description Condition Conditio
brincar V;NFIN	 No se arregla de casualidad N
latinar V;3;SG;IND;PST;PRF	atinar V;3;SG;IND;PST;PRF;PRF;
desdizer V;3;PL;IMP;NEG	 le 19/01/2018 a la une de le 
estipular V;3;PL;SBJV;PRS	ar V;3;PL;SBJV;3;PL;SBJV;3;PL;
arquejar V;3;PL;COND	ejar V;3;PL;CONDADO DE PL COND
pregar V;2;PL;IND;PST;IPFV	 pregar V en el en el en el en
redimir V;1;PL;SBJV;FUT	;1;PL;SBJV;FUT V;1;PL;SBJV;FUT
borrar V;3;PL;SBJV;PST;IPFV	 V;3;PL;SBJV;3;PL;SBJV;3;PL;SB
surtar V;1;PL;SBJV;FUT	ar V;1;PL;SBJV;FUTir V;1;PL;SB
impregnar V.PTCP;PRS	gnar V.PTCP;PRSquo V.PTCP;PRSq
entrar V;2;PL;IND;PRS	 por espantos de la sigla en i
cagar V;1;SG;COND	agar V;1;SG;CONDAGAR V;1;SG;CO
apedrejar V;3;SG;IMP;POS	apedrejar V;3;SG;IMP;POS;POS;P
enfileirar V;2;SG;SBJV;FUT	enfileirar V;2;SG;SBJV;FUTjV;F
registar V;1;SG;SBJV;FUT	estar V;1;SG;SBJV;FUTj V;1;SG;
mutilar V;3;PL;SBJV;FUT	ar V;3;PL;SBJV;FUTE V;3;PL;SBJ
indiciar V;3;SG;SBJV;FUT	id indiiiiiiiiiiiiiiiiiiiiiiii
limar V;2;SG;SBJV;PST;IPFV	 V;2;SG;SBJ V;2;SG;SBJ V;2;SG;
apatetar V;3;SG;SBJV;PST;IPFV	apapapapapapapapapapapapapapap
guardar V;3;PL;IMP;POS	 leer artículos recomendados 
pagar V;1;SG;IND;PRS	amana V;1;SG;IND;PRSbhujajapag
optar V;2;SG;IMP;NEG	 alimentar optar V;2;SG;IMP;NE
voltar V;1;SG;NFIN	 100 mA 12V 100 W Voltar V;1;S
coevoluir V;2;SG;IND;PST;PFV	oevoluir V2;SG;IND;PST;PF Vers
olear V;2;SG;COND	 SG CONDENSER V;2;SG;CONDENSER
conjecturar V;2;PL;IMP;POS	er V;2;PL;IMP;POS;IMP;POS;POS;
raciocinar V;2;PL;IMP;POS	ar V;2;PL;IMP;POS;POS;POS;POS;
secundar V;2;PL;NFIN	ectasia and secundar V;2;PL;NF
aluviar V;3;PL;IND;FUT	 V;3;PL;IND;FUT;FUT;FUT;FUT;FU
aventar V;2;PL;IND;FUT	ar V;2;PL;IND;FUT;FUT;FUT;FUT;
vesguear V;1;PL;SBJV;FUT	ar V;1;PL;SBJV;FUTjvesguear V;
relacionar V;1;SG;IND;PRS	ar V;1;SG;IND;PRSe podr relaci
realçar V;2;PL;IMP;POS	ar V;2;PL;IMP;POS;POS;POS;POS;
confraternizar V;1;SG;IND;FUT	relacionarse con otros seres h
olear V;3;SG;IMP;POS	 SG;IMP;POS;POS;POS;POS;POS;PO
sangrar V;1;SG;IND;FUT	ar V;1;SG;IND;FUT;FUT;FUT;FUT;
polimerizar V;3;SG;NFIN	r V;3;SG;NFINlaminar V;3;SG;NF
anteceder V;1;SG;IND;FUT	anteceder V;1;SG;IND;FUT;FUT;F
delimitar V;1;PL;IMP;POS	entorno de capital positivo de
contrabalançar V;2;SG;IMP;POS	 contrabalançar V;2;SG;IMP;PO
desarrazoar V;1;PL;SBJV;FUT	rim V;1;PL;SBJV;FUT;1;PL;SBJV;
fallecer V;2;SG;SBJV;FUT	allecer V;2;SG;SBJV;FUT;2;SG;S
aventar V;2;PL;IND;PST;IPFV	 comentarios for this section 
analisar V;1;PL;SBJV;FUT	 1;PL;SBJV;FUTჩ 1;PL;SBJ V;F
adoecer V.PTCP;PRS	 Series Phylloscopus Adoecer V
arrebentar V;1;PL;NFIN	ebentar V;1;PL;NFINL;NFINL;NFI
extinguir V;3;PL;IND;PST;IPFV	estimado de los estimados de l
mastigar V;3;PL;IMP;POS	ar V;3;PL;IMP;POS;POS;POS;POS;
constatar V;3;PL;IND;PST;IPFV	o constatar V;3;PL;IND;PST;IPF
filtrar V;3;PL;SBJV;FUT	ar V;3;PL;SBJV;FUTilde V;3;PL;
tosar V;1;PL;IND;FUT	 V;1;PL;IND;FUT;FUT;FUT;FUT;FU
proliferar V;1;PL;SBJV;PRS	 c p e f g h i j k l m n o p k
cumprimentar V;1;SG;NFIN	ero com caligrafia e periodici
comendar V;3;SG;IND;FUT	r V;3;SG;IND;FUT;FUT;fut;fut;f
desarrazoar V;1;SG;IND;PST;PFV	estrada de cartas de cartas de
sonambular V.PTCP;MASC;SG;PST	a can on the surface of the so
sangrar V;3;PL;IND;PRS	ar V;3;PL;IND;PRSer V;3;PL;IND
adivinhar V;3;PL;IMP;NEG	 PL;IMP;NEGEGEGEGEGEGEGEGEGEGE
lambujar V.PTCP;FEM;SG;PST	a V.PTCP;FEM;SG;PST;PST;PST;PS
registrar V;2;SG;SBJV;FUT	datos de registrar V;2;SG;SBJV
desembalar V;3;SG;IND;PST;IPFV	esemblar V;3;SG;IND;PST;IPFVes
liquefazer V;2;PL;IMP;NEG	er V;2;PL;IMP;NEG PL 2;PL;IMP;
sobressair V;1;SG;IND;FUT	obressair V;1;SG;IND;FUT;FUT;F
incorporar V;1;PL;IMP;POS	on and incorporar V;1;PL;IMP;P
absceder V;3;SG;NFIN	bsceder V;3;SG;NFINew York bsc
escassear V;1;SG;SBJV;PRS	escassear V;1;SG;SBJV;PRSgesca
registrar V;1;PL;IND;PST;IPFV	data de contraseña V;1;PL;IND
retaliar V.PTCP;MASC;SG;PST	 Para el acto de la comunidad 
vomitar V;2;PL;IND;PST;PRF	 PL IND PST PRFe PL IND PST PR
realçar V;1;PL;SBJV;FUT	ar V;1;PL;SBJV;FUTrealçar V;1
derrapar V;1;PL;IND;PRS	estado de acuerdo con los esta
denotar V;2;PL;IMP;NEG	enotar V;2;PL;IMP;NEGrafia de 
encomendar V;1;SG;SBJV;FUT	rio de 1995 1996 1997 1998 199
escalfar V;3;PL;IMP;NEG	filosofar V;3;PL;IMP;NEG sol V
desentranhar V;3;PL;IND;PST;IPFV	as en Parte de Parte de Parte 
amarrar V;2;SG;SBJV;FUT	a sa marrar V;2;SG;SBJV;FUT;2;
discar V;3;SG;SBJV;PRS	ar V;3;SG;SBJV;PRSnar V;3;SG;S
teclar V;3;PL;SBJV;PRS	 de la página de inicio » ©
alfabetizar V;1;PL;SBJV;PST;IPFV	abierto a alfabetizar V;1;PL;S
ruir V;1;SG;SBJV;PST;IPFV	 Search Results for " Search R
arquivar V;1;SG;SBJV;FUT	pt arquivo arquivo arquivo arq
terminar V;1;PL;IND;PST;IPFV	 Perterminar V;1;PL;IND;PST;IP
sublinhar V;3;PL;IND;PST;IPFV	 Para algun descriptor de la l
resplandecer V;2;PL;IND;PST;PFV	decer V;2;2;2;2;2;2;2;2;2;2;2;
talhar V;3;PL;NFIN	ar V;3;PL;NFINci PL;NFI Nci PL
ondular V;3;SG;SBJV;PRS	 S S S S S S S S S S S S S S S
ensaiar V;2;SG;SBJV;FUT	ar V;2;SG;SBJV;FUTlenovo Tradu
prover V;3;SG;COND	er V;3;SG;CONDer V;3;SG;CONDer
tagarelar V.PTCP;MASC;PL;PST	arelar V.PTCP;MASC;PL;PST;PST;
fallecer V;2;SG;SBJV;PRS	allecer V;2;SG;SBJV;PRSer V;2;
relacionar V;3;PL;IMP;NEG	o de relacionar V;3;PL;IMP;NEG
concordar V;3;PL;IND;PST;IPFV	;3;PL;IND;PST;IPFV;3;PL;IND;PS
assemelhar V;3;PL;COND	assembler V;3;PL;CONDASSEMBLER
filtrar V;2;PL;SBJV;FUT	ar V;2;PL;SBJV;FUTipo de sitio
engendrar V;1;SG;IND;PRS	ngendrar V;1;SG;IND;PRSengendr
proliferar V;3;SG;SBJV;PRS	 carcinoma proliferative and p
silenciar V;2;PL;IMP;NEG	 PL;IMP;NEGENERAL PL;IMP;NEGEN
denominar V;1;PL;IND;PRS	 estado de control 1 1 0 0 0 0
mumificar V;2;PL;IMP;POS	ar V;2;PL;IMP;POS;2;POS;2;POS;
complicar V;2;PL;IND;PST;PFV	estructura de almacenamiento e
terminar V;1;PL;IND;PST;PRF	 Pretemporada Pretemporada Pre
bombardear V.PTCP;FEM;PL;PST	 V.PTCP;FEM;PL;PST;FEM;PL;PST;
desossar V;1;SG;SBJV;PST;IPFV	esossar V;1;SG;SBJ V;1;SG;SBJ 
remunerar V;3;SG;IND;PST;PFV	ar V;3;SG;IND;PST;PFV;3;SG;IND
recriar V;2;PL;IND;PST;PRF	eriar V;2;PL;IND;PST;PRFeriar 
enraivecer V;2;PL;COND	;2;PL;COND;2;PL;COND;2;PL;COND
designar V;2;PL;IND;PST;PFV	 contacto con el sitio de ayud
damnar V;1;PL;IND;PRS	amnar V;1;PL;IND;PRSignar V;1;
adequar V;3;SG;IND;PST;IPFV	 a dequar V;3;SG;IND;PST;IPFV;
complicar V;1;PL;SBJV;FUT	 es en este articulo completo 
blasonar V;1;PL;IND;FUT	 1 PL IND FUT FUT FUT FUT FUT 
interpelar V;2;SG;IND;PST;PRF	erpelar V;2;SG;IND;PST;PRFerpe
gatunar V;3;SG;IND;PRS	 1999 1999 1999 1999 1999 1999
contrair V;3;PL;IMP;NEG	 contrair V;3;PL;IMP;NEGH;3;PL
engastar V;1;SG;SBJV;PRS	 SBJ V;1;SG;SBJ V;PRSeng V;1;S
acreditar V;1;PL;IND;PST;PRF	a contratación por acreditar 
compensar V;1;PL;IND;FUT	ompansar V;1;PL;IND;FUT;FUT;FU
achatar V;NFIN	chatar V;NFIN ;NFIN ;NFIN ;NFI
olhar V;2;PL;IND;PST;PFV	 V 2 PL IND PST PF V 2 PL IND 
talhar V;1;SG;NFIN	alhar V;1;SG;NFINfi salhar V;1
redimir V.PTCP;MASC;PL;PST	ets V.PTCP;MASC;PL;PST;PST;PST
lapidar V;NFIN	apidar V;NFINeidar V;NFINeidar
indiciar V;2;SG;IND;PST;PFV	general V;2;SG;IND;PST;PF gen
arquivar V;3;PL;IND;PST;PFV	 V;3;PL;IND;PST;PFV;3;PL;IND;P
arquejar V;2;PL;COND	ejar V;2;PL;COND;COND;COND;CON
cumprir V;1;PL;NFIN	r V;1;PL;NFINL;NFINL;NFINL;NFI
estipular V;1;PL;SBJV;PRS	ar V;1;PL;SBJ1;PL;SBJ1;PL;SBJ1
encetar V.PTCP;MASC;SG;PST	a V.PTCP;MASC;SG;PST;PST;PST;P
abscindir V;2;SG;SBJV;PRS	indir V;2;SG;SBJV;PRSer V;2;SG
supurar V;2;SG;SBJV;PST;IPFV	ar V;2;SG;SBJ V;2;SG;SBJ V;2;S
ablegar V;1;PL;SBJV;FUT	 1;PL;SBJ V;FUTl;SBJ V;FUTl;SB
resplendecer V.PTCP;FEM;SG;PST	er V.PTCP;FEM;SG;PST;PST;PST;P
charquear V;2;PL;IND;PST;PRF	andandoandandoan charqueandand
enrubescer V;1;SG;IND;PST;PFV	1;SG;IND;PST;PF V;1;SG;IND;PST
aclamar V;1;PL;SBJV;FUT	aclamar V;1;PL;SBJV;FUTiempo d
anteceder V;3;SG;SBJV;FUT	ceder V;3;SG;SBJV;FUTllanteced
criticar V;3;SG;IND;FUT	riticar V;3;SG;IND;FUT;FUT;FUT
expectorar V;3;SG;IND;PRS	;PRSectoral exposure through t
comprehender V;1;SG;IND;FUT	er V;1;SG;IND;FUT;FUT;FUT;FUT;
inquirir V;2;PL;SBJV;PST;IPFV	 2 PL;SBJ 2 PL;SBJ 2 PL;SBJ 2 
incorporar V;3;SG;IND;PRS	;PRS;PRS;PRS;PRS;PRS;PRS;PRS;P
sufocar V;2;PL;IND;PST;IPFV	 2 PL IND PST IPF V;2;PL;IND;P
estimar V;2;SG;IND;PRS	estimar V;2;SG;IND;PRSg;IND;PR
desentranhar V;3;SG;COND	ESTADO DE CONTATO DE CONTATO D
achatar V;3;SG;IMP;NEG	achatar V;3;SG;IMP;NEG;3;SG;IM
anteceder V;1;PL;IND;PST;PFV	 PL IND PS T P                
adoecer V.PTCP;FEM;SG;PST	 Padoecer V.PTCP;FEM;SG;PST;PS
interferir V;3;SG;SBJV;PST;IPFV	receptorer interferens V;3;SG;
protrair V.PTCP;FEM;PL;PST	otrair V.PTCP;FEM;PL;PST;PST;P
charquear V;1;PL;IND;PST;PFV	ar V;1;PL;IND;PST;PF V;1;PL;IN
ousar V;1;SG;NFIN	 Saidi Saidi Saidi Saidi Saidi
adequar V.PTCP;FEM;SG;PST	 Para Para Para Para Para Para
denominar V;1;PL;IND;PST;PRF	nombre de nombre de nombre de 
estercar V;3;PL;IND;FUT	ar V;3;PL;IND;FUTrestercar V;3
economizar V.PTCP;MASC;PL;PST	economizar V.PTCP;MASC;PL;PST;
afundir V;3;SG;IND;PST;PFV	 la la la la la la la la la la
visitar V;1;SG;IND;PST;IPFV	 visitar V;1;SG;IND;PST;IPFVer
condecorar V;2;PL;COND	ecorar V;2;PL;CONDECORAR V;2;P
adoecer V.PTCP;MASC;PL;PST	adoecer V.PTCP;MASC;PL;PST;PST
cumprimentar V;1;PL;IND;FUT	 constante V;1;PL;IND;FUT;FUT;
agradar V;2;PL;SBJV;FUT	agradar V;2;PL;SBJV;FUTjardar 
prevalecer V;1;PL;IND;PRS	er 1;PL;IND;PRSer 1;PL;IND;PRS
abafar V.PTCP;MASC;SG;PST	 S. S. S. S. S. S. S. S. S. S.
flutuar V;3;SG;IND;FUT	 V;3;SG;IND;FUT;FUT;FUT;FUT;FU
objetar V;1;PL;IND;PST;PFV	 objetar V;1;PL;IND;PST;PFVn o
escassear V.PTCP;FEM;SG;PST	assear V.PTCP;FEM;SG;PST para 
alojar V;2;PL;IND;FUT	ar V;2;PL;IND;FUT;FUT;FUT;FUT;
pagar V;2;PL;IND;PST;IPFV	amana pagar v 2 pagar v 2 paga
cintar V;1;PL;IND;PST;IPFV	 V;1;PL;IND;PST;IPFV;1;PL;IND;
tanger V;1;PL;IMP;NEG	 1 1 1 1 1 1 1 1 1 1 1 1 1 1 1
consolidar V;3;SG;IND;PST;IPFV	olidar V;3;SG;IND;PST;IPFVer m
amaynar V;1;SG;IND;PRS	 1 Samaynar V;1;SG;IND;PRSg 1 
condenar V;3;SG;IND;FUT	educación especial V;3;SG;IND
desistir V;2;SG;SBJV;PRS	estir V;2;SG;SBJV;PRSg;SBJV;PR
frequentar V;3;PL;SBJV;FUT	 esta esta esta esta esta esta
brincar V;1;PL;SBJV;PRS	ray V;1;PL;SBJV;1;PL;SBJV;1;PL
visitar V;1;PL;SBJV;FUT	a con visitar V;1;PL;SBJV;FUTe
vocalizar V;1;SG;IND;PRS	 a vocalizar V;1;SG;IND;PRSg a
safar V;3;PL;IND;PST;PRF	amin dan safar V;3;PL;IND;PST;
pregar V;3;SG;IND;PST;IPFV	 pregar V;3;SG;IND;PST;IPFV;3;
encarcerar V;1;SG;SBJV;FUT	ar encarcerar V;1;SG;SBJV;FUTl
talhar V;3;SG;IMP;NEG	ar V;3;SG;IMP;NEG;NEG;NEG;NEG;
saturar V;3;PL;IND;PST;PFV	ar V;3;PL;IND;PST;PFVer la ent
remunerar V;2;PL;IND;PRS	estructural V;2;PL;IND;PRSalud
anotar V;2;SG;IND;PST;PFV	anotar V;2;SG;IND;PST;PFVersio
apregoar V;1;SG;COND	are de pregoar V;1;SG;COND;CON
sonambular V;2;SG;IMP;NEG	 sonambular SG;IMP;NEG;IMP;NEG
marchar V;1;SG;IND;FUT	marchar V;1;SG;IND;FUT;FUT;FUT
seguir V;3;SG;IND;FUT	e a V;3;SG;IND;FUT
Futebol est
inquirir V;1;PL;SBJV;FUT	 1 2 3 4 5 6 7 8 9 10 ... 11 N
proliferar V;1;PL;IMP;NEG	 proliferar V;1;PL;IMP;NEG;1;1
desentranhar V;3;PL;IND;FUT	;3;PL;IND;FUT;FUT;FUT;FUT;FUT;
escavar V;1;PL;SBJV;FUT	ar V;1;PL;SBJV;FUTj V;FUTj V;F
ascender V;3;PL;IND;PST;PFV	ascender V;3;PL;IND;PST;PF V;3
segmentar V;2;SG;IND;PST;IPFV	a SG;IND;PST;IPFVersion 2 SG;I
desvairar V;3;PL;SBJV;PST;IPFV	en desváirar en desváirar en
ascender V;2;SG;SBJV;PST;IPFV	 a position of the sun a posit
condecorar V;3;PL;IND;PRS	ar V;3;PL;IND;PRSgo tambor con
afundir V;2;SG;COND	fundir V;2;SG;CONDafundir V;2;
escravizar V;1;SG;IND;PRS	izar V;1;SG;IND;PRSg;ind;prsg;
regularizar V;3;SG;IND;PST;PRF	estructura de alta regularizar
revelar V;1;PL;IND;PST;PFV	 contents of the V;1;PL;IND;PS
entrar V.PTCP;PRS	 PTCP;PRS;PRS;PRS;PRS;PRS;PRS;
vir V;1;PL;SBJV;PST;IPFV	a version | Torrent | Torrent 
pescar V;2;SG;NFIN	internacional de pesca de carr
bombardear V;1;SG;NFIN	ear V;1;SG;NFINear V;1;SG;NFIN
colorar V;2;PL;SBJV;PRS	 colorar V;2;PL;SBJV;2;PL;SBJV
surtar V;2;SG;SBJV;PRS	ar V;2;SG;SBJV;PRSnurtar V;2;S
arrebentar V;3;PL;IND;PST;PFV	ebentar V;3;PL;IND;PST;PFVeben
mastigar V;2;PL;SBJV;PRS	ar V;2;PL;SBJ 2;PL;SBJ 2;PL;SB
enrubescer V;1;PL;IND;PRS	 1 2 3 4 5 6 7 8 9 10 11 12 13
privilegiar V;2;SG;SBJV;PST;IPFV	igual igual SG;SBJ SBJ SBJ SB
desossar V;NFIN	esossar V;NFINesossar V;NFINes
deificar V;3;SG;SBJV;FUT	ar V;3;SG;SBJV;FUTj V;FUTj V;F
vesguear V;3;PL;SBJV;PRS	a V;3;PL;SBJ V;3;PL;SBJ V;3;PL
alucinar V;2;PL;IMP;NEG	 Propecia a propecia a propeci
printar V;3;PL;IND;PST;IPFV	 tester "V;3;PL;IND;PST;IPF" V
simpatizar V;1;SG;IND;FUT	individuo simpatizar V;1;SG;IN
ondular V;2;SG;SBJV;FUT	 SBJ V;2;SG;SBJ V;FUTj V;2;SG;
sobressair V;1;SG;SBJV;PRS	airesobressairesobressairesobr
escassear V;2;SG;SBJV;PST;IPFV	escassear V;2;SG;SBJV;2;SG;SBJ
maltar V;2;SG;IMP;NEG	 Maltar V;2;SG;IMP;NEG;IMP;NEG
delinear V;1;PL;SBJV;PRS	er V;1;PL;SBJ1;PL;SBJ1;PL;SBJS
desistir V;2;PL;SBJV;PRS	estir estir estir estir estir 
secundar V;2;PL;SBJV;PRS	ecundary secundar and secundar
ensaiar V;2;PL;IND;PST;PRF	ensaiar V;2;PL;IND;PST;PRFensa
analisar V;2;SG;IND;PRS	 PRS 100 mg per per per per pe
sonambular V;2;PL;COND	 condition is a sonambular or 
alucinar V;1;PL;IND;PRS	 1 2 3 4 5 6 7 8 9 10 11 12 13
comprehender V;2;PL;SBJV;PRS	identifier V;2;PL;SBJV;2;PL;SB
molestar V;1;PL;NFIN	;1;PL;NFINew York Times New Ro
biotransformar V;1;PL;IMP;POS	ar biotransformar biotransform
pagar V;1;PL;COND	a pagar V;1;PL;CONDENSA PAGAR 
designar V;1;PL;IND;PST;PFV	 contacto con v desear V desea
engendrar V;2;SG;IMP;POS	sammanfattar V;2;SG;IMP;POS;PO
jazer V;3;PL;IND;PRS	 0.00 0.00 0 0 0 0 0 0 0 0 0 0
tratar V;1;PL;SBJV;PRS	 1;PL;SBJ1;PL;SBJ1;PL;SBJ1;PL;
instigar V.PTCP;MASC;PL;PST	 PTCP;MASC;PL;PST;PST;PST;PST;
leiloar V;3;PL;SBJV;FUT	eiloar eiloar eiloar eiloar ei
uivar V;2;PL;IND;PST;PRF	 Para algoritmo de production 
ludibriar V;2;SG;IMP;NEG	 SG IMP NEG IMP NEG IMP NEG IM
complicar V;1;PL;IMP;NEG	o complicar V;1;PL;IMP;NEG;1;1
açacalar V.PTCP;FEM;SG;PST	açacalar V.PTCP;FEM;SG;PST;PS
escravizar V;1;SG;COND	out V;1;SG;CONDE 1;SG;CONDE 2;
colorar V;1;PL;SBJV;PST;IPFV	ar colorar colorar colorar col
cagar V;NFIN	agar V;NFINmin New V;NFINmin N
alucinar V.PTCP;FEM;SG;PST	 PTCP;FEM;SG;PST;PST;PST;PST;P
blogar V;2;PL;COND	 el V;2;PL;COND y el V;2;PL;CO
enrubescer V;2;PL;SBJV;FUT	2;PL;SBJV;FUTraditional Tradit
cagar V;2;SG;SBJV;PST;IPFV	a cagar a cagar a cagar a caga
conjecturar V;3;SG;COND	;3;SG;COND;3;SG;COND;3;SG;COND
assoprar V;3;PL;IMP;POS	a temperados de alento de alen
destratar V;3;SG;IMP;NEG	registrar V;3;SG;IMP;NEG;NEG;N
crochetar V;2;SG;IND;PST;IPFV	 chart articular chart articul
aquaplanar V;3;PL;IND;PST;IPFV	 Aquaplanar Aquaplanar Aquapla
surtar V;1;SG;COND	 SG CONDAR SG CONDAR SG CONDAR
silenciar V;3;PL;SBJV;PRS	reducir el sentido como si fue
latir V;3;SG;SBJV;PRS	atir V;3;SG;SBJV;PRSg;sbjv;prs
frequentar V;NFIN	;NFINmi;Next;Norte;Noroeste;No
içar V;1;PL;IND;FUT	 diretor de diretório de mark
sinterizar V;3;SG;IND;PRS	reducir V;3;SG;IND;PRS;PRS;PRS
flutuar V;2;SG;SBJV;FUT	lutuar V;2;SG;SBJ V;FUTflutuar
leiloar V;1;SG;IND;PST;IPFV	ar V;1;SG;IND;PST;IPFVeranda V
blogar V;3;PL;IND;PST;PFV	 blogar V;3;PL;IND;PST;PFVersi
lambujar V;2;SG;NFIN	arambujar V;2;SG;NFINew 2017 S
printar V;2;PL;IND;FUT	 V;2;PL;IND;FUTz printar V;2;P
impregnar V;2;PL;IMP;POS	impregnar V;2;PL;IMP;POS;POS;P
attentar V;1;SG;IND;PST;PRF	 V;1;SG;IND;PST;PRF;PRF;PRF;PR
arianizar V;2;PL;IMP;NEG	izar V;2;PL;IMP;NEG PL;IMP;NEG
marchar V;3;PL;IND;FUT	marchar V;3;PL;IND;FUTghar V;3
arquejar V;1;PL;IMP;POS	ar V;1;PL;IMP;POS;POS;POS;POS;
encriptar V;2;SG;SBJV;PST;IPFV	e e incluso encriptar V;2;SG;S
manjar V;2;PL;IND;PST;PRF	 2 PL IND PST PRF PL IND PST P
alocar V;2;SG;IND;PST;PFV	 SG;IND;PST;PF SG;IND;PST;PF S
vesguear V;3;PL;SBJV;FUT	ar V;3;PL;SBJV;FUTjv;futjv;fut
encetar V;3;PL;SBJV;PST;IPFV	 Productos de la marca V;3;PL;
eliminar V;2;SG;IMP;NEG	elimportante professional SG;I
ziguezaguear V;1;PL;SBJV;FUT	ar V;1;PL;SBJV;FUTr V;1;PL;SBJ
bombardear V;3;SG;SBJV;PST;IPFV	ar V;3;SG;SBJV;PST;IPFVe3;SG;S
ladrar V;1;SG;IND;PST;PRF	ar V;1;SG;IND;PST;PRF;PRF;PRF;
amamentar V.PTCP;MASC;PL;PST	amamentar V.PTCP;MASC;PL;PST;P
protrair V;3;PL;IMP;POS	rotrair V;3;PL;IMP;POS;IMP;POS
menosprezar V;2;SG;IND;FUT	enosprzar V;2;SG;IND;FUT;FUTzu
botar V;3;SG;IMP;POS	 Sobre idioma Posui idioma Pos
ascender V;1;PL;IND;FUT	ascender V;1;PL;IND;FUT;FUT;FU
ruir V;3;PL;NFIN	 a chair a chair a chair a cha
munir V;1;PL;NFIN	 munir V;1;PL;NFIN munir V;1;P
estimular V;3;PL;SBJV;PRS	a canal sex prosternal sex pro
bombardear V;1;SG;IND;FUT	ardear V;1;SG;IND;FUT;FUT;FUT;
escassear V;3;PL;IND;FUT	escassear V;3;PL;IND;FUT;FUT;F
registrar V;2;PL;NFIN	ergistrar V;2;PL;NFINgistrar V
maquinar V;2;SG;SBJV;PRS	; 2;SG;SBJV;PRSS;PRSSS;PRSSSSS
embasar V;3;SG;IMP;NEG	 sedang membasar V;3;SG;IMP;NE
sonambular V;2;PL;IMP;POS	 Contraction of the Ventral So
frequentar V;2;SG;SBJV;FUT	out 2019 - Parte 2
Parte 2 de 
comprehender V;2;SG;NFIN	 comprehender V;2;SG;NFINeine 
lambujar V;1;PL;SBJV;PRS	ambujar V;1;PL;SBJV;PRSeerat V
crescer V;1;PL;IND;PST;PFV	 continuar leyendo la nota de 
leiloar V;3;SG;IND;FUT	ar V;3;SG;IND;FUT;FUT;fut;fut;
antidotar V;NFIN	 N;NFINg N;NFINg N;NFINg N;NFI
sufocar V;1;SG;COND	ANDALUSIA V;1;SG;CONDALUSIA V;
rufar V;2;PL;IND;PST;PFV	 V 2 PL IND PST PF V 2 PL IND 
estrumar V.PTCP;MASC;SG;PST	 PTCP;MASC;SG;PST;PST;PST;PST;
registar V;2;SG;IND;PST;PRF	egistrar V;2;SG;IND;PST;PRF;PR
postular V.PTCP;FEM;SG;PST	a postular V.PTCP;FEM;SG;PST;P
anabolizar V;2;PL;SBJV;PRS	 este tiempo el anabolizar V;2
printar V;2;SG;COND	 printar V;2;SG;CONDe printar 
desvairar V;NFIN	ar desvairar desvairar desvair
desrespeitar V.PTCP;MASC;SG;PST	ritual de responsabilidade V.P
prover V;2;SG;SBJV;PST;IPFV	er V;2;SG;SBJ V;2;SG;SBJ V;2;S
comichar V;1;PL;IND;PST;IPFV	 comichar V;1;PL;IND;PST;IPFV;
telhar V;1;PL;IMP;NEG	 a a a a a a a a a a a a a a a
assemelhar V;3;SG;IMP;POS	rios e comentários assemelhar
simpatizar V;1;SG;SBJV;PST;IPFV	identificar Si no es simple a 
deliciar V;3;PL;COND	en la primera persona de la le
flutuar V;1;SG;SBJV;PST;IPFV	 fluar fluar fluar fluar fluar
ladrar V;3;PL;IND;PST;PFV	a med förvaring a med förvar
expectorar V;1;SG;NFIN	;1;SG;NFINFINight V;1;SG;NFINi
munir V;2;SG;NFIN	 Sunnir Sunnir Sunnir Sunnir S
destratar V;3;PL;IND;PST;PFV	 V;3;PL;IND;PST;PFV;3;PL;IND;P
estocar V;3;SG;IND;PST;PRF	;PRF;PRF;PRF;PRF;PRF;PRF;PRF;P
kickar V;1;PL;SBJV;PST;IPFV	 sen 2017-05-11 10:00 2017-05-
ponderar V;3;PL;SBJV;FUT	at man ikke har någon att man
desarmar V;1;SG;IND;PRS	independente de la presión de
terminar V.PTCP;FEM;PL;PST	ar V.PTCP;FEM;PL;PSTerminar V.
antidotar V;3;SG;IMP;NEG	antidotar V;3;SG;IMP;NEG;NEG;N
remunerar V;1;PL;IND;PST;IPFV	 1 PL IND PST IPF PST IPF PST 
vomitar V;1;SG;NFIN	 Sandy Sandy Sandy Sandy Sandy
ponderar V;2;SG;IMP;NEG	innehåller V;2;SG;IMP;NEG;IMP
vesguear V.PTCP;MASC;PL;PST	anos V.PTCP;MASC;PL;PSTeen sec
analisar V;2;SG;COND	DIAGNOSTICS CONDITIONER CONDIT
realçar V.PTCP;MASC;PL;PST	ealçar V.PTCP;MASC;PL;PSTeal
arquivar V;1;SG;IND;PST;PFV	 arquivar V;1;SG;IND;PST;PFV;1
secundar V;3;SG;IND;PST;PFV	ar V;3;SG;IND;PST;PF secundar 
adjudicar V;2;PL;IND;PST;PFV	ar V 2 P 2 P 2 P 2 P 2 P 2 P 2
arianizar V;1;SG;COND	arianizar V;1;SG;CONDentro de 
açacalar V;2;SG;IMP;NEG	acalar V;2;SG;IMP;NEG;IMP;NEG;
marchar V;2;SG;NFIN	archive room in V;2;SG;NFIN SG
desrespeitar V;2;PL;IND;PST;PRF	itos de pronunciar e de respon
estimular V;2;PL;SBJV;PST;IPFV	a contraction sensation V;2;PL
abafar V;2;SG;NFIN	abafar V;2;SG;NFINcompatible S
sobressair V;3;PL;COND	obressair V;3;PL;CONDAIR V;3;P
desentranhar V;1;PL;IND;FUT	;1;PL;IND;FUT;FUT;FUT;FUT;FUT;
blasonar V;1;PL;IMP;NEG	ar V;1;PL;IMP;NEGsonar V;1;PL;
arrebentar V;3;SG;SBJV;PRS	ebentar V;3;SG;SBJV;PRSebenta
simbolizar V;3;SG;NFIN	 SG;NFINcorrer a ser esta esta
acortinar V;3;SG;IND;FUT	acortinar V;3;SG;IND;FUT;FUT;F
crochetar V;3;SG;IND;PST;PFV	 chakra de color de cabello de
açacalar V;2;SG;IND;PRS	açaçaçaçaçaçaçaçaçaç
cumprimentar V;1;SG;IND;FUT	 contra contra contra contra c
vincular V;1;PL;IND;PRS	; S 11000000000000000000000000
latir V;1;SG;SBJV;PST;IPFV	atir V;1;SG;SBJ V;1;SG;SBJ V;1
agradar V;2;SG;SBJV;PRS	rier de la carta rier de la c
silenciar V.PTCP;FEM;SG;PST	 PTCP;FEM;SG;PST;PST;PST;PST;P
derrapar V;2;SG;COND	errapar V;2;SG;CONDar V;2;SG;C
desentranhar V;2;SG;IND;PST;PFV	entranhar V;2;SG;IND;PST;PF V;
botar V;3;SG;IND;PST;PRF	a sa sa sa sa sa sa sa sa sa s
escavar V;1;SG;IND;PRS	area V;1;SG;IND;PRSescovar V;1
sobressair V;3;SG;COND	DESSAIR V;3;SG;CONDESSAIR V;3;
zumbificar V;1;SG;SBJV;PST;IPFV	ar V;1;SG;SBJV;PST;IPFVer 1;SG
confraternizar V;2;SG;SBJV;PST;IPFV	relato de la confraternidad de
parcelar V;3;SG;SBJV;PST;IPFV	 con sus sus sus sus sus sus s
prender V;2;SG;COND	er le lenguage de la sigla esc
sociabilizar V;2;PL;SBJV;PST;IPFV	ociabilizar V;2;PL;SBJV;2;PL;S
alocar V;1;PL;COND	ar V;1;PL;CONDENADO V;1;PL;CON
comprehender V;1;SG;SBJV;PRS	er V;1;SG;SBJV;PRSgt;1;SBJ com
fatorar V;3;PL;NFIN	a se se se se se se se se se s
terminar V;3;SG;IMP;POS	ar V;3;SG;IMP;POS;POS;POS;POS;
adoecer V;2;SG;COND	ADOECER V;2;SG;CONDECER V;2;SG
agradar V;1;PL;IND;PRS	a cartera 1;1;2;3;4;5;6;7;8;1;
retaliar V;3;SG;NFIN	etaliar V;3;SG;NFINetaliar V;3
vomitar V;3;SG;IND;PST;PFV	ar V;3;SG;IND;PST;PFV;3;SG;IND
resplandecer V;1;PL;COND	esplandecer V;1;PL;COND;COND;C
designar V;3;SG;SBJV;FUT	r V;3;SG;SBJV;FUTj y tallas co
adjudicar V;1;SG;SBJV;PRS	estar al azar | Ser al azar | 
adivinhar V;2;PL;IND;FUT	adivinhar V;2;PL;IND;FUT;FUT;F
instigar V;2;SG;SBJV;PRS	 statistik for statistik for s
inquirir V;3;PL;IMP;POS	risco de reservas V;3;PL;IMP;P
mutilar V;3;PL;IND;PST;IPFV	 Proton differential transfer 
entrar V;1;SG;COND	estrella estrella estrella est
denominar V;1;SG;IND;FUT	 posicion 1 1 0 0 0 0 0 0 0 0 
guarnecer V;2;SG;IND;PST;PFV	anacortes de carranza de carra
desentranhar V;2;PL;IND;PST;PRF	 de comprimidos de comprimidos
desdizer V;1;SG;NFIN	er V;1;SG;NFINsg 1 sg 1 sg 1 s
arquivar V;1;PL;IND;PST;PRF	ita  V 1 PL IND PST PRF 1 PL 
seguir V;1;SG;SBJV;PRS	esta en falso a dica de que po
redimir V;3;SG;IND;PST;PFV	edimir V;3;SG;IND;PST;PFV;3;SG
tretar V;2;SG;SBJV;FUT	ar V;2;SG;SBJV;FUTretar V;2;SG
teorizar V;2;PL;IND;PST;IPFV	 V e P L e I N D P S T I F V e
escassear V;3;SG;IND;PST;PFV	assear V;3;SG;IND;PST;PF V;3;S
impregnar V;3;SG;IND;PST;PRF	ation V;3;SG;IND;PST;PRF;PRF;P
açacalar V;1;SG;IND;PST;IPFV	acacalar V;1;SG;IND;PST;IPFV;1
encomendar V;2;PL;IND;PST;IPFV	omingo de Vendas de Vendas Ven
festar V;3;SG;IND;PST;IPFV	 m f f h i j k l m n o q u v e
encetar V;3;SG;IND;FUT	ar V;3;SG;IND;FUT;FUT;FUT;FUT;
tanger V;2;PL;SBJV;PST;IPFV	re standard standard standard 
encetar V;2;PL;IMP;NEG	encetar V;2;PL;IMP;NEGH;2;PL;I
instigar V;3;PL;SBJV;PST;IPFV	ar V;3;PL;SBJV;3;PL;SBJV;3;PL;
maltar V;1;SG;SBJV;PST;IPFV	 SB SB SB SB SB SB SB SB SB SB
entrar V;3;PL;NFIN	 en esta entrevista a la serie
visar V;3;PL;IND;PST;PRF	 V;3;PL;IND;PST;PRFerrari V;3;
consolidar V;3;SG;SBJV;PST;IPFV	o constituir V;3;SG;SBJV;3;SG;
cumprir V;2;SG;NFIN	r SGSNFINSGSNFINSGSNFINSGSNFIN
afundir V;3;SG;NFIN	fundir SV3;SG;NFINLFINLFINLFIN
expectorar V.PTCP;MASC;SG;PST	ectoral V.PTCP;MASC;SG;PST
PTC
criticar V;2;SG;IMP;POS	recorrer V;2;SG;IMP;POS;POS;PO
desarranjar V.PTCP;FEM;PL;PST	educacion e servicio de autoes
refogar V;2;SG;SBJV;PST;IPFV	efogar V;2;SG;SBJ V;2;SG;SBJ V
ziguezaguear V;1;SG;IND;PRS	iguezaguear V;1;SG;IND;PRS;INS
bebericar V;2;SG;SBJV;PRS	ericar V;2;SG;SBJV;PRSG;SBJV;P
publicitar V;3;SG;IND;PST;IPFV	identidad comercial de publici
blasonar V;2;PL;COND	ar V;2;PL;CONDESAR V;2;PL;COND
inquirir V.PTCP;FEM;PL;PST	ir V.PTCP;FEM;PL;PSTem present
estimar V;2;SG;IND;FUT	ar V;2;SG;IND;FUT;FUT;FUT;FUT;
uivar V;2;SG;SBJV;FUT	 2019 0 0 0 0 0 0 0 0 0 0 0 0 
cuidar V;2;SG;IND;FUT	ar V;2;SG;IND;FUT;FUT;FUT;FUT;
absceder V;2;PL;IND;PST;IPFV	absceder V;2;PL;IND;PST;IPFV;2
alucinar V;1;SG;IND;FUT	ar V;1;SG;IND;FUTar V;1;SG;I
designar V;3;PL;IND;PRS	direccionar desenho de cortina
aquaplanar V;3;PL;IND;PRS	a a a a a a a a a a a a a a a 
deixar V;2;PL;IND;PST;PFV	 e p e p e p e p e p e p e p e
agachar V;1;SG;IND;PST;PFV	agachar V;1;SG;IND;PST;PFVenga
simpatizar V;1;PL;IND;PST;IPFV	interiorizar simpatizar simpat
pegar V;2;PL;IND;PST;PFV	 Pegar V;2;PL;IND;PST;PF Pegar
rufar V;2;PL;IND;PST;PRF	 V;2;PL;IND;PST;PRF;PRF;PRF;PR
estercar V.PTCP;PRS	 PTCP;PRSestercar V.PTCP;PRSes
instigar V;3;PL;NFIN	 stigar V;3;PL;NFIN og V;3;PL;
citar V.PTCP;MASC;PL;PST	 Para la canción de Para la c
mumificar V;3;SG;SBJV;PRS	ar V;3;SG;SBJV;PRSBJV;PRSBJV;P
antidotar V;3;PL;IND;PST;PRF	 Antidoto Antidoto Antidoto An
bombardear V;2;PL;SBJV;FUT	ardear V;2;PL;SBJV;FUTj V;2;PL
predominar V.PTCP;MASC;SG;PST	omio V.PTCP;MASC;SG;PST;PST;PS
concordar V;3;PL;NFIN	oncerdar V;3;PL;NFINFINFINFINF
estocar V;1;SG;IND;FUT	estocar V;1;SG;IND;FUT;FUT;FUT
visitar V;2;SG;IMP;POS	resultados de la película de 
designar V;3;PL;SBJV;PRS	. es. es. es. es. es. es. es. 
proceder V;3;SG;IMP;NEG	roceder V;3;SG;IMP;NEG;3;SG;IM
safar V;1;SG;COND	 Safar V;1;SG;COND Safar V;1;S
enramalhetar V;2;PL;COND	ar V;2;PL;COND;COND;COND;COND;
confraternizar V;2;PL;IMP;POS	 confraternizar V;2;PL;IMP;POS
impregnar V;2;PL;NFIN	a impregnar V;2;PL;NFINsa inte
abafar V;2;PL;IND;PST;PFV	abafar V;2;PL;IND;PST;PFV;2;PL
deixar V;3;SG;IND;PST;PRF	line de texto para a imagem es
abafar V;2;SG;IMP;POS	abafar V;2;SG;IMP;POS/2;SG/IMP
existir V;2;PL;COND	existir V;2;PL;CONDesejado exi
vir V;3;PL;IND;PST;PRF	 V;3;PL;IND;PST;PRFe;PRFe;PRFe
deliciar V;1;PL;SBJV;PRS	rumpe el control de la polla d
saturar V;2;PL;IMP;POS	ar V;2;PL;IMP;POS;2;PL;2;PL;2;
auferir V;3;SG;IND;PRS	auferir V;3;SG;IND;PRS;PRS;PRS
regularizar V.PTCP;MASC;SG;PST	regularizar V.PTCP;MASC;SG;PST
corroborar V;3;SG;IMP;POS	redar V;3;SG;IMP;POS;POS;POS;P
harmonizar V;1;SG;SBJV;PRS	rmonizar V;1;SG;SBJV;PRSg 1;SG
auguriar V;2;PL;IND;FUT	 2017 - 2018 - V;2;PL;IND;FUT

vir V;2;PL;SBJV;PRS	 Torvaldsen V;2;PL;SBJ Torvald
reiterar V;3;PL;IMP;NEG	 stereiterar V;3;PL;IMP;NEGste
alfabetizar V;3;PL;COND	 V;3;PL;CONDENA V;3;PL;CONDENA
pisotear V;1;PL;NFIN	ar PL;NFINlear PL;NFINlear PL;
estipular V;2;SG;SBJV;FUT	ar V;2;SG;SBJV;FUTj V;2;SG;SBJ
ensaboar V;2;SG;IND;FUT	 V;2;SG;IND;FUT;FUT;FUT;FUT;FU
talhar V;2;SG;SBJV;FUT	alhar V;2;SG;SBJV;FUTilhar V;2
criticar V;2;PL;SBJV;PST;IPFV	 V;2;PL;SBJV;2;PL;SBJV;2;PL;SB
terminar V;2;SG;COND	ar V;2;SG;CONDar V;2;SG;CONDar
derrapar V;2;PL;IND;PRS	estado de acuerdo con los estu
brincar V;1;PL;IND;PRS	rincar V;1;PL;IND;PRSesar brin
retinir V;2;SG;SBJV;PRS	en se se se se se se se se se 
enramalhetar V;2;SG;SBJV;PST;IPFV	 SG;SBJ V;2;SG;SBJ V;2;SG;SBJ 
estercar V;1;PL;SBJV;PST;IPFV	articles 1 2 3 4 5 6 7 8 9 10 
maltar V;2;PL;IND;FUT	maltar V;2;PL;IND;FUTIND;FUTIN
commandar V;NFIN	 V;NFINe et V;NFINe V;NFINe V;
gatunar V;2;SG;SBJV;PST;IPFV	ar V;2;SG;SBJ V;2;SG;SBJ V;2;S
amancebar V;3;PL;NFIN	amancebar V;3;PL;NFINl;nfinl;n
deixar V;1;PL;SBJV;PRS	ico en linea en linea en linea
bombardear V;2;SG;IMP;NEG	ar V;2;SG;IMP;NEG;IMP;NEG;IMP;
escravizar V;1;SG;SBJV;FUT	 1;SG;SBJ V;1;SG;SBJ V;1;SG;SB
amaynar V;2;PL;SBJV;PST;IPFV	a karamaynar V;2;PL;SBJ V;2;PL
delimitar V;3;SG;NFIN	eliminar V;3;SG;NFINeliminar V
sociabilizar V;2;PL;IMP;POS	 V;2;PL;IMP;POS;2;PL;IMP;POS;2
blasonar V;2;PL;SBJV;PST;IPFV	ar V;2;PL;SBJ V;2;PL;SBJ V;2;P
tosar V;2;PL;IND;FUT	 V;2;PL;IND;FUT;FUT;FUT;FUT;FU
encriptar V;2;PL;SBJV;PRS	red de contraseña Para esta p
administrar V;1;PL;IND;FUT	editor de contador de contador
ousar V;2;PL;IND;FUT	 2;PL;IND;FUT V;2;PL;IND;FUT V
escassear V;2;PL;SBJV;FUT	escassear V;2;PL;SBJV;FUThe se
adoecer V;3;SG;IND;PST;PRF	ecer V;3;SG;IND;PST;PRF;PRF;PR
existir V;2;PL;SBJV;PST;IPFV	 filtros de paginas a paginas 
escassear V.PTCP;PRS	a V.PTCP;PRSescassear V.PTCP;P
estipular V;3;SG;IMP;POS	estipular V;3;SG;IMP;POS;POS;P
estrumar V;3;PL;IND;PRS	indicaciones para la periorida
incorporar V;2;SG;IND;PST;PRF	 incorporated incorporary inco
contrabalançar V;1;PL;NFIN	ar 1;1;2;3;4;5;6;7;8;8;8;8;8;8
aparafusar V;3;PL;NFIN	aparafusar V;3;PL;NFINFINFINFI
contra-atacar V;2;PL;IND;PST;IPFV	ar V;2;PL;IND;PST;IPFVer el co
ablegar V;1;PL;NFIN	 tablegar V;1;PL;NFINFINFINFIN
patentear V;3;SG;IND;PST;IPFV	atenear V;3;SG;IND;PST;IPFV;3;
lesmar V;1;SG;IND;PRS	 1 SG IND PRSession 1 Session 
adoecer V;1;PL;SBJV;FUT	adoecer V;1;PL;SBJV;FUThermoph
tilintar V;3;PL;IND;PRS	 1999 1999 1999 1999 1999 1999
condenar V;2;PL;IND;PRS	ar V;2;PL;IND;PRSgo condenar V
ensaboar V;2;PL;IND;FUT	ar V;2;PL;IND;FUT;FUTensaboar 
commandar V;3;SG;COND	on commandar v;3;sg;cond comma
delinear V;1;PL;IND;PST;PFV	 PL IND PS T P IND PS T P IND 
ziguezaguear V;3;PL;SBJV;PRS	ar V;3;PL;SBJV;PRSBJ V;3;PL;SB
colorar V;3;PL;SBJV;FUT	ar V;3;PL;SBJV;FUTj colorar V;
impregnar V;2;SG;SBJV;PST;IPFV	register of the View View View
sinterizar V;1;PL;SBJV;PST;IPFV	e es sintoma de se poder estan
atenazar V;2;PL;NFIN	e Profesor Profesor Profesor P
teorizar V;3;SG;IND;FUT	 V;3;SG;IND;FUTeorizar V;3;SG;
alocar V;2;PL;IMP;POS	river press the word the word 
sociabilizar V;3;PL;SBJV;FUT	r V;3;PL;SBJV;FUTj V;FUTj V;FU
antidotar V;1;SG;IND;PST;PFV	 antidotar V;1;SG;IND;PST;PFVe
conjecturar V;3;SG;IND;PRS	;PRS;PRS;PRS;PRS;PRS;PRS;PRS;P
tilintar V;3;PL;COND	 PL COND PL COND PL COND PL CO
ascender V;3;SG;NFIN	ascendant V;3;SG;NFINerascenda
aquaplanar V;2;PL;IND;PRS	a a a a a a a a a a a a a a a 
incorporar V;2;PL;IMP;NEG	incorporar V;2;PL;IMP;NEGenera
talhar V;2;SG;IND;PST;PRF	ar V;2;SG;IND;PST;PRF;PRF;PRF;
silenciar V;2;PL;IND;PST;PFV	estado de consumo de calor de 
reiterar V;1;PL;SBJV;FUT	ar V;1;PL;SBJV;FUT 1;PL;SBJ 1;
contrair V;1;SG;IND;PST;PRF	e contrair V;1;SG;IND;PST;PRFe
privilegiar V;1;PL;SBJV;FUT	e privilegiar V;1;PL;SBJV;FUTj
expectorar V;1;SG;COND	 2010 08 24 Expectoration of t
attentar V;1;PL;SBJV;FUT	a attentar V;1;PL;SBJV;FUTrans
expectorar V;3;PL;IND;PST;PFV	ectoral V;3;PL;IND;PST;PFV;3;P
sinterizar V;3;PL;IND;PST;PRF	 V;3;PL;IND;PST;PRFe;PL;IND;PS
desdizer V;1;PL;IND;PRS	esdizer V;1;PL;IND;PRSesdizer 
estimular V;1;SG;COND	 sexual sensation SG;CONDar V;
saturar V;3;PL;NFIN	a a la que se adecua a la segu
protrair V;3;PL;IND;PST;PFV	rotrair V;3;PL;IND;PST;PFVersi
registar V;3;PL;IND;FUT	ergistar V;3;PL;IND;FUTgergist
ousar V;3;PL;IND;PST;PRF	 Ali Akeem Akeem Akeem Akeem A
barbear V;1;PL;IND;PRS	arbear V;1;PL;IND;PRSearch thi
torrar V;3;PL;IND;PRS	estructura de la signosa de la
kickar V;3;PL;NFIN	 spela spela spela spela spela
liquefazer V;1;SG;IND;PST;PRF	en contre le train de la roche
munir V;1;SG;NFIN	 Salamunir Salamunir Salamunir
attentar V;1;SG;IND;FUT	ar V;1;SG;IND;FUT V;1;SG;IND;F
liderar V.PTCP;FEM;PL;PST	ar PTCP;FEM;PL;PST;PST;PST;PST
grudar V;2;SG;IND;PRS	risiko V;2;SG;IND;PRSgrudar V;
vesguear V;3;SG;SBJV;PRS	ar V;3;SG;SBJV;PRSar V;3;SG;SB
sortear V;1;SG;IND;PST;IPFV	ar V;1;SG;IND;PST;IPFVersion a
arquejar V;2;SG;IND;PST;IPFV	 2;SG;IND;PST;IPFV 2;SG;IND;PS
arseniar V;3;PL;SBJV;PRS	eniar V;3;PL;SBJV;PRSeniar V;3
entrar V;1;SG;SBJV;FUT	 1;SG;SBJ 1;SG;SBJ 1;SG;SBJ 1;
kickar V;1;PL;COND	 spelar V;1;PL;CONDer spelar V
recompensar V;1;PL;IND;FUT	ompositor V;1;PL;IND;FUT;FUT;1
vir V;2;SG;SBJV;PST;IPFV	 talia no de foro | Talia no d
implicar V;3;SG;COND	 es el siguiente en este artí
apreciar V;2;PL;IND;PST;PRF	apreciar apreciar apreciar apr
enramalhetar V;1;SG;SBJV;FUT	alhetar V;1;SG;SBJV;FUTlhetar 
festar V;1;SG;SBJV;PST;IPFV	 1;SG;SBJ 1;SG;SBJ 1;SG;SBJ 1;
pescar V;3;SG;IND;PRS	 de productos de productos de 
enfileirar V;2;SG;IND;PST;IPFV	enfileirar V;2;SG;IND;PST;IPFV
aclamar V;1;PL;IMP;NEG	aclamar V;1;PL;IMP;NEG V;1;PL;
teclar V;2;PL;IND;PST;PRF	eclar V;2;PL;IND;PST;PRFeclar 
derrapar V;2;SG;IMP;POS	o en esta clase se puede encon
sortear V;3;SG;COND	 la biblia de la sortear V;3;S
saltear V;3;PL;IND;PST;PFV	 a a a a a a a a a a a a a a a
sufocar V;3;SG;IND;PST;PFV	 SG IND PST PF V SG IND PST PF
agachar V;2;PL;IMP;NEG	 Sarasamy Sarasamy Sarasamy Sa
arianizar V;3;PL;NFIN	arianizar arianizar arianizar 
registrar V;3;PL;IND;PRS	.v.subscription 10000000000000
aparafusar V.PTCP;FEM;SG;PST	aparafusar V.PTCP;FEM;SG;PST;P
cuidar V;3;SG;COND	AR V;3;SG;CONDAR V;3;SG;CONDAR
arquejar V;3;SG;IND;PST;PRF	;SG;IND;PST;PRF;PRF;PRF;PRF;PR
vesguear V;1;SG;NFIN	;1;SG;NFINLIN 1;SG;NFINLIN 1;S
estimar V;2;PL;COND	ar V;2;PL;CONDE ESTIMAR V;2;PL
cotejar V;1;PL;SBJV;PST;IPFV	 cotejar V;1;PL;SBJ V;1;PL;SBJ
denominar V;2;SG;SBJV;FUT	e sexo e lengua especial V;2;S
desentranhar V;3;SG;IND;PST;IPFV	a de entrrrrrrrrrrrrrrrrrrrrrr
inflamar V;1;SG;SBJV;PRS	arteria sinflamar V;1;SG;SBJV;
condecorar V;1;PL;IMP;POS	er condecorar V;1;PL;IMP;POS;I
ascender V;2;SG;NFIN	ascender V;2;SG;NFINerd V;2;SG
acreditar V;2;SG;SBJV;PRS	e se acreditar V;2;SG;SBJV;PRS
compensar V;2;PL;IMP;POS	on 2010 - 2011 - Portal de Com
prender V;3;SG;IND;PRS	ender V;3;SG;IND;PRS;PRS V;3;S
tanger V;2;SG;IMP;NEG	er V;2;SG;IMP;NEG;NEG;NEG;NEG;
desiludir V;3;SG;SBJV;PRS	 SBJ SBJ SBJ SBJ SBJ SBJ SBJ S
discar V;2;SG;IMP;POS	car V;2;SG;IMP;POS;POS;POS;POS
entabuar V;1;SG;IND;PST;PFV	ar V;1;SG;IND;PST;PFV;1;SG;IND
recompensar V.PTCP;FEM;PL;PST	empleo de competencia y recomp
rimar V;2;PL;IND;PST;PFV	 V V V V V V V V V V V V V V V
crescer V;3;SG;SBJV;PST;IPFV	er continuar con la crescer co
menstruar V;2;PL;IND;PST;IPFV	emenstuar V;2;PL;IND;PST;IPFV;
manjar V;1;PL;IND;PRS	 1 2 3 4 5 6 7 8 9 10 11 12 13
comendar V;1;PL;IND;PST;PFV	 comendar V;1;PL;IND;PST;PFV;1
sobresair V;3;SG;IND;FUT	 V;3;SG;IND;FUT;FUT;FUT;FUT;FU
menosprezar V;1;SG;IND;PST;PRF	zar V;1;SG;IND;PST;PRF;PRF;PRF
alegar V;3;PL;IMP;NEG	 Plantilla de Palegar V;3;PL;I
alojar V;2;SG;NFIN	ar Se estrella de la loteria d
estipular V;2;SG;SBJV;PRS	ar V;2;SG;SBJV;PRSnar V;2;SG;S
copular V.PTCP;FEM;SG;PST	 Paracer V.PTCP;FEM;SG;PST;PST
adivinhar V;2;PL;SBJV;PRS	adivinhar V;2;PL;SBJV;PRSeriff
arianizar V;1;PL;IMP;NEG	izar V;1;PL;IMP;NEG L;IMP;NEG 
munir V;3;SG;IND;PST;IPFV	 SG;IND;PST;IPFVw SG;IND;PST;I
aclamar V;3;PL;IND;FUT	aclamar V;3;PL;IND;FUT;FUT;FUT
sortear V;1;PL;SBJV;FUT	ar V;1;PL;SBJV;FUT V;1;PL;SBJV
fluorar V;1;SG;IND;PST;PFV	length: 1000 V;1;SG;IND;PST;PF
papar V;3;PL;SBJV;FUT	apar V;3;PL;SBJV;FUT} T} T} T}
attentar V;1;SG;SBJV;PST;IPFV	 attentar V;1;SG;SBJ V;1;SG;SB
compensar V;2;PL;SBJV;PST;IPFV	 compartir V;2;PL;SBJ V;2;PL;S
derrapar V.PTCP;PRS	a de para para para para para 
delimitar V;1;SG;IND;FUT	 size of size of size of size 
doar V;1;SG;NFIN	ar V;1;SG;NFINe;1;1;1;1;1;1;1;
privilegiar V;2;SG;IMP;POS	rivillgiar V;2;SG;IMP;POS;POS;
achatar V;1;PL;SBJV;PRS	 de res / alimentación / alim
rimar V;3;SG;IND;PST;PRF	 Sala de presentacion de prese
abarcar V;2;SG;IND;PST;PFV	a car V;2;SG;IND;PST;PFV;2;SG;
deliciar V;3;SG;IND;PST;PFV	e se puede del contrato de con
simbolizar V;2;SG;IMP;POS	 esta simbología se podrá de
registrar V;3;PL;SBJV;PST;IPFV	datas de servidor V;3;PL;SBJ V
amancebar V;2;PL;IMP;NEG	 PL;2;IMP;NEGs;2;PL;2;2;2;2;2;
formigar V;3;SG;IND;PST;PFV	a formigar V;3;SG;IND;PST;PFVa
guardar V;3;PL;COND	ar V;3;PL;CONDAR V;3;PL;CONDAR
safar V;1;PL;IND;FUT	a a a a a a a a a a a a a a a 
depenar V;3;PL;NFIN	 depenar depenar depenar depen
talhar V;3;PL;SBJV;FUT	alhar V;3;PL;SBJV;FUTalhar V;3
expectorar V;3;SG;IND;PST;IPFV	ectoral V;3;SG;IND;PST;IPFV;3;
vomitar V;1;SG;IND;PST;PFV	 1 SG;IND;PST;PFV;1;SG;IND;PST
algemar V;3;SG;IMP;POS	arte de la calidad de la prota
resplandecer V;1;PL;IND;PST;IPFV	e plandecer V;1;PL;IND;PST;IPF
talhar V.PTCP;MASC;PL;PST	 V.PTCP;MASC;PL;PST;PST;PST;PS
raciocinar V;2;SG;IND;PRS	;PRSb 100 mg 1 mg 1 mg 1 mg 1 
estocar V;2;SG;SBJV;PRS	 SG SBJ SBJ SBJ SBJ SBJ SBJ SB
tretar V;3;PL;NFIN	retar V;3;PL;NFINl;nfinl;nfinl
atenazar V;2;SG;IMP;POS	atenazar V;2;SG;IMP;POS;POS;PO
formigar V;3;PL;IND;PRS	ar 1;2;3;2;1;1;1;1;1;1;1;1;1;1
fluorar V;2;PL;SBJV;PRS	 characteristics of a fluorine
gatunar V;1;SG;IND;PRS	 1. Sarasamy V;1;SG;IND;PRS;IN
arrebentar V;1;SG;IND;PRS	ebentar V;1;SG;IND;PRSgrebenta
postular V;1;SG;SBJV;PST;IPFV	 postular V;1;SG;SBJ V;1;SG;SB
indiciar V;3;SG;NFIN	 3;SG;NFIN;3;SF;SG;SN ;3;SG;SN
saturar V;2;PL;IND;PRS	ar V;2;PL;IND;PRSaturar V;2;PL
aclamar V;1;SG;COND	A CONDITION OF CONDITION OF CO
tratar V;3;SG;IND;PST;PFV	 3;SG;IND;PST;PF 3;SG;IND;PST;
encabular V.PTCP;PRS	a Participante en la Participa
latinar V;1;SG;IND;PST;PRF	atinar V;1;SG;IND;PST;PRF V;1;
comichar V;1;PL;NFIN	 1 1 1 1 1 1 1 1 1 1 1 1 1 1 1
apedrejar V;3;PL;IND;PST;IPFV	 Parapedrejar V;3;PL;IND;PST;I
contrabalançar V;2;PL;IMP;NEG	ar V;2;PL;IMP;NEG;NEG;NEG;NEG;
ruir V;1;SG;IND;PST;PRF	 V;1;SG;IND;PST;PRF;PRF;PRF;PR
rimar V;NFIN	ar IV;NFIN IV;NFIN IV;NFIN IV;
pagar V;3;PL;NFIN	ar V;3;PL;NFIN;IN;IN;IN;IN;IN;
contactar V;3;SG;IND;PST;PFV	ones de sonido de V;3;SG;IND;P
depenar V;3;PL;IMP;POS	ar V;3;PL;IMP;POS;POS;POS;POS;
retardar V;2;SG;IND;PRS	etardar V;2;SG;IND;PRSetardar 
copular V;3;SG;SBJV;PST;IPFV	 SG;SBJ SBJ SBJ SBJ SBJ SBJ SB
prevalecer V;2;SG;NFIN	er el prevalecer V;2;SG;NFINli
commandar V.PTCP;PRS	 PTCP;PRSe PRSe PRSe PRSe PRSe
encabular V;1;SG;SBJV;FUT	a Tradicional Tradicional Trad
condenar V;3;PL;SBJV;FUT	ar V;3;PL;SBJV;FUTraducir V;3;
simpatizar V;NFIN	impulsar V;NFINess V;NFINess V
instigar V;1;PL;IMP;POS	 ska instigar V;1;PL;IMP;POS;I
aplainar V;2;SG;IND;FUT	aplainar V;2;SG;IND;FUTfutfutf
vesguear V.PTCP;PRS	 V.PTCP;PRSee V.PTCP;PRSee V.P
deixar V;1;PL;IND;FUT	 comentários V;1;PL;IND;FUT 
pegar V;3;SG;SBJV;FUT	ar V;3;SG;SBJV;FUTrajes de com
molestar V;1;SG;IND;PST;PRF	olestar Molestar Molestar Mole
antidotar V;2;PL;SBJV;PRS	 Antidotar V;2;PL;SBJ V;2;PL;S
desiludir V;2;PL;COND	esiludir V;2;PL;CONDAR V;2;PL;
inflamar V;2;SG;SBJV;FUT	inflamación de la parotis par
lambujar V;1;PL;COND	ar V;1;PL;CONDAR V;1;PL;CONDAR
proliferar V;2;PL;IND;PRS	 proliferative proliferative p
tosar V;2;PL;IMP;NEG	ar V;2;PL;IMP;NEG;2;PL;2;2;2;2
confraternizar V;2;PL;IND;FUT	rio de confraternidad confrate
torpedear V;2;PL;SBJV;PRS	orpediar V;2;PL;SBJV;PRSee V;2
revelar V;2;SG;IND;PRS	;PRSequence 2011;100: 10000000
papar V;1;SG;IND;FUT	ar and analysis papar V;1;SG;I
olear V;2;PL;NFIN	 PL;NFINear PL;NFINear PL;NFIN
publicitar V;3;SG;IND;PRS	itar V;3;SG;IND;PRSeguridad pu
tretar V;1;SG;COND	 SG CONDe SG CONDe SG CONDe SG
proliferar V.PTCP;FEM;PL;PST	 Proliferar V.PTCP;FEM;PL;PST 
condenar V;2;PL;IND;PST;IPFV	 condenar V;2;PL;IND;PST;IPFV;
estocar V;3;PL;SBJV;FUT	 PL;SBJ V;FUT 3;PL;SBJ V;FUT 3
cagar V;3;SG;IMP;NEG	ararararararararararararararar
derrapar V;2;SG;IND;PST;IPFV	arapar errapar errapar errapar
açacalar V;2;PL;SBJV;PRS	a cu açacu açacu açacu aça
desvairar V;1;SG;SBJV;PST;IPFV	et se la venda de la para la p
sangrar V;2;PL;IND;FUT	 10 dayar sangrar V;2;PL;IND;F
volver V.PTCP;MASC;SG;PST	 V.
Revolver V. Revolver V. Re
papar V;2;PL;IND;PRS	an papar V;2;PL;IND;PRSan Papa
corroborar V;3;SG;SBJV;FUT	ar V;3;SG;SBJV;FUTj V;3;SG;SBJ
pisotear V;1;PL;SBJV;PRS	isotear V;1;PL;SBJV;PRSnapshot
attentar V;3;SG;COND	a attentar V;3;SG;CONDA attent
teorizar V;3;PL;SBJV;PST;IPFV	 V;3;PL;SBJV;3;PL;SBJV;3;PL;SB
extinguir V;1;SG;IND;PST;IPFV	estimate of the V 1 SG IND PST
proliferar V;3;PL;IND;PRS	ar V;3;PL;IND;PRSection of a p
derrapar V;3;PL;COND	 PL;COND de rapar V;3;PL;COND 
reiterar V;3;SG;IND;PST;IPFV	ar V;3;SG;IND;PST;IPFVideo V;3
tosar V;1;SG;IND;PST;IPFV	 V 1 SG IND PST IPF V 1 SG IND
remunerar V;2;SG;IND;PST;PFV	ar V;2;SG;IND;PST;PFV;2;SG;IND
eliminar V;3;PL;SBJV;PRS	 cantae cantae cantae cantae c
rastrejar V;2;SG;NFIN	rejar V;2;SG;NFINejar V;2;SG;N
supurar V;1;PL;SBJV;PRS	 1 2 3 4 5 6 7 8 9 10 11 12 13
estocar V;2;PL;IND;PST;PFV	 PL IND PS T P F V P V I N D P
indiciar V;2;PL;IMP;POS	 de por medio de pos de pos de
ensaboar V;2;SG;IMP;POS	 2 SG IMP POS 2 S 2 S 2 S 2 S 
pegar V;3;PL;IMP;POS	ar V;3;PL;IMP;POS;IMP;POS;IMP;
alojar V;1;PL;IND;PST;IPFV	 Parte 1 de 2 1 2 3 4 5 6 7 8 
sonambular V;3;PL;SBJV;PRS	a case of a paraclete subcompr
formigar V;3;SG;SBJV;FUT	 3;SG;SBJV;FUTj 3;SG;SBJV;FUTj
engendrar V;3;SG;IND;PST;PFV	endrar V;3;SG;IND;PST;PFVs V;3
latinar V;2;PL;IND;FUT	atinar V;2;PL;IND;FUT;FUT;FUT;
vomitar V;3;PL;SBJV;PRS	 1.1 mg / kg / kg / kg / kg / 
conjecturar V;1;SG;IND;PRS	 conjuncturar V;1;SG;IND;PRSej
excetuar V;2;PL;IMP;NEG	e excetuar V;2;PL;IMP;NEG;2;2;
desafogar V;2;SG;IMP;POS	a de carro de carro de carro d
kickar V;3;PL;SBJV;FUT	 sex show show show show show 
existir V;1;PL;IMP;NEG	exister V;1;PL;IMP;NEG;1;PL;IM
indiciar V;3;PL;COND	o indiciar V;3;PL;CONDADO DE D
aquaplanar V;2;PL;SBJV;PRS	a planar aquaplanar aquaplanar
postular V;2;PL;IND;PRS	ar postular V;2;PL;IND;PRSns p
pregar V;2;SG;IMP;NEG	 SG;IMP;NEG SG;IMP;NEG SG;IMP;
guarnecer V;2;PL;IND;PRS	er V;2;PL;IND;PRS;PRS;PRS;PRS;
designar V;1;SG;SBJV;PRS	 content with the artist of th
desafogar V;3;PL;NFIN	esafogar PV;3;PL;NFINj;3;PL;NF
latinar V;3;SG;SBJV;PRS	a para la para la para la para
pagar V;2;PL;IND;PST;PRF	ama sama sama sama sama sama s
alocar V;1;SG;IND;PRS	 Alocar V;1;SG;IND;PRSe Alocar
ostracizar V;1;PL;SBJV;PST;IPFV	identificar V;1;PL;SBJV;1;PL;S
finalizar V.PTCP;PRS	 PTCP PRS PRS PRS PRS PRS PRS 
expectorar V;1;SG;IND;PST;PRF	 1 1 1 1 1 1 1 1 1 1 1 1 1 1 1
rufar V;1;PL;IND;PST;PRF	ar V;1;PL;IND;PST;PRFeedback V
extinguir V.PTCP;FEM;PL;PST	e este este este este este est
proceder V;2;SG;SBJV;PRS	 2;SG;SBJ V;PRS 2;SG;SBJ V;PRS
brunir V;2;SG;SBJV;PRS	 saka saka saka saka saka saka
bombardear V;1;PL;NFIN	ear V;1;PL;NFINlear V;1;PL;NFI
redimir V;3;SG;IND;PRS	ever V;3;SG;IND;PRSberedimir V
recompensar V;1;PL;COND	entero V;1;PL;COND;COND;COND;C
assemelhar V;1;SG;IND;PST;IPFV	ar V;1;SG;IND;PST;IPFV;1;SG;IN
lesmar V;3;PL;SBJV;PST;IPFV	;3;PL;SBJV;PST;IPFV;PST;IPFV;P
arseniar V;3;SG;SBJV;PRS	arseniar V;3;SG;SBJV;PRSeniar 
recompensar V;2;PL;IND;PST;PRF	entrenamiento de complementos 
visar V;1;PL;IND;PST;PRF	 V;1;PL;IND;PST;PRFe;PL;IND;PS
adoecer V;3;SG;SBJV;PST;IPFV	adoecer V;3;SG;SBJ V;3;SG;SBJ 
entabuar V;1;PL;IND;PST;PRF	ar V;1;PL;IND;PST;PRF;IND;PST;
arseniar V;1;PL;IND;PST;PRF	eniarseniarseniarseniarseniars
arquivar V;1;SG;SBJV;PST;IPFV	 to to to V;1;SG;SBJV;1;SG;SBJ
remunerar V;NFIN	emunerar V;NFINMINMINMINMINMIN
tilintar V;2;PL;IND;FUT	intar V;2;PL;IND;FUT 2 PL;IND;
arquejar V;1;PL;IND;PST;PRF	arquejar Para la puesta en mar
estimar V;3;PL;IND;PST;PRF	estimar V;3;PL;IND;PST;PRFesti
amarrar V;3;PL;SBJV;FUT	a rar V;3;PL;SBJV;FUT;3;PL;SBJ
entrar V;NFIN	 en el caso de V;NFIN en el ca
lambujar V;2;PL;COND	ambujar V;2;PL;CONDEDEDEDEDEDE
jazer V;2;SG;IND;PST;PFV	 arabic arabic arabic arabic a
contrabalançar V;1;SG;SBJV;PRS	ar contrabalançar V;1;SG;SBJV
commandar V;1;SG;COND	ouvrir commandar commandar com
barbear V;2;PL;IMP;NEG	arbear V;2;PL;2MP;2EG;2EG;2EG;
cumprimentar V;2;PL;COND	e condado V;2;PL;CONDado V;2;P
engastar V;1;SG;NFIN	ar V;1;SG;NFINengastar V;1;SG;
rufar V;3;PL;SBJV;FUT	ar V;3;PL;SBJV;FUTzufar V;3;PL
estercar V;3;SG;IND;PST;PFV	ar V;3;SG;IND;PST;PF V;3;SG;IN
luctar V;3;SG;IND;PST;PFV	 la pregnancy de la pregnancy 
expectorar V;3;SG;IND;FUT	; V;3;SG;IND;FUT;FUT;FUT;FUT;F
remunerar V;1;PL;IND;FUT	erar V;1;PL;IND;FUT;FUT;FUT;FU
abocanhar V.PTCP;FEM;SG;PST	 Parabocanhar V.PTCP;FEM;SG;PS
abscindir V;2;PL;SBJV;PST;IPFV	identificador de abscindir abs
revelar V;2;PL;IMP;POS	elar V;2;PL;IMP;POS;2;POS;2;PO
escavar V;1;SG;IND;PST;PFV	ar V;1;SG;IND;PST;PFV;1;SG;IND
conjecturar V;2;SG;IND;PST;PRF	onjonjonjonjonjonjonjonjonjonj
agachar V;1;PL;IND;PST;PFV	agachar V;1;PL;IND;PST;PFVe1;P
maltar V;3;SG;SBJV;PST;IPFV	 SG;SBJ V;PST;IPF V;PST;IPF V;
ruir V;1;PL;NFIN	 a chair a chair a chair a cha
tosar V;1;SG;COND	 1. SG. CONDAR 1. SG. CONDAR 2
aventar V;2;SG;IND;PST;PRF	ar V;2;SG;IND;PST;PRFeat V;2;S
abarcar V.PTCP;FEM;SG;PST	 proceso de control de tribus 
simpatizar V;2;SG;IND;PST;PFV	individualizar V;2;SG;IND;PST;
deixar V;3;PL;COND	eixar V;3;PL;CONDAIXOAR V;3;PL
desiludir V;3;SG;SBJV;PST;IPFV	esiludir Siludir Siludir Silud
tratar V;2;PL;IND;PST;IPFV	 P F I F I N D P S T I N F I O
respirar V;3;PL;SBJV;PST;IPFV	respirar V;3;PL;SBJV;3;PL;SBJV
vomitar V;3;PL;IND;PST;PRF	 Protophora Protophora Protoph
registar V;1;PL;SBJV;PST;IPFV	 1 2 3 4 5 6 7 8 9 10 ... 11 N
assoprar V;2;SG;IND;FUT	a a a a a a a a a a a a a a a 
içar V;3;PL;IND;FUT	 diretor de diretores de diret
inquirir V;1;PL;COND	 1 PL CONDE SE INQUIRIR V;1;PL
aclamar V;1;PL;SBJV;PST;IPFV	aclamar V;1;PL;SBJ V;1;PL;SBJ 
aplainar V;3;PL;SBJV;FUT	aplainar V;3;PL;SBJV;FUTjV;FUT
apoteosar V;2;SG;IND;PST;PFV	apoteosar V;2;SG;IND;PST;PFV;2
saltear V;2;SG;IND;PRS	 SG;IND;PRS 2 Saltear V;2;SG;I
concordar V;1;PL;IND;PRS	onconconconconconconconconconc
reiterar V;1;SG;COND	DER SICHT EIN SICHT EIN SICHT 
confraternizar V;3;PL;SBJV;PST;IPFV	relacionarse con el confratern
afundir V;3;SG;IMP;POS	 Safundir Safundir Safundir Sa
apreciar V;3;SG;NFIN	er lista de apreciar lista de 
vomitar V;2;SG;IND;FUT	 V;2;SG;IND;FUT;FUT;FUT;FUT;FU
arrebentar V;2;SG;IND;PST;PFV	arrebentar V;2;SG;IND;PST;PFV;
incorporar V;3;PL;IND;FUT	 V;3;PL;IND;FUT;FUT;FUT;FUT;FU
ligar V;2;PL;SBJV;PST;IPFV	s med V;2;PL;SBJ V;2;PL;SBJ V;
desdizer V;3;PL;SBJV;PRS	er desdizer desdizer desdizer 
objetar V;1;SG;SBJV;PST;IPFV	 objetos de objetos de objetos
mastigar V;2;PL;IND;PRS	mastigar V;2;PL;IND;PRSamastig
desistir V;1;PL;IND;PRS	en desistir V;1;PL;IND;PRSen d
charquear V.PTCP;MASC;PL;PST	ar V.PTCP;MASC;PL;PST;PST;PST;
crescer V;2;SG;IMP;NEG	rescer V;2;SG;IMP;NEG;NEG;NEG;
alucinar V;2;PL;IMP;POS	 Propionato de alucinar V;2;PL
blogar V;3;SG;SBJV;FUT	 1 hora a la venta de blogar V
pegar V;2;SG;IND;FUT	ar V;2;SG;IND;FUTemporada V;2;
talhar V.PTCP;FEM;PL;PST	ar V.PTCP;FEM;PL;PST;PST;PST;P
comichar V;1;PL;SBJV;FUT	 1;PL;SBJV;FUTj 1;PL;SBJV;FUTj
destratar V;2;PL;IND;FUT	out V;2;PL;IND;FUT;FUT;fut fut
contrabalançar V;NFIN	ar V;NFINfiNfiNfiNfiNfiNfiNfiN
auguriar V;2;PL;IND;PST;PFV	 2017 » Contact » Contact »
desarrazoar V;1;SG;IND;FUT	estrada V;1;SG;IND;FUT;FUT;FUT
concordar V;2;PL;NFIN	rido V;2;PL;NFINFINFINFINFINFI
objetar V;1;PL;NFIN	 objetar V;1;PL;NFINl;nfinl;nf
antidotar V.PTCP;FEM;PL;PST	ar V.PTCP;FEM;PL;PST;PST;PST;P
desarmar V;3;SG;NFIN	 SG;NFINesarmar SG;NFINesarmar
indiciar V;3;PL;IND;PST;PFV	 p r e n g h i j k l m n i j k
delinear V;1;PL;IMP;POS	 PL IMP POS SW POS SW POS SW P
sociabilizar V;3;PL;IMP;POS	 Desociabilizar V;3;PL;IMP;POS
copular V;1;SG;SBJV;PRS	 Scheremethrich scopular V;1;S
resplandecer V;3;PL;IND;PST;PRF	;3;PL;IND;PST;PRFe;3;PL;IND;PS
criticar V;2;SG;IND;PST;PRF	redactar V;2;SG;IND;PST;PRFeda
direcionar V;1;SG;SBJV;FUT	 V;1;SG;SBJV;FUTg SBJ SBJ SBJ 
teclar V;3;PL;IMP;POS	eclar V;3;PL;IMP;POS;POS;IMP;P
desarranjar V;1;SG;IND;PST;PRF	arranjar V;1;SG;IND;PST;PRFe;S
transitar V;2;SG;IND;FUT	 V;2;SG;IND;FUTz V;2;SG;IND;FU
protrair V;1;PL;IND;PST;PRF	rotrair protrair protrair prot
commandar V;1;PL;SBJV;PST;IPFV	ar V;1;PL;SBJV;1;PL;SBJV;1;PL;
decrescer V;1;PL;IND;PST;PFV	escribe un articolo sobre el c
vincular V;2;SG;SBJV;PST;IPFV	 Series V;2;SG;SBJ Series V;2;
liquefazer V;1;SG;SBJV;FUT	reste de la compagnie de la co
acreditar V;1;PL;IND;PST;IPFV	 con la palabra creditar V;1;P
munir V;NFIN	munir V;NFINmunir V;NFINmunir 
punguear V;1;PL;COND	ar V;1;PL;CONDAR V;1;PL;CONDAR
desafogar V;3;SG;IND;PRS	esafogar V;3;SG;IND;PRSesafoga
telar V;3;PL;IND;PST;IPFV	 manuscrita  manuscrita V 3 P
interferir V;2;SG;SBJV;FUT	r V;2;SG;SBJV;FUTfutfutfutfutf
consternar V;3;PL;IMP;NEG	 constrnar V;3;PL;IMP;NEG;3;PL
polimerizar V;2;SG;SBJV;PST;IPFV	erizar V;2;SG;SBJV;2;SG;SBJV;2
visitar V;1;SG;IND;PST;PRF	a esta terapi se vision a se v
assemelhar V;1;SG;SBJV;PRS	ar assemelhar V;1;SG;SBJV;PRSa
saturar V;1;PL;IMP;POS	ar V;1;PL;IMP;POS;POS;POS;POS;
revelar V;1;SG;IND;PRS	 Prevelar V;1;SG;IND;PRSevelar
amancebar V;3;PL;IND;FUT	 V;3;PL;IND;FUTl V;3;PL;IND;FU
ablegar V;3;PL;IND;PST;PRF	ablegar V;3;PL;IND;PST;PRFe;PL
agradar V;3;SG;SBJV;PRS	rier de la sección de agradar
entabuar V;2;SG;SBJV;PST;IPFV	a cara de para sa mana de para
deixar V;1;SG;SBJV;PRS	ico en linea en linea en linea
eliminar V;3;SG;IND;PST;IPFV	 V;3;SG;IND;PST;IPFVe3;SG;IND;
encarcerar V;2;PL;COND	encarcerar V;2;PL;COND;COND;CO
expedir V.PTCP;FEM;PL;PST	edir V.PTCP;FEM;PL;PST;PST;PST
surtar V;3;PL;COND	ar V;3;PL;CONDER V;3;PL;CONDER
barbear V;2;SG;SBJV;FUT	ear V;2;SG;SBJV;FUTlear V;2;SG
ousar V;2;SG;IND;PST;PFV	 2 SG;IND;PST;PF V;2;SG;IND;PS
saturar V;3;PL;IND;PST;PRF	aturar V;3;PL;IND;PST;PRFerram
ensaiar V;1;SG;SBJV;PST;IPFV	a en la entrega de presentes e
analisar V;2;SG;SBJV;PRS	 2;SG;SBJ V;PRS 2;SG;SBJ V;PRS
convencer V;2;SG;COND	on V;2;SG;CONDENAR V;2;SG;COND
reconsiderar V;NFIN	 No se puede considerar V;NFIN
aventar V;2;PL;SBJV;PRS	 comentarios Intervenir coment
comendar V;2;PL;SBJV;FUT	rio de pl;sbj V;FUTj V;FUTj V;
zumbificar V.PTCP;MASC;SG;PST	 Para esta categorizacion se z
papar V;3;SG;IND;PST;IPFV	arti ka paper paper paper pape
engendrar V;3;PL;IMP;POS	n samlar in en samlar in en sa
escavar V;1;SG;SBJV;FUT	escavar V;1;SG;SBJV;FUTl;1;SG;
escravizar V;3;PL;IND;PRS	idad de la cabeza de la cama d
tagarelar V;3;SG;SBJV;FUT	arelar V;3;SG;SBJV;FUT3;SG;SBJ
desarranjar V;3;PL;IND;PST;PFV	esarrrrrrrrrrrrrrrrrrrrrrrrrrr
desarranjar V;1;PL;NFIN	estrutura de arrenjar V;1;PL;N
papar V;3;PL;SBJV;PRS	ana par V;3;PL;SBJV;PRSearch r
mastigar V;1;PL;IND;PRS	 PL IND PR S 1 2 3 4 5 6 7 8 9
ziguezaguear V;2;SG;IND;PST;PFV	ar V;2;SG;IND;PST;PFV;2;SG;IND
pisotear V;1;PL;SBJV;FUT	ar V;1;PL;SBJV;FUTj V;FUTj V;F
eliminar V;2;SG;IND;PST;IPFV	 SG;IND;PST;IPFVeliminar V;2;S
registar V;1;SG;NFIN	ar V;1;SG;NFINfinfinfinfinfinf
aquaplanar V;3;PL;NFIN	a a a a a a a a a a a a a a a 
menstruar V;3;PL;IND;PST;PFV	emenstuar V;3;PL;IND;PST;PFV;3
pretender V;1;PL;IND;PST;PRF	pretender V;1;PL;IND;PST;PRF;P
volver V;NFIN	 V;NFINe Ine Ine Ine Ine Ine I
terminar V;3;PL;SBJV;PRS	ar V;3;PL;SBJV;3;PL;SBJV;3;PL;
teclar V;2;SG;IND;PRS	 PRSeclar V;2;SG;IND;PRSeclar 
bombardear V;2;SG;IND;FUT	ardear V;2;SG;IND;FUT;FUT;FUT;
enramalhetar V;1;PL;IND;PST;IPFV	 PL IND PST;IPF V;1;PL;IND;PST
talhar V;1;SG;SBJV;FUT	alhar V;1;SG;SBJV;FUTilhar V;1
tilintar V;2;SG;IND;PST;PFV	 SG IND PST PF Versi SG IND PS
menstruar V;3;PL;COND	enstruar V;3;PL;CONDar V;3;PL;
recompensar V;3;SG;IND;PST;IPFV	ensaio de componentes de compo
expectorar V;2;SG;IMP;POS	 2009 11 21 22 23 24 25 26 27 
vincular V.PTCP;MASC;SG;PST	 Particular V.PTCP;MASC;SG;PST
grudar V;1;PL;SBJV;FUT	 statistik o personer för and
içar V;3;SG;IND;FUT	a divulgação do post anterio
fatorar V;1;SG;NFIN	a serie a serie a serie a seri
alocar V;3;SG;SBJV;PST;IPFV	 Salon de prensa V;3;SG;SBJ V;
inquirir V;3;PL;IMP;NEG	 3;PL;IMP;NEG;NEG;NEG;NEG;NEG;
amancebar V;1;SG;SBJV;PRS	a cebar V;1;SG;SBJV;PRSna 1;SG
pescar V;1;PL;IMP;NEG	 PL IMP NEG PL IMP NEG PL IMP 
miscrar V;3;SG;IND;PST;PRF	 miscrar miscrar miscrar miscr
alegar V;3;PL;SBJV;FUT	 Para la temporada de la tempo
proceder V;2;PL;NFIN	 proceder V;2;PL;NFINFINFINFIN
festar V.PTCP;PRS	 Para o V.PTCP;PRSe e PRSe e P
vesguear V;2;PL;IND;PST;PRF	 Independiente de la Vesguear 
desossar V;3;SG;IMP;NEG	esossar V;3;SG;IMP;NEG;NEG;NEG
retinir V;NFIN	 V;NFINMR IIIIIIIIIIIIIIIIIIII
abocanhar V;2;PL;NFIN	abocanhar V;2;PL;NFINlabocanha
ondular V;1;SG;SBJV;PRS	 Serological ondular V;1;SG;SB
administrar V;3;SG;IND;PRS	direccion de administrar V;3;S
abarcar V;2;SG;SBJV;FUT	ar V;2;SG;SBJV;FUTl;SBJV;FUTl;
decrescer V;3;PL;SBJV;PRS	estar en el campo y decrescer 
sociabilizar V;1;PL;NFIN	r de desociabilizar desociabil
indiciar V;1;PL;NFIN	 indiciar V;1;PL;NFINg indicia
maquinar V;3;SG;COND	mamaquinar V;3;SG;CONDD;CONDD;
entabuar V;2;SG;SBJV;FUT	ar V;2;SG;SBJV;FUTz V;2;SG;SBJ
analisar V;2;SG;IND;PST;PFV	analisar V;2;SG;IND;PST;PFVers
ruir V;2;PL;SBJV;PRS	 Para reservar a para reservar
sufocar V;3;SG;NFIN	ufocar V;3;SG;NFINew V;3;SG;NF
attentar V;1;SG;SBJV;FUT	ar V;1;SG;SBJV;FUTransfer V;1;
cumprimentar V;2;PL;NFIN	er com compressor de compresso
complicar V;1;PL;SBJV;PST;IPFV	 complicar V;1;PL;SBJ V;1;PL;S
registar V;2;PL;IND;PRS	estado de contagem do contagem
torrar V;2;PL;SBJV;FUT	 se se se se se se se se se se
reiterar V.PTCP;FEM;PL;PST	a PTCP;FEM;PL;PST;PST;PST;PST;
miscrar V;2;SG;IMP;POS	ar V;2;SG;IMP;POS;POS;POS;POS;
inquirir V;1;SG;IND;PRS	 presente de un consultorio de
cuidar V;2;PL;SBJV;PST;IPFV	 Versión Para Calidad de temp
estrumar V;2;PL;NFIN	ar V;2;PL;NFINc;2;PL;NFINc;2;P
sobressair V;3;PL;IND;PST;PRF	onessair V;3;PL;IND;PST;PRFe;p
apatetar V;2;PL;IMP;POS	apatetar V;2;PL;IMP;POS;POS;PO
contrair V;3;SG;COND	rair V;3;SG;COND;3;SG;COND;3;S
apoteosar V;3;SG;IMP;NEG	poteosar V;3;SG;IMP;NEG;IMP;NE
escravizar V;2;SG;NFIN	rescribir con el escribir el e
flutuar V;3;PL;IND;PST;IPFV	ar V;3;PL;IND;PST;IPFV;3;PL;IN
assignalar V;1;SG;SBJV;PST;IPFV	assignment assignment assignme
munir V;2;SG;IND;PST;IPFV	 SG;IND;PST;IPFVw SG;IND;PST;I
zumbificar V;3;SG;SBJV;FUT	ar V;3;SG;SBJV;FUTraspaso de c
munir V;2;SG;IND;PST;PRF	 Samuelis Samuelis Samuelis Sa
talhar V;3;PL;IND;PST;IPFV	ar V;3;PL;IND;PST;IPFV;3;PL;IN
telhar V;3;PL;IND;FUT	ar V;3;PL;IND;FUT;FUT;FUT;FUT;
designar V;1;PL;IMP;NEG	 2014 V;1;PL;IMP;NEG;1;PL;IMP;
predominar V;2;PL;SBJV;PST;IPFV	e predominar V;2;PL;SBJV;2;PL;
copular V;2;SG;NFIN	2;SG;NFINecrostachyon V;2;SG;N
predominar V;3;PL;IND;FUT	dominante V;3;PL;IND;FUT;FUT;F
abscindir V;NFIN	ir V;NFINmir V;NFINmir V;NFINm
contrabalançar V;3;SG;IND;FUT	r V;3;SG;IND;FUT;FUT;FUT;FUT;F
simpatizar V;2;SG;COND	V;2;SG;CONDar V;2;SG;CONDar V;
fluorar V;3;PL;IMP;NEG	 fluorar V;3;PL;IMP;NEGenerate
ocorrer V;1;PL;NFIN	ocorrer V;1;PL;NFINFINFINFINFI
liquefazer V;2;SG;IND;PRS	aire de liquefazer V;2;SG;IND;
ligar V;3;SG;SBJV;PRS	a sammenligar V;3;SG;SBJV;PRSn
comprehender V;2;PL;IND;PST;PRF	 comprehender V;2;PL;IND;PST;P
desarranjar V;2;PL;IND;PST;PRF	estructura desarrollar V;2;PL;
mutilar V;2;PL;SBJV;PST;IPFV	 Protein S1 1 1 1 1 1 1 1 1 1 
visitar V;2;SG;SBJV;FUT	a con la visita de visita de v
encomendar V.PTCP;MASC;PL;PST	encomendar V.PTCP;MASC;PL;PST;
alegar V;1;SG;IND;PST;IPFV	 : V;1;SG;IND;PST;IPFV;1;SG;IN
jazer V.PTCP;FEM;SG;PST	 Mujazer V.PTCP;FEM;SG;PSTv.PT
convencer V;2;PL;IND;PST;PFV	er V;2;PL;IND;PST;PFV;2;PLV;2;
escavar V;2;SG;IMP;POS	escavar V;2;SG;IMP;POS;POS;2;S
vesguear V;1;PL;NFIN	esguear 1. 1. 1. 1. 1. 1. 1. 1
encharcar V.PTCP;PRS	ar V.PTCP;PRSencharcar V.PTCP;
copular V;2;PL;IND;FUT	 - Wikipedia
سلام V;2;PL;I
achatar V;3;SG;IND;PST;PRF	achatar V;3;SG;IND;PST;PRF;PRF
remunerar V;3;PL;IMP;POS	er menos de un solo punto de v
estipular V;1;SG;SBJV;PST;IPFV	estipular V;1;SG;SBJ V;1;SG;SB
resplendecer V;3;SG;IND;FUT	esplendecer V;3;SG;IND;FUT;FUT
papar V;3;SG;IND;FUT	ar and and and and and and and
engastar V;3;PL;IND;PST;PFV	 PL IND PST PF V;3;PL IND PST 
mutilar V;1;PL;IND;PRS	 1. Protein subunitin 2. Prote
nublar V;3;PL;SBJV;FUT	ar V;3;PL;SBJV;FUT9;3;PL;SBJV;
capotar V;2;SG;IND;PST;IPFV	 SG;IND;PST;IPF;2;SG;IND;PST;I
damnar V;2;PL;NFIN	arbetsväsen med stöd för st
afundir V;3;PL;SBJV;PRS	 PR Select or click the profil
simbolizar V;3;SG;IMP;POS	 esta simbología se debe de e
resplandecer V;3;SG;COND	ESPLENDORA V;3;SG;COND;COND;CO
desenrolar V;2;SG;IMP;POS	 1 2 3 4 5 6 7 8 9 10 11 12 13
fluorar V;2;SG;IMP;NEG	 fluorar V;2;SG;IMP;NEG;NEG;NE
denominar V;2;SG;COND	 e esta terceira de ser por pa
anotar V;3;SG;IND;PST;IPFV	 para la panotar V;3;SG;IND;PS
crescer V;2;PL;IND;PST;IPFV	 considerar como se le atraves
olhar V;NFIN	 ;NFINS ;NFINS ;NFINS ;NFINS ;
apedrejar V;2;SG;IMP;NEG	er V;2;SG;IMP;NEG SG;IMP;NEG S
escravizar V;2;SG;IND;PST;PFV	escrivizar V;2;SG;IND;PST;PFVe
pôr V;2;PL;IND;PST;PRF	 de personalité  de personal
pescar V;3;PL;IND;PST;PFV	 Pescar Pescar Pescar Pescar P
surtar V;NFIN	 N;N;N;N;N;N;N;N;N;N;N;N;N;N;N
pisotear V;3;SG;COND	 SG COND SG COND SG COND SG CO
agachar V;1;PL;COND	 Mangalagachar V;1;PL;CONDA Ma
estimular V;2;PL;SBJV;FUT	a contraction and sex to end p
optar V;3;PL;IMP;NEG	 optar V;3;PL;IMP;NEGs optar V
polimerizar V;3;PL;IND;FUT	 V;3;PL;IND;FUT;FUT;FUT;FUT;FU
escalfar V.PTCP;FEM;SG;PST	; PST; PSG; PSG; PSG; PSG; PSG
instigar V;3;SG;IND;PST;IPFV	instigar V;3;SG;IND;PST;IPFVer
