Generate the inflected form for: Arabize V;PRS;NOM(3,SG)	Arabizes	Arabizes
Generate the inflected form for: Arabize V;V.PTCP;PRS	Arabizing	Arabizing
Generate the inflected form for: Arabize V;V.PTCP;PST	Arabized	Arabized
Generate the inflected form for: DL V;PST	DL	DLed
Generate the inflected form for: DL V;V.PTCP;PST	DLed	DLed
Generate the inflected form for: GI V;PRS;NOM(3,SG)	GIs	GIs
Generate the inflected form for: GI V;V.PTCP;PRS	GIing	GIing
Generate the inflected form for: GI V;V.PTCP;PST	GIed	GIed
Generate the inflected form for: Godcast V;PRS;NOM(3,SG)	Godcasts	Godcasts
Generate the inflected form for: Godcast V;V.PTCP;PRS	Godcasting	Godcasting
Generate the inflected form for: Godcast V;V.PTCP;PST	Godcasted	Godcast
Generate the inflected form for: IRC V;NFIN	IRC	IRC
Generate the inflected form for: IRC V;PRS;NOM(3,SG)	IRCs	IRCs
Generate the inflected form for: IRC V;PST	IRCed	IRCed
Generate the inflected form for: IRC V;V.PTCP;PST	IRCed	IRCed
Generate the inflected form for: Muhammadanize V;NFIN	Muhammadanize	Muhammadanize
Generate the inflected form for: Muhammadanize V;PRS;NOM(3,SG)	Muhammadanizes	Muhammadanizes
Generate the inflected form for: Muhammadanize V;V.PTCP;PST	Muhammadanized	Muhammadanized
Generate the inflected form for: Salafize V;PRS;NOM(3,SG)	Salafizes	Salafizes
Generate the inflected form for: Salafize V;PST	Salafized	Salafized
Generate the inflected form for: Salafize V;V.PTCP;PST	Salafized	Salafized
Generate the inflected form for: Sufize V;PRS;NOM(3,SG)	Sufizes	Sufizes
Generate the inflected form for: Sufize V;V.PTCP;PRS	Sufizing	Sufizing
Generate the inflected form for: Sufize V;V.PTCP;PST	Sufized	Sufized
Generate the inflected form for: abode V;NFIN	abode	abode
Generate the inflected form for: abode V;PRS;NOM(3,SG)	abodes	abodes
Generate the inflected form for: abode V;V.PTCP;PRS	aboding	aboding
Generate the inflected form for: absolve V;PRS;NOM(3,SG)	absolves	absolves
Generate the inflected form for: absolve V;PST	absolved	absolved
Generate the inflected form for: absolve V;V.PTCP;PRS	absolving	absolving
Generate the inflected form for: accept V;NFIN	accept	accept
Generate the inflected form for: accept V;PRS;NOM(3,SG)	accepts	accepts
Generate the inflected form for: accept V;V.PTCP;PRS	accepting	accepting
Generate the inflected form for: accept V;V.PTCP;PST	accepted	accepted
Generate the inflected form for: accession V;NFIN	accession	accession
Generate the inflected form for: accession V;PRS;NOM(3,SG)	accessions	accessions
Generate the inflected form for: accession V;V.PTCP;PRS	accessioning	accessioning
Generate the inflected form for: acetize V;PRS;NOM(3,SG)	acetizes	acetizes
Generate the inflected form for: acetize V;PST	acetized	acetized
Generate the inflected form for: acquire V;NFIN	acquire	acquire
Generate the inflected form for: acquire V;PRS;NOM(3,SG)	acquires	acquires
Generate the inflected form for: acquire V;PST	acquired	acquired
Generate the inflected form for: acquire V;V.PTCP;PRS	acquiring	acquiring
Generate the inflected form for: adhære V;NFIN	adhære	adhære
Generate the inflected form for: adhære V;PST	adhæred	adhæred
Generate the inflected form for: adhære V;V.PTCP;PST	adhæred	adhæred
Generate the inflected form for: adipocerate V;PRS;NOM(3,SG)	adipocerates	adipocerates
Generate the inflected form for: adipocerate V;PST	adipocerated	adipocerated
Generate the inflected form for: adipocerate V;V.PTCP;PRS	adipocerating	adipocerating
Generate the inflected form for: affect V;NFIN	affect	affect
Generate the inflected form for: affect V;PST	affected	affected
Generate the inflected form for: affect V;V.PTCP;PRS	affecting	affecting
Generate the inflected form for: affect V;V.PTCP;PST	affected	affected
Generate the inflected form for: affine V;NFIN	affine	affine
Generate the inflected form for: affine V;PRS;NOM(3,SG)	affines	affines
Generate the inflected form for: affine V;PST	affined	affined
Generate the inflected form for: anticipate V;NFIN	anticipate	anticipate
Generate the inflected form for: anticipate V;PRS;NOM(3,SG)	anticipates	anticipates
Generate the inflected form for: anticipate V;PST	anticipated	anticipated
Generate the inflected form for: anticipate V;V.PTCP;PRS	anticipating	anticipating
Generate the inflected form for: assail V;PRS;NOM(3,SG)	assails	assails
Generate the inflected form for: assail V;PST	assailed	assailed
Generate the inflected form for: assail V;V.PTCP;PRS	assailing	assailing
Generate the inflected form for: assail V;V.PTCP;PST	assailed	assailed
Generate the inflected form for: atsake V;NFIN	atsake	atsake
Generate the inflected form for: atsake V;PRS;NOM(3,SG)	atsakes	atsakes
Generate the inflected form for: atsake V;PST	atsaked	atsook
Generate the inflected form for: aumail V;NFIN	aumail	aumail
Generate the inflected form for: aumail V;PRS;NOM(3,SG)	aumails	aumails
Generate the inflected form for: aumail V;V.PTCP;PRS	aumailing	aumailing
Generate the inflected form for: babify V;NFIN	babify	babify
Generate the inflected form for: babify V;PRS;NOM(3,SG)	babifies	babifies
Generate the inflected form for: babify V;PST	babified	babified
Generate the inflected form for: babify V;V.PTCP;PST	babified	babified
Generate the inflected form for: barhop V;NFIN	barhop	barhop
Generate the inflected form for: barhop V;PRS;NOM(3,SG)	barhops	barhops
Generate the inflected form for: barhop V;V.PTCP;PRS	barhopping	barhopping
Generate the inflected form for: base V;NFIN	base	base
Generate the inflected form for: base V;PRS;NOM(3,SG)	bases	bases
Generate the inflected form for: base V;PST	based	based
Generate the inflected form for: base V;V.PTCP;PST	based	based
Generate the inflected form for: bemaul V;NFIN	bemaul	bemaul
Generate the inflected form for: bemaul V;PRS;NOM(3,SG)	bemauls	bemauls
Generate the inflected form for: bemaul V;V.PTCP;PRS	bemauling	bemauling
Generate the inflected form for: bemaul V;V.PTCP;PST	bemauled	bemauled
Generate the inflected form for: beshape V;NFIN	beshape	beshape
Generate the inflected form for: beshape V;PRS;NOM(3,SG)	beshapes	beshapes
Generate the inflected form for: beshape V;V.PTCP;PRS	beshaping	beshaping
Generate the inflected form for: beshape V;V.PTCP;PST	beshaped	beshaped
Generate the inflected form for: bespirt V;NFIN	bespirt	bespirt
Generate the inflected form for: bespirt V;PRS;NOM(3,SG)	bespirts	bespirts
Generate the inflected form for: bespirt V;V.PTCP;PRS	bespirting	bespirting
Generate the inflected form for: bespirt V;V.PTCP;PST	bespirted	bespirted
Generate the inflected form for: bioactivate V;NFIN	bioactivate	bioactivate
Generate the inflected form for: bioactivate V;PST	bioactivated	bioactivated
Generate the inflected form for: bioactivate V;V.PTCP;PRS	bioactivating	bioactivating
Generate the inflected form for: biodegrade V;NFIN	biodegrade	biodegrade
Generate the inflected form for: biodegrade V;PST	biodegraded	biodegraded
Generate the inflected form for: biodegrade V;V.PTCP;PRS	biodegrading	biodegrading
Generate the inflected form for: biodegrade V;V.PTCP;PST	biodegraded	biodegraded
Generate the inflected form for: biostimulate V;NFIN	biostimulate	biostimulate
Generate the inflected form for: biostimulate V;PRS;NOM(3,SG)	biostimulates	biostimulates
Generate the inflected form for: biostimulate V;PST	biostimulated	biostimulated
Generate the inflected form for: biostimulate V;V.PTCP;PRS	biostimulating	biostimulating
Generate the inflected form for: bliken V;NFIN	bliken	bliken
Generate the inflected form for: bliken V;PST	blikened	blikened
Generate the inflected form for: bliken V;V.PTCP;PRS	blikening	blikening
Generate the inflected form for: bliken V;V.PTCP;PST	blikened	blikened
Generate the inflected form for: bodysurf V;NFIN	bodysurf	bodysurf
Generate the inflected form for: bodysurf V;PST	bodysurfed	bodysurfed
Generate the inflected form for: bodysurf V;V.PTCP;PST	bodysurfed	bodysurfed
Generate the inflected form for: brickfilm V;PRS;NOM(3,SG)	brickfilms	brickfilms
Generate the inflected form for: brickfilm V;PST	brickfilmed	brickfilmed
Generate the inflected form for: brickfilm V;V.PTCP;PRS	brickfilming	brickfilming
Generate the inflected form for: brickfilm V;V.PTCP;PST	brickfilmed	brickfilmed
Generate the inflected form for: bulletize V;NFIN	bulletize	bulletize
Generate the inflected form for: bulletize V;PST	bulletized	bulletized
Generate the inflected form for: bulletize V;V.PTCP;PRS	bulletizing	bulletizing
Generate the inflected form for: bus V;NFIN	bus	bus
Generate the inflected form for: change V;NFIN	change	change
Generate the inflected form for: change V;PRS;NOM(3,SG)	changes	changes
Generate the inflected form for: change V;PST	changed	changed
Generate the inflected form for: change V;V.PTCP;PST	changed	changed
Generate the inflected form for: chequer V;PRS;NOM(3,SG)	chequers	chequers
Generate the inflected form for: chequer V;PST	chequered	chequered
Generate the inflected form for: chequer V;V.PTCP;PRS	chequering	chequering
Generate the inflected form for: chinwag V;NFIN	chinwag	chinwag
Generate the inflected form for: chinwag V;V.PTCP;PRS	chinwagging	chinwagging
Generate the inflected form for: chinwag V;V.PTCP;PST	chinwagged	chinwagged
Generate the inflected form for: chirr V;NFIN	chirr	chirr
Generate the inflected form for: chirr V;PRS;NOM(3,SG)	chirrs	chirrs
Generate the inflected form for: chirr V;PST	chirred	chirred
Generate the inflected form for: chirr V;V.PTCP;PRS	chirring	chirring
Generate the inflected form for: co-locate V;PRS;NOM(3,SG)	co-locates	co-locates
Generate the inflected form for: co-locate V;PST	co-located	co-located
Generate the inflected form for: co-locate V;V.PTCP;PST	co-located	co-located
Generate the inflected form for: codeshare V;NFIN	codeshare	codeshare
Generate the inflected form for: codeshare V;PRS;NOM(3,SG)	codeshares	codeshares
Generate the inflected form for: codeshare V;V.PTCP;PRS	codesharing	codesharing
Generate the inflected form for: codeshare V;V.PTCP;PST	codeshared	codeshared
Generate the inflected form for: coimmunoprecipitate V;NFIN	coimmunoprecipitate	coimmunoprecipitate
Generate the inflected form for: coimmunoprecipitate V;PRS;NOM(3,SG)	coimmunoprecipitates	coimmunoprecipitates
Generate the inflected form for: coimmunoprecipitate V;V.PTCP;PRS	coimmunoprecipitating	coimmunoprecipitating
Generate the inflected form for: coimmunoprecipitate V;V.PTCP;PST	coimmunoprecipitated	coimmunoprecipitated
Generate the inflected form for: comarket V;PRS;NOM(3,SG)	comarkets	comarkets
Generate the inflected form for: comarket V;PST	comarketed	comarketed
Generate the inflected form for: comarket V;V.PTCP;PRS	comarketing	comarketing
Generate the inflected form for: comarket V;V.PTCP;PST	comarketed	comarketed
Generate the inflected form for: commiserate V;NFIN	commiserate	commiserate
Generate the inflected form for: commiserate V;PST	commiserated	commiserated
Generate the inflected form for: commiserate V;V.PTCP;PRS	commiserating	commiserating
Generate the inflected form for: commiserate V;V.PTCP;PST	commiserated	commiserated
Generate the inflected form for: compost V;NFIN	compost	compost
Generate the inflected form for: compost V;PRS;NOM(3,SG)	composts	composts
Generate the inflected form for: compost V;PST	composted	composted
Generate the inflected form for: compost V;V.PTCP;PST	composted	composted
Generate the inflected form for: congest V;NFIN	congest	congest
Generate the inflected form for: congest V;PRS;NOM(3,SG)	congests	congests
Generate the inflected form for: congest V;V.PTCP;PST	congested	congested
Generate the inflected form for: conquer V;PRS;NOM(3,SG)	conquers	conquers
Generate the inflected form for: conquer V;V.PTCP;PRS	conquerring	conquering
Generate the inflected form for: conversation V;NFIN	conversation	conversation
Generate the inflected form for: conversation V;PRS;NOM(3,SG)	conversations	conversations
Generate the inflected form for: conversation V;V.PTCP;PRS	conversationing	conversationing
Generate the inflected form for: conversation V;V.PTCP;PST	conversationed	conversationed
Generate the inflected form for: cordon V;PST	cordoned	cordoned
Generate the inflected form for: cordon V;V.PTCP;PRS	cordoning	cordoning
Generate the inflected form for: cordon V;V.PTCP;PST	cordoned	cordoned
Generate the inflected form for: cosponsor V;NFIN	cosponsor	cosponsor
Generate the inflected form for: cosponsor V;PRS;NOM(3,SG)	cosponsors	cosponsors
Generate the inflected form for: cosponsor V;PST	cosponsored	cosponsored
Generate the inflected form for: counterindoctrinate V;NFIN	counterindoctrinate	counterindoctrinate
Generate the inflected form for: counterindoctrinate V;V.PTCP;PST	counterindoctrinated	counterindoctrinated
Generate the inflected form for: crescendo V;NFIN	crescendo	crescendo
Generate the inflected form for: crescendo V;PST	crescendoed	crescendoed
Generate the inflected form for: crescendo V;V.PTCP;PRS	crescendoing	crescendoing
Generate the inflected form for: crescendo V;V.PTCP;PST	crescendoed	crescendoed
Generate the inflected form for: croggle V;PRS;NOM(3,SG)	croggles	croggles
Generate the inflected form for: croggle V;PST	croggled	croggled
Generate the inflected form for: croggle V;V.PTCP;PRS	croggling	croggling
Generate the inflected form for: declamate V;PRS;NOM(3,SG)	declamates	declamates
Generate the inflected form for: declamate V;V.PTCP;PRS	declamating	declamating
Generate the inflected form for: declamate V;V.PTCP;PST	declamated	declamated
Generate the inflected form for: decompartmentalize V;NFIN	decompartmentalize	decompartmentalize
Generate the inflected form for: decompartmentalize V;PST	decompartmentalized	decompartmentalized
Generate the inflected form for: decompartmentalize V;V.PTCP;PRS	decompartmentalizing	decompartmentalizing
Generate the inflected form for: decompartmentalize V;V.PTCP;PST	decompartmentalized	decompartmentalized
Generate the inflected form for: deconcentrate V;NFIN	deconcentrate	deconcentrate
Generate the inflected form for: deconcentrate V;PST	deconcentrated	deconcentrated
Generate the inflected form for: deconcentrate V;V.PTCP;PST	deconcentrated	deconcentrated
Generate the inflected form for: defunctionalize V;NFIN	defunctionalize	defunctionalize
Generate the inflected form for: defunctionalize V;PRS;NOM(3,SG)	defunctionalizes	defunctionalizes
Generate the inflected form for: defunctionalize V;PST	defunctionalized	defunctionalized
Generate the inflected form for: defunctionalize V;V.PTCP;PST	defunctionalized	defunctionalized
Generate the inflected form for: degroup V;NFIN	degroup	degroup
Generate the inflected form for: degroup V;PRS;NOM(3,SG)	degroups	degroups
Generate the inflected form for: degroup V;PST	degrouped	degrouped
Generate the inflected form for: degroup V;V.PTCP;PRS	degrouping	degrouping
Generate the inflected form for: deke V;PRS;NOM(3,SG)	dekes	dekes
Generate the inflected form for: deke V;PST	deked	deked
Generate the inflected form for: deke V;V.PTCP;PST	deked	deked
Generate the inflected form for: deliberate V;NFIN	deliberate	deliberate
Generate the inflected form for: deliberate V;PST	deliberated	deliberated
Generate the inflected form for: deliberate V;V.PTCP;PRS	deliberating	deliberating
Generate the inflected form for: deliberate V;V.PTCP;PST	deliberated	deliberated
Generate the inflected form for: delve V;PST	delved	delved
Generate the inflected form for: delve V;V.PTCP;PRS	delving	delving
Generate the inflected form for: delve V;V.PTCP;PST	delved	dolven
Generate the inflected form for: demorify V;NFIN	demorify	demorify
Generate the inflected form for: demorify V;PRS;NOM(3,SG)	demorifies	demorifies
Generate the inflected form for: demorify V;PST	demorified	demorified
Generate the inflected form for: demorify V;V.PTCP;PST	demorified	demorified
Generate the inflected form for: denuclearize V;NFIN	denuclearize	denuclearize
Generate the inflected form for: denuclearize V;PRS;NOM(3,SG)	denuclearizes	denuclearizes
Generate the inflected form for: denuclearize V;PST	denuclearized	denuclearized
Generate the inflected form for: denuclearize V;V.PTCP;PST	denuclearized	denuclearized
Generate the inflected form for: deraign V;NFIN	deraign	deraign
Generate the inflected form for: deraign V;PRS;NOM(3,SG)	deraigns	deraigns
Generate the inflected form for: deraign V;PST	deraigned	deraigned
Generate the inflected form for: deraign V;V.PTCP;PRS	deraigning	deraigning
Generate the inflected form for: destruct V;PRS;NOM(3,SG)	destructs	destructs
Generate the inflected form for: destruct V;PST	destructed	destructed
Generate the inflected form for: destruct V;V.PTCP;PRS	destructing	destructing
Generate the inflected form for: detumesce V;NFIN	detumesce	detumesce
Generate the inflected form for: detumesce V;PRS;NOM(3,SG)	detumesces	detumesces
Generate the inflected form for: detumesce V;PST	detumesced	detumesced
Generate the inflected form for: detumesce V;V.PTCP;PST	detumesced	detumesced
Generate the inflected form for: deurbanize V;NFIN	deurbanize	deurbanize
Generate the inflected form for: deurbanize V;PRS;NOM(3,SG)	deurbanizes	deurbanizes
Generate the inflected form for: deurbanize V;PST	deurbanized	deurbanized
Generate the inflected form for: deurbanize V;V.PTCP;PRS	deurbanizing	deurbanizing
Generate the inflected form for: devenustate V;NFIN	devenustate	devenustate
Generate the inflected form for: devenustate V;PRS;NOM(3,SG)	devenustates	devenustates
Generate the inflected form for: devenustate V;PST	devenustated	devenustated
Generate the inflected form for: devenustate V;V.PTCP;PRS	devenustating	devenustating
Generate the inflected form for: dewret V;PRS;NOM(3,SG)	dewrets	dewrets
Generate the inflected form for: dewret V;V.PTCP;PRS	dewretting	dewretting
Generate the inflected form for: dewret V;V.PTCP;PST	dewretted	dewretted
Generate the inflected form for: digiscope V;PST	digiscoped	digiscoped
Generate the inflected form for: digiscope V;V.PTCP;PRS	digiscoping	digiscoping
Generate the inflected form for: digiscope V;V.PTCP;PST	digiscoped	digiscoped
Generate the inflected form for: dishonnour V;NFIN	dishonnour	dishonnour
Generate the inflected form for: dishonnour V;PRS;NOM(3,SG)	dishonnours	dishonnours
Generate the inflected form for: dishonnour V;V.PTCP;PRS	dishonnouring	dishonnouring
Generate the inflected form for: dishonnour V;V.PTCP;PST	dishonnoured	dishonnoured
Generate the inflected form for: dissettle V;PRS;NOM(3,SG)	dissettles	dissettles
Generate the inflected form for: dissettle V;V.PTCP;PRS	dissettling	dissettling
Generate the inflected form for: dissettle V;V.PTCP;PST	dissettled	dissettled
Generate the inflected form for: dissonate V;NFIN	dissonate	dissonate
Generate the inflected form for: dissonate V;V.PTCP;PRS	dissonating	dissonating
Generate the inflected form for: dissonate V;V.PTCP;PST	dissonated	dissonated
Generate the inflected form for: disuse V;NFIN	disuse	disuse
Generate the inflected form for: disuse V;PRS;NOM(3,SG)	disuses	disuses
Generate the inflected form for: disuse V;V.PTCP;PST	disused	disused
Generate the inflected form for: dodd V;PRS;NOM(3,SG)	dodds	dodds
Generate the inflected form for: dodd V;PST	dodded	dodded
Generate the inflected form for: dodd V;V.PTCP;PRS	dodding	dodding
Generate the inflected form for: dodd V;V.PTCP;PST	dodded	dodded
Generate the inflected form for: douche V;NFIN	douche	douche
Generate the inflected form for: douche V;PRS;NOM(3,SG)	douches	douches
Generate the inflected form for: douche V;PST	douched	douched
Generate the inflected form for: douche V;V.PTCP;PRS	douching	douching
Generate the inflected form for: downclock V;PRS;NOM(3,SG)	downclocks	downclocks
Generate the inflected form for: downclock V;PST	downclocked	downclocked
Generate the inflected form for: downclock V;V.PTCP;PRS	downclocking	downclocking
Generate the inflected form for: dram V;NFIN	dram	dram
Generate the inflected form for: dram V;PRS;NOM(3,SG)	drams	drams
Generate the inflected form for: dram V;PST	drammed	drammed
Generate the inflected form for: dram V;V.PTCP;PRS	dramming	dramming
Generate the inflected form for: duress V;NFIN	duress	duress
Generate the inflected form for: duress V;PRS;NOM(3,SG)	duresses	duresses
Generate the inflected form for: earnest V;PRS;NOM(3,SG)	earnests	earnests
Generate the inflected form for: earnest V;V.PTCP;PST	earnested	earnested
Generate the inflected form for: empassion V;NFIN	empassion	empassion
Generate the inflected form for: empassion V;PRS;NOM(3,SG)	empassions	empassions
Generate the inflected form for: encoach V;PRS;NOM(3,SG)	encoaches	encoaches
Generate the inflected form for: encoach V;PST	encoached	encoached
Generate the inflected form for: encoach V;V.PTCP;PRS	encoaching	encoaching
Generate the inflected form for: enlace V;NFIN	enlace	enlace
Generate the inflected form for: enlace V;PRS;NOM(3,SG)	enlaces	enlaces
Generate the inflected form for: enlace V;V.PTCP;PRS	enlacing	enlacing
Generate the inflected form for: enlace V;V.PTCP;PST	enlaced	enlaced
Generate the inflected form for: enrank V;NFIN	enrank	enrank
Generate the inflected form for: enring V;PRS;NOM(3,SG)	enrings	enrings
Generate the inflected form for: enring V;PST	enringed	enringed
Generate the inflected form for: enring V;V.PTCP;PRS	enringing	enringing
Generate the inflected form for: ensky V;NFIN	ensky	ensky
Generate the inflected form for: ensky V;PRS;NOM(3,SG)	enskies	enskies
Generate the inflected form for: ensky V;PST	enskied	enskied
Generate the inflected form for: ensky V;V.PTCP;PST	enskied	enskied
Generate the inflected form for: enwisen V;NFIN	enwisen	enwisen
Generate the inflected form for: enwisen V;PRS;NOM(3,SG)	enwisens	enwisens
Generate the inflected form for: enwisen V;V.PTCP;PRS	enwisening	enwisening
Generate the inflected form for: exceed V;NFIN	exceed	exceed
Generate the inflected form for: exceed V;PRS;NOM(3,SG)	exceeds	exceeds
Generate the inflected form for: exceed V;V.PTCP;PRS	exceeding	exceeding
Generate the inflected form for: fainten V;PRS;NOM(3,SG)	faintens	faintens
Generate the inflected form for: fainten V;PST	faintened	faintened
Generate the inflected form for: fainten V;V.PTCP;PRS	faintening	faintening
Generate the inflected form for: fainten V;V.PTCP;PST	faintened	faintened
Generate the inflected form for: fanaticize V;PRS;NOM(3,SG)	fanaticizes	fanaticizes
Generate the inflected form for: fanaticize V;V.PTCP;PRS	fanaticizing	fanaticizing
Generate the inflected form for: feel V;NFIN	feel	feel
Generate the inflected form for: feel V;PRS;NOM(3,SG)	feels	feels
Generate the inflected form for: feel V;V.PTCP;PRS	feeling	feeling
Generate the inflected form for: flail V;PST	flailed	flailed
Generate the inflected form for: fluff V;NFIN	fluff	fluff
Generate the inflected form for: fluff V;V.PTCP;PRS	fluffing	fluffing
Generate the inflected form for: flutter V;NFIN	flutter	flutter
Generate the inflected form for: flutter V;PRS;NOM(3,SG)	flutters	flutters
Generate the inflected form for: flutter V;PST	fluttered	fluttered
Generate the inflected form for: flutter V;V.PTCP;PST	fluttered	fluttered
Generate the inflected form for: forestal V;NFIN	forestal	forestal
Generate the inflected form for: forestal V;PRS;NOM(3,SG)	forestals	forestals
Generate the inflected form for: forestal V;PST	forestalled	forestalled
Generate the inflected form for: formicate V;NFIN	formicate	formicate
Generate the inflected form for: formicate V;V.PTCP;PRS	formicating	formicating
Generate the inflected form for: formicate V;V.PTCP;PST	formicated	formicated
Generate the inflected form for: forthcast V;NFIN	forthcast	forthcast
Generate the inflected form for: forthcast V;PRS;NOM(3,SG)	forthcasts	forthcasts
Generate the inflected form for: forthcast V;V.PTCP;PRS	forthcasting	forthcasting
Generate the inflected form for: forthcast V;V.PTCP;PST	forthcast	forthcast
Generate the inflected form for: forwrap V;PRS;NOM(3,SG)	forwraps	forwraps
Generate the inflected form for: forwrap V;V.PTCP;PRS	forwrapping	forwrapping
Generate the inflected form for: forwrap V;V.PTCP;PST	forwrapped	forwrapped
Generate the inflected form for: fraternise V;PST	fraternised	fraternised
Generate the inflected form for: fraternise V;V.PTCP;PRS	fraternising	fraternising
Generate the inflected form for: fraternise V;V.PTCP;PST	fraternised	fraternised
Generate the inflected form for: frustrate V;PST	frustrated	frustrated
Generate the inflected form for: frustrate V;V.PTCP;PRS	frustrating	frustrating
Generate the inflected form for: fustigate V;PST	fustigated	fustigated
Generate the inflected form for: fustigate V;V.PTCP;PRS	fustigating	fustigating
Generate the inflected form for: fustigate V;V.PTCP;PST	fustigated	fustigated
Generate the inflected form for: geck V;NFIN	geck	geck
Generate the inflected form for: geck V;PRS;NOM(3,SG)	gecks	gecks
Generate the inflected form for: geck V;V.PTCP;PRS	gecking	gecking
Generate the inflected form for: geck V;V.PTCP;PST	gecked	gecked
Generate the inflected form for: germinate V;NFIN	germinate	germinate
Generate the inflected form for: germinate V;PRS;NOM(3,SG)	germinates	germinates
Generate the inflected form for: germinate V;V.PTCP;PST	germinated	germinated
Generate the inflected form for: glycolyze V;PRS;NOM(3,SG)	glycolyzes	glycolyzes
Generate the inflected form for: glycolyze V;V.PTCP;PST	glycolyzed	glycolyzed
Generate the inflected form for: graffiti V;PRS;NOM(3,SG)	graffities	graffitis
Generate the inflected form for: graffiti V;PST	graffitied	graffitied
Generate the inflected form for: graffiti V;V.PTCP;PRS	graffiting	graffitiing
Generate the inflected form for: graffiti V;V.PTCP;PST	graffitied	graffitied
Generate the inflected form for: grammaticize V;PRS;NOM(3,SG)	grammaticizes	grammaticizes
Generate the inflected form for: grammaticize V;PST	grammaticized	grammaticized
Generate the inflected form for: grammaticize V;V.PTCP;PRS	grammaticizing	grammaticizing
Generate the inflected form for: grammaticize V;V.PTCP;PST	grammaticized	grammaticized
Generate the inflected form for: grid V;NFIN	grid	grid
Generate the inflected form for: grid V;PRS;NOM(3,SG)	grids	grids
Generate the inflected form for: grid V;PST	gridded	gridded
Generate the inflected form for: grid V;V.PTCP;PST	gridded	gridded
Generate the inflected form for: grill V;NFIN	grill	grill
Generate the inflected form for: grill V;PRS;NOM(3,SG)	grills	grills
Generate the inflected form for: grill V;PST	grilled	grilled
Generate the inflected form for: grill V;V.PTCP;PRS	grilling	grilling
Generate the inflected form for: gub V;PRS;NOM(3,SG)	gubs	gubs
Generate the inflected form for: gub V;PST	gubbed	gubbed
Generate the inflected form for: gub V;V.PTCP;PRS	gubbing	gubbing
Generate the inflected form for: gub V;V.PTCP;PST	gubbed	gubbed
Generate the inflected form for: hand V;PRS;NOM(3,SG)	hands	hands
Generate the inflected form for: hand V;V.PTCP;PRS	handing	handing
Generate the inflected form for: hand V;V.PTCP;PST	handed	handed
Generate the inflected form for: happify V;PRS;NOM(3,SG)	happifies	happifies
Generate the inflected form for: happify V;PST	happified	happified
Generate the inflected form for: happify V;V.PTCP;PST	happified	happified
Generate the inflected form for: harpoon V;NFIN	harpoon	harpoon
Generate the inflected form for: harpoon V;PRS;NOM(3,SG)	harpoons	harpoons
Generate the inflected form for: harpoon V;V.PTCP;PST	harpooned	harpooned
Generate the inflected form for: heli-ski V;NFIN	heli-ski	heli-ski
Generate the inflected form for: heli-ski V;PST	heli-skied	heli-skied
Generate the inflected form for: heli-ski V;V.PTCP;PRS	heli-skiing	heli-skiing
Generate the inflected form for: heli-ski V;V.PTCP;PST	heli-skied	heli-skied
Generate the inflected form for: hickup V;PRS;NOM(3,SG)	hickups	hickups
Generate the inflected form for: hickup V;PST	hickupped	hickupped
Generate the inflected form for: hickup V;V.PTCP;PST	hickupped	hickupped
Generate the inflected form for: high-step V;NFIN	high-step	high-step
Generate the inflected form for: high-step V;PRS;NOM(3,SG)	high-steps	high-steps
Generate the inflected form for: high-step V;PST	high-stepped	high-stepped
Generate the inflected form for: high-step V;V.PTCP;PST	high-stepped	high-stepped
Generate the inflected form for: hiss V;NFIN	hiss	hiss
Generate the inflected form for: hiss V;PST	hissed	hissed
Generate the inflected form for: hiss V;V.PTCP;PRS	hissing	hissing
Generate the inflected form for: hiss V;V.PTCP;PST	hissed	hissed
Generate the inflected form for: hydrolyze V;NFIN	hydrolyze	hydrolyze
Generate the inflected form for: hydrolyze V;PRS;NOM(3,SG)	hydrolyzes	hydrolyzes
Generate the inflected form for: hydrolyze V;V.PTCP;PRS	hydrolyzing	hydrolyzing
Generate the inflected form for: hydrolyze V;V.PTCP;PST	hydrolyzed	hydrolyzed
Generate the inflected form for: illure V;V.PTCP;PRS	illuring	illuring
Generate the inflected form for: imboil V;NFIN	imboil	imboil
Generate the inflected form for: imboil V;PRS;NOM(3,SG)	imboils	imboils
Generate the inflected form for: imboil V;PST	imboiled	imboiled
Generate the inflected form for: imboil V;V.PTCP;PST	imboiled	imboiled
Generate the inflected form for: imbower V;NFIN	imbower	imbower
Generate the inflected form for: imbower V;PRS;NOM(3,SG)	imbowers	imbowers
Generate the inflected form for: imbower V;V.PTCP;PRS	imbowering	imbowering
Generate the inflected form for: imparl V;PST	imparled	imparled
Generate the inflected form for: imparl V;V.PTCP;PRS	imparling	imparling
Generate the inflected form for: imperialize V;NFIN	imperialize	imperialize
Generate the inflected form for: imperialize V;PRS;NOM(3,SG)	imperializes	imperializes
Generate the inflected form for: imperialize V;V.PTCP;PRS	imperializing	imperializing
Generate the inflected form for: indorse V;NFIN	indorse	indorse
Generate the inflected form for: indorse V;PRS;NOM(3,SG)	indorses	indorses
Generate the inflected form for: indorse V;PST	indorsed	indorsed
Generate the inflected form for: infeeble V;PRS;NOM(3,SG)	infeebles	infeebles
Generate the inflected form for: infeeble V;V.PTCP;PRS	infeebling	infeebling
Generate the inflected form for: infumate V;NFIN	infumate	infumate
Generate the inflected form for: infumate V;PRS;NOM(3,SG)	infumates	infumates
Generate the inflected form for: infumate V;PST	infumated	infumated
Generate the inflected form for: infumate V;V.PTCP;PRS	infumating	infumating
Generate the inflected form for: inhere V;NFIN	inhere	inhere
Generate the inflected form for: inhere V;PRS;NOM(3,SG)	inheres	inheres
Generate the inflected form for: inhere V;V.PTCP;PST	inhered	inhered
Generate the inflected form for: instrengthen V;NFIN	instrengthen	instrengthen
Generate the inflected form for: instrengthen V;PRS;NOM(3,SG)	instrengthens	instrengthens
Generate the inflected form for: instrengthen V;PST	instrengthened	instrengthened
Generate the inflected form for: instrengthen V;V.PTCP;PRS	instrengthening	instrengthening
Generate the inflected form for: intergrade V;PRS;NOM(3,SG)	intergrades	intergrades
Generate the inflected form for: intergrade V;PST	intergraded	intergraded
Generate the inflected form for: intergrade V;V.PTCP;PRS	intergrading	intergrading
Generate the inflected form for: internetwork V;PRS;NOM(3,SG)	internetworks	internetworks
Generate the inflected form for: internetwork V;V.PTCP;PRS	internetworking	internetworking
Generate the inflected form for: internetwork V;V.PTCP;PST	internetworked	internetworked
Generate the inflected form for: interplay V;NFIN	interplay	interplay
Generate the inflected form for: interplay V;PRS;NOM(3,SG)	interplays	interplays
Generate the inflected form for: interplay V;V.PTCP;PRS	interplaying	interplaying
Generate the inflected form for: interplay V;V.PTCP;PST	interplayed	interplayed
Generate the inflected form for: interpoint V;NFIN	interpoint	interpoint
Generate the inflected form for: interpoint V;V.PTCP;PRS	interpointing	interpointing
Generate the inflected form for: interpoint V;V.PTCP;PST	interpointed	interpointed
Generate the inflected form for: jetski V;NFIN	jetski	jetski
Generate the inflected form for: jetski V;V.PTCP;PRS	jetskiing	jetskiing
Generate the inflected form for: jetski V;V.PTCP;PST	jetskied	jetskied
Generate the inflected form for: jockey V;PRS;NOM(3,SG)	jockeys	jockeys
Generate the inflected form for: jockey V;V.PTCP;PRS	jockeying	jockeying
Generate the inflected form for: jockey V;V.PTCP;PST	jockeyed	jockeyed
Generate the inflected form for: joke V;NFIN	joke	joke
Generate the inflected form for: joke V;PRS;NOM(3,SG)	jokes	jokes
Generate the inflected form for: joke V;PST	joked	joked
Generate the inflected form for: juice V;NFIN	juice	juice
Generate the inflected form for: juice V;PRS;NOM(3,SG)	juices	juices
Generate the inflected form for: juice V;V.PTCP;PST	juiced	juiced
Generate the inflected form for: knuckleball V;NFIN	knuckleball	knuckleball
Generate the inflected form for: knuckleball V;PRS;NOM(3,SG)	knuckleballs	knuckleballs
Generate the inflected form for: knuckleball V;PST	knuckleballed	knuckleballed
Generate the inflected form for: knuckleball V;V.PTCP;PST	knuckleballed	knuckleballed
Generate the inflected form for: laud V;V.PTCP;PRS	lauding	lauding
Generate the inflected form for: laud V;V.PTCP;PST	lauded	lauded
Generate the inflected form for: lave V;NFIN	lave	lave
Generate the inflected form for: lave V;PRS;NOM(3,SG)	laves	laves
Generate the inflected form for: lave V;PST	laved	laved
Generate the inflected form for: lave V;V.PTCP;PRS	laving	laving
Generate the inflected form for: lear V;NFIN	lear	lear
Generate the inflected form for: lear V;V.PTCP;PRS	learing	learing
Generate the inflected form for: legislate V;NFIN	legislate	legislate
Generate the inflected form for: legislate V;PST	legislated	legislated
Generate the inflected form for: legislate V;V.PTCP;PRS	legislating	legislating
Generate the inflected form for: legislate V;V.PTCP;PST	legislated	legislated
Generate the inflected form for: livetweet V;NFIN	livetweet	livetweet
Generate the inflected form for: livetweet V;PRS;NOM(3,SG)	livetweets	livetweets
Generate the inflected form for: livetweet V;PST	livetweeted	livetweeted
Generate the inflected form for: livetweet V;V.PTCP;PST	livetweeted	livetweeted
Generate the inflected form for: loun V;PRS;NOM(3,SG)	louns	louns
Generate the inflected form for: loun V;PST	louned	louned
Generate the inflected form for: loun V;V.PTCP;PRS	louning	louning
Generate the inflected form for: loun V;V.PTCP;PST	louned	louned
Generate the inflected form for: lush V;NFIN	lush	lush
Generate the inflected form for: lush V;PRS;NOM(3,SG)	lushes	lushes
Generate the inflected form for: lush V;V.PTCP;PRS	lushing	lushing
Generate the inflected form for: machicolate V;PRS;NOM(3,SG)	machicolates	machicolates
Generate the inflected form for: machicolate V;PST	machicolated	machicolated
Generate the inflected form for: machicolate V;V.PTCP;PRS	machicolating	machicolating
Generate the inflected form for: machicolate V;V.PTCP;PST	machicolated	machicolated
Generate the inflected form for: mactate V;PRS;NOM(3,SG)	mactates	mactates
Generate the inflected form for: mactate V;PST	mactated	mactated
Generate the inflected form for: mactate V;V.PTCP;PRS	mactating	mactating
Generate the inflected form for: mactate V;V.PTCP;PST	mactated	mactated
Generate the inflected form for: mand V;NFIN	mand	mand
Generate the inflected form for: mand V;PST	manded	manded
Generate the inflected form for: mand V;V.PTCP;PRS	manding	manding
Generate the inflected form for: mand V;V.PTCP;PST	manded	manded
Generate the inflected form for: maternalize V;NFIN	maternalize	maternalize
Generate the inflected form for: maternalize V;PRS;NOM(3,SG)	maternalizes	maternalizes
Generate the inflected form for: maternalize V;V.PTCP;PRS	maternalizing	maternalizing
Generate the inflected form for: maternalize V;V.PTCP;PST	maternalized	maternalized
Generate the inflected form for: meach V;PRS;NOM(3,SG)	meaches	meaches
Generate the inflected form for: meach V;PST	meached	meached
Generate the inflected form for: meach V;V.PTCP;PRS	meaching	meaching
Generate the inflected form for: meach V;V.PTCP;PST	meached	meached
Generate the inflected form for: mirk V;NFIN	mirk	mirk
Generate the inflected form for: mirk V;PRS;NOM(3,SG)	mirks	mirks
Generate the inflected form for: mirk V;PST	mirked	mirked
Generate the inflected form for: mirk V;V.PTCP;PRS	mirking	mirking
Generate the inflected form for: misken V;NFIN	misken	misken
Generate the inflected form for: misken V;PST	miskened	miskent
Generate the inflected form for: misken V;V.PTCP;PRS	miskening	miskenning
Generate the inflected form for: misstructure V;NFIN	misstructure	misstructure
Generate the inflected form for: misstructure V;PRS;NOM(3,SG)	misstructures	misstructures
Generate the inflected form for: misstructure V;V.PTCP;PST	misstructured	misstructured
Generate the inflected form for: misvalue V;NFIN	misvalue	misvalue
Generate the inflected form for: misvalue V;PST	misvalued	misvalued
Generate the inflected form for: misvalue V;V.PTCP;PRS	misvaluing	misvaluing
Generate the inflected form for: misvalue V;V.PTCP;PST	misvalued	misvalued
Generate the inflected form for: mold V;PST	molded	molded
Generate the inflected form for: mongrelize V;NFIN	mongrelize	mongrelize
Generate the inflected form for: mongrelize V;PRS;NOM(3,SG)	mongrelizes	mongrelizes
Generate the inflected form for: mongrelize V;PST	mongrelized	mongrelized
Generate the inflected form for: mongrelize V;V.PTCP;PRS	mongrelizing	mongrelizing
Generate the inflected form for: mounch V;NFIN	mounch	mounch
Generate the inflected form for: mounch V;V.PTCP;PST	mounched	mounched
Generate the inflected form for: nasalise V;NFIN	nasalise	nasalise
Generate the inflected form for: nasalise V;PRS;NOM(3,SG)	nasalises	nasalises
Generate the inflected form for: nasalise V;PST	nasalised	nasalised
Generate the inflected form for: nasalise V;V.PTCP;PST	nasalised	nasalised
Generate the inflected form for: newname V;NFIN	newname	newname
Generate the inflected form for: newname V;PRS;NOM(3,SG)	newnames	newnames
Generate the inflected form for: newname V;PST	newnamed	newnamed
Generate the inflected form for: newname V;V.PTCP;PST	newnamed	newnamed
Generate the inflected form for: obdure V;NFIN	obdure	obdure
Generate the inflected form for: obdure V;PST	obdured	obdured
Generate the inflected form for: obdure V;V.PTCP;PRS	obduring	obduring
Generate the inflected form for: obdure V;V.PTCP;PST	obdured	obdured
Generate the inflected form for: obsolete V;NFIN	obsolete	obsolete
Generate the inflected form for: obsolete V;PRS;NOM(3,SG)	obsoletes	obsoletes
Generate the inflected form for: obsolete V;PST	obsoleted	obsoleted
Generate the inflected form for: obsolete V;V.PTCP;PRS	obsoleting	obsoleting
Generate the inflected form for: outbud V;NFIN	outbud	outbud
Generate the inflected form for: outbud V;PRS;NOM(3,SG)	outbuds	outbuds
Generate the inflected form for: outbud V;V.PTCP;PRS	outbudding	outbudding
Generate the inflected form for: outbud V;V.PTCP;PST	outbudded	outbudded
Generate the inflected form for: outduel V;NFIN	outduel	outduel
Generate the inflected form for: outduel V;PRS;NOM(3,SG)	outduels	outduels
Generate the inflected form for: outduel V;V.PTCP;PST	outduelled	outduelled
Generate the inflected form for: outgush V;PRS;NOM(3,SG)	outgushes	outgushes
Generate the inflected form for: outgush V;PST	outgushed	outgushed
Generate the inflected form for: outgush V;V.PTCP;PRS	outgushing	outgushing
Generate the inflected form for: outgush V;V.PTCP;PST	outgushed	outgushed
Generate the inflected form for: outjuggle V;NFIN	outjuggle	outjuggle
Generate the inflected form for: outjuggle V;PRS;NOM(3,SG)	outjuggles	outjuggles
Generate the inflected form for: outjuggle V;PST	outjuggled	outjuggled
Generate the inflected form for: outjuggle V;V.PTCP;PRS	outjuggling	outjuggling
Generate the inflected form for: outplace V;NFIN	outplace	outplace
Generate the inflected form for: outplace V;PRS;NOM(3,SG)	outplaces	outplaces
Generate the inflected form for: outplace V;PST	outplaced	outplaced
Generate the inflected form for: outplace V;V.PTCP;PRS	outplacing	outplacing
Generate the inflected form for: outwin V;NFIN	outwin	outwin
Generate the inflected form for: outwin V;PRS;NOM(3,SG)	outwins	outwins
Generate the inflected form for: outwin V;V.PTCP;PST	outwinned	outwon
Generate the inflected form for: overdot V;NFIN	overdot	overdot
Generate the inflected form for: overdot V;PST	overdotted	overdotted
Generate the inflected form for: overdot V;V.PTCP;PRS	overdotting	overdotting
Generate the inflected form for: overdot V;V.PTCP;PST	overdotted	overdotted
Generate the inflected form for: overexpose V;NFIN	overexpose	overexpose
Generate the inflected form for: overexpose V;PST	overexposed	overexposed
Generate the inflected form for: overexpose V;V.PTCP;PST	overexposed	overexposed
Generate the inflected form for: overgloom V;NFIN	overgloom	overgloom
Generate the inflected form for: overgloom V;PRS;NOM(3,SG)	overglooms	overglooms
Generate the inflected form for: overgloom V;PST	overgloomed	overgloomed
Generate the inflected form for: overgloom V;V.PTCP;PST	overgloomed	overgloomed
Generate the inflected form for: overgrow V;PRS;NOM(3,SG)	overgrows	overgrows
Generate the inflected form for: overgrow V;V.PTCP;PRS	overgrowing	overgrowing
Generate the inflected form for: overplow V;NFIN	overplow	overplow
Generate the inflected form for: overplow V;PST	overplowed	overplowed
Generate the inflected form for: overplow V;V.PTCP;PRS	overplowing	overplowing
Generate the inflected form for: overplow V;V.PTCP;PST	overplowed	overplowed
Generate the inflected form for: overpublicize V;NFIN	overpublicize	overpublicize
Generate the inflected form for: overpublicize V;V.PTCP;PRS	overpublicizing	overpublicizing
Generate the inflected form for: overpublicize V;V.PTCP;PST	overpublicized	overpublicized
Generate the inflected form for: overreckon V;NFIN	overreckon	overreckon
Generate the inflected form for: overreckon V;PRS;NOM(3,SG)	overreckons	overreckons
Generate the inflected form for: overreckon V;PST	overreckoned	overreckoned
Generate the inflected form for: overreckon V;V.PTCP;PRS	overreckoning	overreckoning
Generate the inflected form for: overtask V;NFIN	overtask	overtask
Generate the inflected form for: overtask V;PRS;NOM(3,SG)	overtasks	overtasks
Generate the inflected form for: overtask V;V.PTCP;PRS	overtasking	overtasking
Generate the inflected form for: overtask V;V.PTCP;PST	overtasked	overtasked
Generate the inflected form for: overwater V;NFIN	overwater	overwater
Generate the inflected form for: overwater V;PST	overwatered	overwatered
Generate the inflected form for: palatalize V;NFIN	palatalize	palatalize
Generate the inflected form for: palatalize V;PST	palatalized	palatalized
Generate the inflected form for: palatalize V;V.PTCP;PRS	palatalizing	palatalizing
Generate the inflected form for: palatalize V;V.PTCP;PST	palatalized	palatalized
Generate the inflected form for: paralyze V;NFIN	paralyze	paralyze
Generate the inflected form for: paralyze V;PRS;NOM(3,SG)	paralyzes	paralyzes
Generate the inflected form for: paralyze V;V.PTCP;PRS	paralyzing	paralyzing
Generate the inflected form for: parboil V;NFIN	parboil	parboil
Generate the inflected form for: parboil V;PRS;NOM(3,SG)	parboils	parboils
Generate the inflected form for: parboil V;V.PTCP;PRS	parboiling	parboiling
Generate the inflected form for: parboil V;V.PTCP;PST	parboiled	parboiled
Generate the inflected form for: pauperise V;PRS;NOM(3,SG)	pauperises	pauperises
Generate the inflected form for: pauperise V;PST	pauperised	pauperised
Generate the inflected form for: pauperise V;V.PTCP;PRS	pauperising	pauperising
Generate the inflected form for: pauperise V;V.PTCP;PST	pauperised	pauperised
Generate the inflected form for: perhorresce V;PRS;NOM(3,SG)	perhorresces	perhorresces
Generate the inflected form for: perhorresce V;PST	perhorresced	perhorresced
Generate the inflected form for: perhorresce V;V.PTCP;PRS	perhorrescing	perhorrescing
Generate the inflected form for: perhorresce V;V.PTCP;PST	perhorresced	perhorresced
Generate the inflected form for: phosphorylate V;NFIN	phosphorylate	phosphorylate
Generate the inflected form for: phosphorylate V;V.PTCP;PST	phosphorylated	phosphorylated
Generate the inflected form for: piggyback V;PRS;NOM(3,SG)	piggybacks	piggybacks
Generate the inflected form for: piggyback V;PST	piggybacked	piggybacked
Generate the inflected form for: piggyback V;V.PTCP;PRS	piggybacking	piggybacking
Generate the inflected form for: piggyback V;V.PTCP;PST	piggybacked	piggybacked
Generate the inflected form for: politize V;NFIN	politize	politize
Generate the inflected form for: politize V;PST	politized	politized
Generate the inflected form for: politize V;V.PTCP;PST	politized	politized
Generate the inflected form for: polycondense V;NFIN	polycondense	polycondense
Generate the inflected form for: polycondense V;PRS;NOM(3,SG)	polycondenses	polycondenses
Generate the inflected form for: polycondense V;PST	polycondensed	polycondensed
Generate the inflected form for: polycondense V;V.PTCP;PST	polycondensed	polycondensed
Generate the inflected form for: polytenize V;NFIN	polytenize	polytenize
Generate the inflected form for: polytenize V;PRS;NOM(3,SG)	polytenizes	polytenizes
Generate the inflected form for: polytenize V;V.PTCP;PST	polytenized	polytenized
Generate the inflected form for: pork V;PST	porked	porked
Generate the inflected form for: pork V;V.PTCP;PRS	porking	porking
Generate the inflected form for: pork V;V.PTCP;PST	porked	porked
Generate the inflected form for: pouch V;NFIN	pouch	pouch
Generate the inflected form for: pouch V;PST	pouched	pouched
Generate the inflected form for: pouch V;V.PTCP;PRS	pouching	pouching
Generate the inflected form for: pouch V;V.PTCP;PST	pouched	pouched
Generate the inflected form for: practicalize V;NFIN	practicalize	practicalize
Generate the inflected form for: practicalize V;PRS;NOM(3,SG)	practicalizes	practicalizes
Generate the inflected form for: practicalize V;PST	practicalized	practicalized
Generate the inflected form for: practicalize V;V.PTCP;PRS	practicalizing	practicalizing
Generate the inflected form for: praise V;NFIN	praise	praise
Generate the inflected form for: praise V;V.PTCP;PST	praised	praised
Generate the inflected form for: predicate V;NFIN	predicate	predicate
Generate the inflected form for: predicate V;V.PTCP;PRS	predicating	predicating
Generate the inflected form for: preprogram V;NFIN	preprogram	preprogram
Generate the inflected form for: preprogram V;PRS;NOM(3,SG)	preprograms	preprograms
Generate the inflected form for: preprogram V;V.PTCP;PRS	preprogramming	preprogramming
Generate the inflected form for: preprogram V;V.PTCP;PST	preprogrammed	preprogrammed
Generate the inflected form for: preseed V;NFIN	preseed	preseed
Generate the inflected form for: preseed V;PRS;NOM(3,SG)	preseeds	preseeds
Generate the inflected form for: preseed V;PST	preseeded	preseeded
Generate the inflected form for: preseed V;V.PTCP;PST	preseeded	preseeded
Generate the inflected form for: preshow V;PST	preshowed	preshowed
Generate the inflected form for: preshow V;V.PTCP;PRS	preshowing	preshowing
Generate the inflected form for: preshow V;V.PTCP;PST	preshowed	preshown
Generate the inflected form for: pretest V;PRS;NOM(3,SG)	pretests	pretests
Generate the inflected form for: pretest V;PST	pretested	pretested
Generate the inflected form for: pretest V;V.PTCP;PRS	pretesting	pretesting
Generate the inflected form for: pretest V;V.PTCP;PST	pretested	pretested
Generate the inflected form for: proclaime V;NFIN	proclaime	proclaime
Generate the inflected form for: proclaime V;V.PTCP;PST	proclaimed	proclaimed
Generate the inflected form for: protocol V;PRS;NOM(3,SG)	protocols	protocols
Generate the inflected form for: protocol V;PST	protocolled	protocolled
Generate the inflected form for: protocol V;V.PTCP;PRS	protocolling	protocolling
Generate the inflected form for: provinciate V;NFIN	provinciate	provinciate
Generate the inflected form for: provinciate V;PST	provinciated	provinciated
Generate the inflected form for: provinciate V;V.PTCP;PRS	provinciating	provinciating
Generate the inflected form for: provinciate V;V.PTCP;PST	provinciated	provinciated
Generate the inflected form for: re-dye V;NFIN	re-dye	re-dye
Generate the inflected form for: re-dye V;PST	re-dyed	re-dyed
Generate the inflected form for: re-dye V;V.PTCP;PRS	re-dying	re-dying
Generate the inflected form for: re-dye V;V.PTCP;PST	re-dyed	re-dyed
Generate the inflected form for: re-use V;NFIN	re-use	re-use
Generate the inflected form for: re-use V;PRS;NOM(3,SG)	re-uses	re-uses
Generate the inflected form for: re-use V;PST	re-used	re-used
Generate the inflected form for: re-use V;V.PTCP;PRS	re-using	re-using
Generate the inflected form for: rearrest V;NFIN	rearrest	rearrest
Generate the inflected form for: rearrest V;V.PTCP;PRS	rearresting	rearresting
Generate the inflected form for: redemand V;NFIN	redemand	redemand
Generate the inflected form for: redemand V;V.PTCP;PRS	redemanding	redemanding
Generate the inflected form for: redemand V;V.PTCP;PST	redemanded	redemanded
Generate the inflected form for: redline V;PST	redlined	redlined
Generate the inflected form for: redline V;V.PTCP;PST	redlined	redlined
Generate the inflected form for: refamiliarize V;NFIN	refamiliarize	refamiliarize
Generate the inflected form for: refamiliarize V;PRS;NOM(3,SG)	refamiliarizes	refamiliarizes
Generate the inflected form for: refamiliarize V;PST	refamiliarized	refamiliarized
Generate the inflected form for: refamiliarize V;V.PTCP;PRS	refamiliarizing	refamiliarizing
Generate the inflected form for: refold V;PRS;NOM(3,SG)	refolds	refolds
Generate the inflected form for: refold V;PST	refolded	refolded
Generate the inflected form for: refold V;V.PTCP;PRS	refolding	refolding
Generate the inflected form for: refold V;V.PTCP;PST	refolded	refolded
Generate the inflected form for: regale V;NFIN	regale	regale
Generate the inflected form for: regale V;PRS;NOM(3,SG)	regales	regales
Generate the inflected form for: regale V;V.PTCP;PRS	regaling	regaling
Generate the inflected form for: regale V;V.PTCP;PST	regaled	regaled
Generate the inflected form for: regiment V;PST	regimented	regimented
Generate the inflected form for: regiment V;V.PTCP;PST	regimented	regimented
Generate the inflected form for: rehybridize V;NFIN	rehybridize	rehybridize
Generate the inflected form for: rehybridize V;PRS;NOM(3,SG)	rehybridizes	rehybridizes
Generate the inflected form for: rehybridize V;PST	rehybridized	rehybridized
Generate the inflected form for: rehybridize V;V.PTCP;PRS	rehybridizing	rehybridizing
Generate the inflected form for: reinsulate V;NFIN	reinsulate	reinsulate
Generate the inflected form for: reinsulate V;V.PTCP;PST	reinsulated	reinsulated
Generate the inflected form for: relodge V;NFIN	relodge	relodge
Generate the inflected form for: relodge V;PST	relodged	relodged
Generate the inflected form for: relodge V;V.PTCP;PRS	relodging	relodging
Generate the inflected form for: relodge V;V.PTCP;PST	relodged	relodged
Generate the inflected form for: remodel V;PRS;NOM(3,SG)	remodels	remodels
Generate the inflected form for: remodel V;PST	remodelled	remodelled
Generate the inflected form for: remodel V;V.PTCP;PRS	remodelling	remodelling
Generate the inflected form for: remodel V;V.PTCP;PST	remodelled	remodelled
Generate the inflected form for: renaturalize V;NFIN	renaturalize	renaturalize
Generate the inflected form for: renaturalize V;PRS;NOM(3,SG)	renaturalizes	renaturalizes
Generate the inflected form for: renaturalize V;V.PTCP;PRS	renaturalizing	renaturalizing
Generate the inflected form for: renaturalize V;V.PTCP;PST	renaturalized	renaturalized
Generate the inflected form for: reperuse V;NFIN	reperuse	reperuse
Generate the inflected form for: reperuse V;PRS;NOM(3,SG)	reperuses	reperuses
Generate the inflected form for: reperuse V;PST	reperused	reperused
Generate the inflected form for: reperuse V;V.PTCP;PST	reperused	reperused
Generate the inflected form for: repipe V;NFIN	repipe	repipe
Generate the inflected form for: repipe V;PRS;NOM(3,SG)	repipes	repipes
Generate the inflected form for: repipe V;V.PTCP;PST	repiped	repiped
Generate the inflected form for: repopularise V;NFIN	repopularise	repopularise
Generate the inflected form for: repopularise V;PST	repopularised	repopularised
Generate the inflected form for: repopularise V;V.PTCP;PRS	repopularising	repopularising
Generate the inflected form for: repopularise V;V.PTCP;PST	repopularised	repopularised
Generate the inflected form for: repot V;NFIN	repot	repot
Generate the inflected form for: repot V;PST	repotted	repotted
Generate the inflected form for: repot V;V.PTCP;PRS	repotting	repotting
Generate the inflected form for: repot V;V.PTCP;PST	repotted	repotted
Generate the inflected form for: reprice V;NFIN	reprice	reprice
Generate the inflected form for: reprice V;PRS;NOM(3,SG)	reprices	reprices
Generate the inflected form for: reprice V;V.PTCP;PRS	repricing	repricing
Generate the inflected form for: reprice V;V.PTCP;PST	repriced	repriced
Generate the inflected form for: reprogramme V;NFIN	reprogramme	reprogramme
Generate the inflected form for: reprogramme V;PRS;NOM(3,SG)	reprogrammes	reprogrammes
Generate the inflected form for: reprogramme V;V.PTCP;PRS	reprogramming	reprogramming
Generate the inflected form for: reprogramme V;V.PTCP;PST	reprogrammed	reprogrammed
Generate the inflected form for: resent V;PST	resented	resented
Generate the inflected form for: resent V;V.PTCP;PRS	resenting	resenting
Generate the inflected form for: resent V;V.PTCP;PST	resented	resented
Generate the inflected form for: revector V;NFIN	revector	revector
Generate the inflected form for: revector V;PRS;NOM(3,SG)	revectors	revectors
Generate the inflected form for: revector V;PST	revectored	revectored
Generate the inflected form for: revector V;V.PTCP;PST	revectored	revectored
Generate the inflected form for: rewetten V;NFIN	rewetten	rewetten
Generate the inflected form for: rewetten V;PST	rewettened	rewettened
Generate the inflected form for: rewetten V;V.PTCP;PRS	rewettening	rewettening
Generate the inflected form for: rewetten V;V.PTCP;PST	rewettened	rewettened
Generate the inflected form for: rigidize V;NFIN	rigidize	rigidize
Generate the inflected form for: rigidize V;PRS;NOM(3,SG)	rigidizes	rigidizes
Generate the inflected form for: rigidize V;V.PTCP;PRS	rigidizing	rigidizing
Generate the inflected form for: rigidize V;V.PTCP;PST	rigidized	rigidized
Generate the inflected form for: roadshow V;PRS;NOM(3,SG)	roadshows	roadshows
Generate the inflected form for: roadshow V;PST	roadshowed	roadshowed
Generate the inflected form for: roadshow V;V.PTCP;PRS	roadshowing	roadshowing
Generate the inflected form for: roadshow V;V.PTCP;PST	roadshowed	roadshown
Generate the inflected form for: romanticise V;NFIN	romanticise	romanticise
Generate the inflected form for: romanticise V;PRS;NOM(3,SG)	romanticises	romanticises
Generate the inflected form for: romanticise V;V.PTCP;PRS	romanticising	romanticising
Generate the inflected form for: romanticise V;V.PTCP;PST	romanticised	romanticised
Generate the inflected form for: rong V;NFIN	rong	rong
Generate the inflected form for: rong V;PRS;NOM(3,SG)	rongs	rongs
Generate the inflected form for: rong V;V.PTCP;PRS	ronging	ronging
Generate the inflected form for: rong V;V.PTCP;PST	ronged	ronged
Generate the inflected form for: ross V;NFIN	ross	ross
Generate the inflected form for: ross V;PRS;NOM(3,SG)	rosses	rosses
Generate the inflected form for: ross V;PST	rossed	rossed
Generate the inflected form for: roughen V;NFIN	roughen	roughen
Generate the inflected form for: roughen V;PRS;NOM(3,SG)	roughens	roughens
Generate the inflected form for: roughen V;V.PTCP;PST	roughened	roughened
Generate the inflected form for: roundtrip V;NFIN	roundtrip	roundtrip
Generate the inflected form for: roundtrip V;PST	roundtripped	roundtripped
Generate the inflected form for: roundtrip V;V.PTCP;PRS	roundtripping	roundtripping
Generate the inflected form for: sail V;PRS;NOM(3,SG)	sails	sails
Generate the inflected form for: sail V;PST	sailed	sailed
Generate the inflected form for: sail V;V.PTCP;PRS	sailing	sailing
Generate the inflected form for: sap V;V.PTCP;PRS	sapping	sapping
Generate the inflected form for: sap V;V.PTCP;PST	sapped	sapped
Generate the inflected form for: sardine V;NFIN	sardine	sardine
Generate the inflected form for: sardine V;PRS;NOM(3,SG)	sardines	sardines
Generate the inflected form for: sardine V;PST	sardined	sardined
Generate the inflected form for: sardine V;V.PTCP;PST	sardined	sardined
Generate the inflected form for: scapegoat V;NFIN	scapegoat	scapegoat
Generate the inflected form for: scapegoat V;PRS;NOM(3,SG)	scapegoats	scapegoats
Generate the inflected form for: scapegoat V;V.PTCP;PRS	scapegoating	scapegoating
Generate the inflected form for: scapegoat V;V.PTCP;PST	scapegoated	scapegoated
Generate the inflected form for: scone V;NFIN	scone	scone
Generate the inflected form for: scone V;PRS;NOM(3,SG)	scones	scones
Generate the inflected form for: scone V;PST	sconed	sconed
Generate the inflected form for: scone V;V.PTCP;PST	sconed	sconed
Generate the inflected form for: season V;NFIN	season	season
Generate the inflected form for: season V;PST	seasoned	seasoned
Generate the inflected form for: season V;V.PTCP;PRS	seasoning	seasoning
Generate the inflected form for: season V;V.PTCP;PST	seasoned	seasoned
Generate the inflected form for: seceed V;PRS;NOM(3,SG)	seceeds	seceeds
Generate the inflected form for: seceed V;PST	seceeded	seceeded
Generate the inflected form for: seceed V;V.PTCP;PRS	seceeding	seceeding
Generate the inflected form for: seceed V;V.PTCP;PST	seceeded	seceeded
Generate the inflected form for: sheal V;NFIN	sheal	sheal
Generate the inflected form for: sheal V;PRS;NOM(3,SG)	sheals	sheals
Generate the inflected form for: sheal V;PST	shealed	shealed
Generate the inflected form for: sheal V;V.PTCP;PST	shealed	shealed
Generate the inflected form for: sie V;NFIN	sie	sie
Generate the inflected form for: sie V;PST	sied	sied
Generate the inflected form for: sie V;V.PTCP;PRS	siing	sying
Generate the inflected form for: sie V;V.PTCP;PST	sied	sied
Generate the inflected form for: slick V;NFIN	slick	slick
Generate the inflected form for: slick V;PST	slicked	slicked
Generate the inflected form for: slick V;V.PTCP;PST	slicked	slicked
Generate the inflected form for: smirk V;NFIN	smirk	smirk
Generate the inflected form for: smirk V;PRS;NOM(3,SG)	smirks	smirks
Generate the inflected form for: smirk V;V.PTCP;PRS	smirking	smirking
Generate the inflected form for: smush V;NFIN	smush	smush
Generate the inflected form for: smush V;PST	smushed	smushed
Generate the inflected form for: smush V;V.PTCP;PRS	smushing	smushing
Generate the inflected form for: softload V;NFIN	softload	softload
Generate the inflected form for: softload V;PRS;NOM(3,SG)	softloads	softloads
Generate the inflected form for: softload V;PST	softloaded	softloaded
Generate the inflected form for: softload V;V.PTCP;PRS	softloading	softloading
Generate the inflected form for: somnambulate V;PRS;NOM(3,SG)	somnambulates	somnambulates
Generate the inflected form for: somnambulate V;PST	somnambulated	somnambulated
Generate the inflected form for: somnambulate V;V.PTCP;PRS	somnambulating	somnambulating
Generate the inflected form for: somnambulate V;V.PTCP;PST	somnambulated	somnambulated
Generate the inflected form for: spile V;NFIN	spile	spile
Generate the inflected form for: spile V;PRS;NOM(3,SG)	spiles	spiles
Generate the inflected form for: spile V;PST	spiled	spiled
Generate the inflected form for: spile V;V.PTCP;PRS	spiling	spiling
Generate the inflected form for: staddle V;NFIN	staddle	staddle
Generate the inflected form for: staddle V;PRS;NOM(3,SG)	staddles	staddles
Generate the inflected form for: staddle V;V.PTCP;PRS	staddling	staddling
Generate the inflected form for: starburst V;PRS;NOM(3,SG)	starbursts	starbursts
Generate the inflected form for: starburst V;PST	starbursted	starbursted
Generate the inflected form for: starburst V;V.PTCP;PRS	starbursting	starbursting
Generate the inflected form for: stark V;NFIN	stark	stark
Generate the inflected form for: stark V;PRS;NOM(3,SG)	starks	starks
Generate the inflected form for: stark V;PST	starked	starked
Generate the inflected form for: stark V;V.PTCP;PRS	starking	starking
Generate the inflected form for: sternutate V;PRS;NOM(3,SG)	sternutates	sternutates
Generate the inflected form for: sternutate V;PST	sternutated	sternutated
Generate the inflected form for: sternutate V;V.PTCP;PRS	sternutating	sternutating
Generate the inflected form for: sternutate V;V.PTCP;PST	sternutated	sternutated
Generate the inflected form for: storm V;NFIN	storm	storm
Generate the inflected form for: storm V;PRS;NOM(3,SG)	storms	storms
Generate the inflected form for: storm V;V.PTCP;PST	stormed	stormed
Generate the inflected form for: storyboard V;PRS;NOM(3,SG)	storyboards	storyboards
Generate the inflected form for: storyboard V;PST	storyboarded	storyboarded
Generate the inflected form for: stringify V;NFIN	stringify	stringify
Generate the inflected form for: stringify V;PST	stringified	stringified
Generate the inflected form for: stringify V;V.PTCP;PRS	stringifying	stringifying
Generate the inflected form for: stringify V;V.PTCP;PST	stringified	stringified
Generate the inflected form for: strip-search V;NFIN	strip-search	strip-search
Generate the inflected form for: strip-search V;V.PTCP;PRS	strip-searching	strip-searching
Generate the inflected form for: strip-search V;V.PTCP;PST	strip-searched	strip-searched
Generate the inflected form for: strow V;NFIN	strow	strow
Generate the inflected form for: strow V;PST	strowed	strowed
Generate the inflected form for: strow V;V.PTCP;PRS	strowing	strowing
Generate the inflected form for: strow V;V.PTCP;PST	strowed	strown
Generate the inflected form for: sublime V;NFIN	sublime	sublime
Generate the inflected form for: sublime V;V.PTCP;PST	sublimed	sublimed
Generate the inflected form for: subsidise V;PRS;NOM(3,SG)	subsidises	subsidises
Generate the inflected form for: subsidise V;V.PTCP;PRS	subsidising	subsidising
Generate the inflected form for: subsidise V;V.PTCP;PST	subsidised	subsidised
Generate the inflected form for: superordinate V;NFIN	superordinate	superordinate
Generate the inflected form for: superordinate V;PRS;NOM(3,SG)	superordinates	superordinates
Generate the inflected form for: superordinate V;PST	superordinated	superordinated
Generate the inflected form for: supervene V;NFIN	supervene	supervene
Generate the inflected form for: supervene V;PRS;NOM(3,SG)	supervenes	supervenes
Generate the inflected form for: supervene V;PST	supervened	supervened
Generate the inflected form for: supervene V;V.PTCP;PRS	supervening	supervening
Generate the inflected form for: survive V;PRS;NOM(3,SG)	survives	survives
Generate the inflected form for: survive V;PST	survived	survived
Generate the inflected form for: survive V;V.PTCP;PRS	surviving	surviving
Generate the inflected form for: terp V;NFIN	terp	terp
Generate the inflected form for: terp V;PST	terped	terped
Generate the inflected form for: terp V;V.PTCP;PRS	terping	terping
Generate the inflected form for: terp V;V.PTCP;PST	terped	terped
Generate the inflected form for: thrombose V;NFIN	thrombose	thrombose
Generate the inflected form for: thrombose V;PRS;NOM(3,SG)	thromboses	thromboses
Generate the inflected form for: thrombose V;V.PTCP;PST	thrombosed	thrombosed
Generate the inflected form for: tint V;NFIN	tint	tint
Generate the inflected form for: tint V;PRS;NOM(3,SG)	tints	tints
Generate the inflected form for: tint V;V.PTCP;PRS	tinting	tinting
Generate the inflected form for: tint V;V.PTCP;PST	tinted	tinted
Generate the inflected form for: tipple V;PRS;NOM(3,SG)	tipples	tipples
Generate the inflected form for: tipple V;PST	tippled	tippled
Generate the inflected form for: tipple V;V.PTCP;PRS	tippling	tippling
Generate the inflected form for: tipple V;V.PTCP;PST	tippled	tippled
Generate the inflected form for: titivate V;PRS;NOM(3,SG)	titivates	titivates
Generate the inflected form for: titivate V;V.PTCP;PRS	titivating	titivating
Generate the inflected form for: titivate V;V.PTCP;PST	titivated	titivated
Generate the inflected form for: transsexualize V;PRS;NOM(3,SG)	transsexualizes	transsexualizes
Generate the inflected form for: transsexualize V;PST	transsexualized	transsexualized
Generate the inflected form for: transsexualize V;V.PTCP;PRS	transsexualizing	transsexualizing
Generate the inflected form for: transsexualize V;V.PTCP;PST	transsexualized	transsexualized
Generate the inflected form for: trench-plough V;NFIN	trench-plough	trench-plough
Generate the inflected form for: trench-plough V;PRS;NOM(3,SG)	trench-ploughs	trench-ploughs
Generate the inflected form for: trench-plough V;V.PTCP;PST	trench-ploughed	trench-ploughed
Generate the inflected form for: trice V;PRS;NOM(3,SG)	trices	trices
Generate the inflected form for: trice V;PST	triced	triced
Generate the inflected form for: trice V;V.PTCP;PRS	tricing	tricing
Generate the inflected form for: trypsinise V;NFIN	trypsinise	trypsinise
Generate the inflected form for: trypsinise V;PRS;NOM(3,SG)	trypsinises	trypsinises
Generate the inflected form for: trypsinise V;V.PTCP;PRS	trypsinising	trypsinising
Generate the inflected form for: trypsinise V;V.PTCP;PST	trypsinised	trypsinised
Generate the inflected form for: tubulate V;PRS;NOM(3,SG)	tubulates	tubulates
Generate the inflected form for: tubulate V;PST	tubulated	tubulated
Generate the inflected form for: twine V;PRS;NOM(3,SG)	twines	twines
Generate the inflected form for: twine V;PST	twined	twined
Generate the inflected form for: twine V;V.PTCP;PRS	twining	twining
Generate the inflected form for: twist V;PRS;NOM(3,SG)	twists	twists
Generate the inflected form for: twist V;PST	twisted	twisted
Generate the inflected form for: twist V;V.PTCP;PRS	twisting	twisting
Generate the inflected form for: twist V;V.PTCP;PST	twisted	twisted
Generate the inflected form for: unclamp V;NFIN	unclamp	unclamp
Generate the inflected form for: unclamp V;PRS;NOM(3,SG)	unclamps	unclamps
Generate the inflected form for: unclamp V;V.PTCP;PRS	unclamping	unclamping
Generate the inflected form for: undeceave V;NFIN	undeceave	undeceave
Generate the inflected form for: undeceave V;PST	undeceaved	undeceaved
Generate the inflected form for: underdose V;PRS;NOM(3,SG)	underdoses	underdoses
Generate the inflected form for: underdose V;V.PTCP;PRS	underdosing	underdosing
Generate the inflected form for: underdose V;V.PTCP;PST	underdosed	underdosed
Generate the inflected form for: unfocus V;PST	unfocused	unfocussed
Generate the inflected form for: unfocus V;V.PTCP;PRS	unfocusing	unfocussing
Generate the inflected form for: unfocus V;V.PTCP;PST	unfocused	unfocussed
Generate the inflected form for: unhyphenate V;PRS;NOM(3,SG)	unhyphenates	unhyphenates
Generate the inflected form for: unhyphenate V;PST	unhyphenated	unhyphenated
Generate the inflected form for: unhyphenate V;V.PTCP;PRS	unhyphenating	unhyphenating
Generate the inflected form for: unhyphenate V;V.PTCP;PST	unhyphenated	unhyphenated
Generate the inflected form for: unpaint V;NFIN	unpaint	unpaint
Generate the inflected form for: unpaint V;PRS;NOM(3,SG)	unpaints	unpaints
Generate the inflected form for: unperplex V;PRS;NOM(3,SG)	unperplexes	unperplexes
Generate the inflected form for: unperplex V;V.PTCP;PRS	unperplexing	unperplexing
Generate the inflected form for: unperplex V;V.PTCP;PST	unperplexed	unperplexed
Generate the inflected form for: unplat V;NFIN	unplat	unplat
Generate the inflected form for: unplat V;PRS;NOM(3,SG)	unplats	unplats
Generate the inflected form for: unplat V;V.PTCP;PST	unplatted	unplatted
Generate the inflected form for: unplug V;NFIN	unplug	unplug
Generate the inflected form for: unplug V;PRS;NOM(3,SG)	unplugs	unplugs
Generate the inflected form for: unplug V;PST	unplugged	unplugged
Generate the inflected form for: unplug V;V.PTCP;PST	unplugged	unplugged
Generate the inflected form for: unsell V;NFIN	unsell	unsell
Generate the inflected form for: unsell V;PRS;NOM(3,SG)	unsells	unsells
Generate the inflected form for: unsell V;PST	unselled	unsold
Generate the inflected form for: unsell V;V.PTCP;PST	unselled	unsold
Generate the inflected form for: unstabilize V;PRS;NOM(3,SG)	unstabilizes	unstabilizes
Generate the inflected form for: upbar V;NFIN	upbar	upbar
Generate the inflected form for: upbar V;PRS;NOM(3,SG)	upbars	upbars
Generate the inflected form for: upbar V;PST	upbarred	upbarred
Generate the inflected form for: upbar V;V.PTCP;PST	upbarred	upbarred
Generate the inflected form for: usher V;NFIN	usher	usher
Generate the inflected form for: usher V;PST	ushered	ushered
Generate the inflected form for: usher V;V.PTCP;PRS	ushering	ushering
Generate the inflected form for: usher V;V.PTCP;PST	ushered	ushered
Generate the inflected form for: vaccinate V;NFIN	vaccinate	vaccinate
Generate the inflected form for: vaccinate V;PST	vaccinated	vaccinated
Generate the inflected form for: vaccinate V;V.PTCP;PRS	vaccinating	vaccinating
Generate the inflected form for: vaccinate V;V.PTCP;PST	vaccinated	vaccinated
Generate the inflected form for: vacillate V;PRS;NOM(3,SG)	vacillates	vacillates
Generate the inflected form for: vacillate V;V.PTCP;PRS	vacillating	vacillating
Generate the inflected form for: vacillate V;V.PTCP;PST	vacillated	vacillated
Generate the inflected form for: vell V;NFIN	vell	vell
Generate the inflected form for: vell V;PRS;NOM(3,SG)	vells	vells
Generate the inflected form for: vell V;V.PTCP;PST	velled	velled
Generate the inflected form for: verbigerate V;NFIN	verbigerate	verbigerate
Generate the inflected form for: verbigerate V;PRS;NOM(3,SG)	verbigerates	verbigerates
Generate the inflected form for: verbigerate V;PST	verbigerated	verbigerated
Generate the inflected form for: verbigerate V;V.PTCP;PRS	verbigerating	verbigerating
Generate the inflected form for: viscerate V;NFIN	viscerate	viscerate
Generate the inflected form for: viscerate V;PST	viscerated	viscerated
Generate the inflected form for: viscerate V;V.PTCP;PRS	viscerating	viscerating
Generate the inflected form for: viscerate V;V.PTCP;PST	viscerated	viscerated
Generate the inflected form for: vivificate V;NFIN	vivificate	vivificate
Generate the inflected form for: vivificate V;PRS;NOM(3,SG)	vivificates	vivificates
Generate the inflected form for: vivificate V;PST	vivificated	vivificated
Generate the inflected form for: vivificate V;V.PTCP;PST	vivificated	vivificated
Generate the inflected form for: wabble V;NFIN	wabble	wabble
Generate the inflected form for: wabble V;PRS;NOM(3,SG)	wabbles	wabbles
Generate the inflected form for: wabble V;PST	wabbled	wabbled
Generate the inflected form for: wabble V;V.PTCP;PRS	wabbling	wabbling
Generate the inflected form for: watchdog V;NFIN	watchdog	watchdog
Generate the inflected form for: watchdog V;PST	watchdogged	watchdogged
Generate the inflected form for: watchdog V;V.PTCP;PST	watchdogged	watchdogged
Generate the inflected form for: water V;NFIN	water	water
Generate the inflected form for: water V;PST	watered	watered
Generate the inflected form for: water V;V.PTCP;PST	watered	watered
Generate the inflected form for: wham V;PRS;NOM(3,SG)	whams	whams
Generate the inflected form for: wham V;V.PTCP;PST	whammed	whammed
Generate the inflected form for: whoomp V;NFIN	whoomp	whoomp
Generate the inflected form for: whoomp V;PRS;NOM(3,SG)	whoomps	whoomps
Generate the inflected form for: whoomp V;PST	whoomped	whoomped
Generate the inflected form for: whoomp V;V.PTCP;PST	whoomped	whoomped
Generate the inflected form for: whoot V;PRS;NOM(3,SG)	whoots	whoots
Generate the inflected form for: whoot V;PST	whooted	whooted
Generate the inflected form for: whoot V;V.PTCP;PRS	whooting	whooting
Generate the inflected form for: whoot V;V.PTCP;PST	whooted	whooted
Generate the inflected form for: withsay V;NFIN	withsay	withsay
Generate the inflected form for: withsay V;PRS;NOM(3,SG)	withsays	withsays
Generate the inflected form for: withsay V;V.PTCP;PRS	withsaying	withsaying
Generate the inflected form for: withsay V;V.PTCP;PST	withsayed	withsaid
Generate the inflected form for: world V;NFIN	world	world
Generate the inflected form for: world V;PRS;NOM(3,SG)	worlds	worlds
Generate the inflected form for: world V;V.PTCP;PRS	worlding	worlding
Generate the inflected form for: world V;V.PTCP;PST	worlded	worlded
Generate the inflected form for: xeriscape V;PRS;NOM(3,SG)	xeriscapes	xeriscapes
Generate the inflected form for: yabby V;PRS;NOM(3,SG)	yabbies	yabbies
Generate the inflected form for: yabby V;PST	yabbied	yabbied
Generate the inflected form for: yearn V;NFIN	yearn	yearn
Generate the inflected form for: yearn V;PRS;NOM(3,SG)	yearns	yearns
Generate the inflected form for: yearn V;PST	yearned	yearned
Generate the inflected form for: yellow V;PRS;NOM(3,SG)	yellows	yellows
Generate the inflected form for: yellow V;PST	yellowed	yellowed
Generate the inflected form for: yellow V;V.PTCP;PRS	yellowing	yellowing
Generate the inflected form for: yellow V;V.PTCP;PST	yellowed	yellowed

Accuracy: 0.9800 (980/1000)
Mismatches (prediction | gold):
DL | DLed
Godcasted | Godcast
atsaked | atsook
conquerring | conquering
delved | dolven
