Generate the inflected form for: accasciare V;COND;NOM(1,SG)	accascerei	accascerei
Generate the inflected form for: accasciare V;COND;NOM(3,PL)	accascerebbero	accascerebbero
Generate the inflected form for: accasciare V;IND;FUT;NOM(1,SG)	accascerò	accascerò
Generate the inflected form for: accasciare V;IND;FUT;NOM(2,SG)	accascerai	accascerai
Generate the inflected form for: accasciare V;IND;PRS;NOM(1,PL)	accasciamo	accasciamo
Generate the inflected form for: accasciare V;IND;PRS;NOM(1,SG)	accasco	accascio
Generate the inflected form for: accasciare V;IND;PRS;NOM(3,PL)	accascano	accasciano
Generate the inflected form for: accasciare V;IND;PST;IPFV;NOM(1,SG)	accasciavo	accasciavo
Generate the inflected form for: accasciare V;IND;PST;IPFV;NOM(2,PL)	accasciavate	accasciavate
Generate the inflected form for: accasciare V;IND;PST;IPFV;NOM(3,PL)	accasciavano	accasciavano
Generate the inflected form for: accasciare V;IND;PST;IPFV;NOM(3,SG)	accasciava	accasciava
Generate the inflected form for: accasciare V;NFIN	accasciare	accasciare
Generate the inflected form for: accasciare V;POS;IMP;NOM(1,PL)	accasciamo	accasciamo
Generate the inflected form for: accasciare V;POS;IMP;NOM(3,PL)	accascino	accascino
Generate the inflected form for: accasciare V;POS;IMP;NOM(3,SG)	accasci	accasci
Generate the inflected form for: accasciare V;SBJV;PRS;NOM(1,SG)	accasci	accasci
Generate the inflected form for: accasciare V;SBJV;PRS;NOM(3,PL)	accascino	accascino
Generate the inflected form for: accasciare V;SBJV;PRS;NOM(3,SG)	accasci	accasci
Generate the inflected form for: accasciare V;SBJV;PST;NOM(1,SG)	accasciassi	accasciassi
Generate the inflected form for: accasciare V;SBJV;PST;NOM(3,PL)	accasciassero	accasciassero
Generate the inflected form for: accecare V.CVB;PRS	accecando	accecando
Generate the inflected form for: accecare V.PTCP;PRS	accecante	accecante
Generate the inflected form for: accecare V.PTCP;PST	accecato	accecato
Generate the inflected form for: accecare V;COND;NOM(1,SG)	accecherei	accecherei
Generate the inflected form for: accecare V;COND;NOM(2,PL)	accechereste	accechereste
Generate the inflected form for: accecare V;COND;NOM(2,SG)	accecheresti	accecheresti
Generate the inflected form for: accecare V;COND;NOM(3,PL)	accecherebbero	accecherebbero
Generate the inflected form for: accecare V;COND;NOM(3,SG)	accecherebbe	accecherebbe
Generate the inflected form for: accecare V;IND;FUT;NOM(3,SG)	accecherà	accecherà
Generate the inflected form for: accecare V;IND;PRS;NOM(2,PL)	accecate	accecate
Generate the inflected form for: accecare V;IND;PRS;NOM(2,SG)	acceci	accechi
Generate the inflected form for: accecare V;IND;PST;IPFV;NOM(1,PL)	accecavamo	accecavamo
Generate the inflected form for: accecare V;IND;PST;PFV;NOM(1,SG)	accecai	accecai
Generate the inflected form for: accecare V;IND;PST;PFV;NOM(2,PL)	accecaste	accecaste
Generate the inflected form for: accecare V;POS;IMP;NOM(1,PL)	accechiamo	accechiamo
Generate the inflected form for: accecare V;POS;IMP;NOM(3,PL)	accechino	accechino
Generate the inflected form for: accecare V;POS;IMP;NOM(3,SG)	accechi	accechi
Generate the inflected form for: accecare V;SBJV;PRS;NOM(1,SG)	accechi	accechi
Generate the inflected form for: accecare V;SBJV;PRS;NOM(2,SG)	accechi	accechi
Generate the inflected form for: accecare V;SBJV;PST;NOM(3,SG)	accecasse	accecasse
Generate the inflected form for: accontentarsi V.PTCP;PRS	accontentantesi	accontentantesi
Generate the inflected form for: accontentarsi V;COND;NOM(3,PL)	si accontenterebbero	si accontenterebbero
Generate the inflected form for: accontentarsi V;IND;FUT;NOM(1,PL)	ci accontenteremo	ci accontenteremo
Generate the inflected form for: accontentarsi V;IND;FUT;NOM(1,SG)	mi accontenterò	mi accontenterò
Generate the inflected form for: accontentarsi V;IND;FUT;NOM(2,PL)	vi accontenterete	vi accontenterete
Generate the inflected form for: accontentarsi V;IND;FUT;NOM(3,PL)	si accontenteranno	si accontenteranno
Generate the inflected form for: accontentarsi V;IND;PRS;NOM(2,SG)	ti accontenti	ti accontenti
Generate the inflected form for: accontentarsi V;IND;PRS;NOM(3,PL)	si accontentano	si accontentano
Generate the inflected form for: accontentarsi V;IND;PRS;NOM(3,SG)	si accontenta	si accontenta
Generate the inflected form for: accontentarsi V;IND;PST;IPFV;NOM(3,SG)	si accontentava	si accontentava
Generate the inflected form for: accontentarsi V;IND;PST;PFV;NOM(1,PL)	ci accontentammo	ci accontentammo
Generate the inflected form for: accontentarsi V;IND;PST;PFV;NOM(2,SG)	ti accontentasti	ti accontentasti
Generate the inflected form for: accontentarsi V;IND;PST;PFV;NOM(3,PL)	si accontentarono	si accontentarono
Generate the inflected form for: accontentarsi V;IND;PST;PFV;NOM(3,SG)	si accontentò	si accontentò
Generate the inflected form for: accontentarsi V;POS;IMP;NOM(1,PL)	accontentiamoci	accontentiamoci
Generate the inflected form for: accontentarsi V;POS;IMP;NOM(2,PL)	accontentatevi	accontentatevi
Generate the inflected form for: accontentarsi V;POS;IMP;NOM(3,SG)	si accontenti	si accontenti
Generate the inflected form for: accontentarsi V;SBJV;PRS;NOM(3,SG)	si accontenti	si accontenti
Generate the inflected form for: accontentarsi V;SBJV;PST;NOM(1,SG)	mi accontentassi	mi accontentassi
Generate the inflected form for: accontentarsi V;SBJV;PST;NOM(2,SG)	ti accontentassi	ti accontentassi
Generate the inflected form for: addomandare V.PTCP;PRS	addomandante	addomandante
Generate the inflected form for: addomandare V;COND;NOM(3,SG)	addomanderebbe	addomanderebbe
Generate the inflected form for: addomandare V;IND;FUT;NOM(2,PL)	addomanderete	addomanderete
Generate the inflected form for: addomandare V;IND;FUT;NOM(3,PL)	addomanderanno	addomanderanno
Generate the inflected form for: addomandare V;IND;PRS;NOM(1,PL)	addomandiamo	addomandiamo
Generate the inflected form for: addomandare V;IND;PRS;NOM(1,SG)	addomando	addomando
Generate the inflected form for: addomandare V;IND;PRS;NOM(2,PL)	addomandate	addomandate
Generate the inflected form for: addomandare V;IND;PRS;NOM(3,PL)	addomandano	addomandano
Generate the inflected form for: addomandare V;IND;PST;IPFV;NOM(1,PL)	addomandavamo	addomandavamo
Generate the inflected form for: addomandare V;IND;PST;IPFV;NOM(2,SG)	addomandavi	addomandavi
Generate the inflected form for: addomandare V;IND;PST;IPFV;NOM(3,PL)	addomandavano	addomandavano
Generate the inflected form for: addomandare V;IND;PST;PFV;NOM(1,PL)	addomandammo	addomandammo
Generate the inflected form for: addomandare V;IND;PST;PFV;NOM(1,SG)	addomandai	addomandai
Generate the inflected form for: addomandare V;IND;PST;PFV;NOM(2,PL)	addomandaste	addomandaste
Generate the inflected form for: addomandare V;IND;PST;PFV;NOM(2,SG)	addomandasti	addomandasti
Generate the inflected form for: addomandare V;POS;IMP;NOM(3,PL)	addomandino	addomandino
Generate the inflected form for: addomandare V;SBJV;PRS;NOM(1,SG)	addomandi	addomandi
Generate the inflected form for: addomandare V;SBJV;PRS;NOM(2,PL)	addomandiate	addomandiate
Generate the inflected form for: addomandare V;SBJV;PRS;NOM(3,SG)	addomandi	addomandi
Generate the inflected form for: addomandare V;SBJV;PST;NOM(3,SG)	addomandasse	addomandasse
Generate the inflected form for: affascinare V.CVB;PRS	affascinando	affascinando
Generate the inflected form for: affascinare V.PTCP;PST	affascinato	affascinato
Generate the inflected form for: affascinare V;COND;NOM(2,PL)	affascinereste	affascinereste
Generate the inflected form for: affascinare V;IND;FUT;NOM(1,SG)	affascinerò	affascinerò
Generate the inflected form for: affascinare V;IND;FUT;NOM(2,SG)	affascinerai	affascinerai
Generate the inflected form for: affascinare V;IND;FUT;NOM(3,PL)	affascineranno	affascineranno
Generate the inflected form for: affascinare V;IND;FUT;NOM(3,SG)	affascinerà	affascinerà
Generate the inflected form for: affascinare V;IND;PRS;NOM(3,PL)	affascinano	affascinano
Generate the inflected form for: affascinare V;IND;PST;IPFV;NOM(1,SG)	affascinavo	affascinavo
Generate the inflected form for: affascinare V;IND;PST;IPFV;NOM(2,PL)	affascinavate	affascinavate
Generate the inflected form for: affascinare V;IND;PST;IPFV;NOM(2,SG)	affascinavi	affascinavi
Generate the inflected form for: affascinare V;IND;PST;IPFV;NOM(3,PL)	affascinavano	affascinavano
Generate the inflected form for: affascinare V;IND;PST;IPFV;NOM(3,SG)	affascinava	affascinava
Generate the inflected form for: affascinare V;IND;PST;PFV;NOM(3,SG)	affascinò	affascinò
Generate the inflected form for: affascinare V;POS;IMP;NOM(1,PL)	affasciniamo	affasciniamo
Generate the inflected form for: affascinare V;SBJV;PRS;NOM(2,PL)	affasciniate	affasciniate
Generate the inflected form for: affascinare V;SBJV;PRS;NOM(3,PL)	affascinino	affascinino
Generate the inflected form for: affascinare V;SBJV;PST;NOM(2,SG)	affascinassi	affascinassi
Generate the inflected form for: affascinare V;SBJV;PST;NOM(3,PL)	affascinassero	affascinassero
Generate the inflected form for: affascinare V;SBJV;PST;NOM(3,SG)	affascinasse	affascinasse
Generate the inflected form for: africanizzare V.PTCP;PRS	africanizzante	africanizzante
Generate the inflected form for: africanizzare V;COND;NOM(1,PL)	africanizzeremmo	africanizzeremmo
Generate the inflected form for: africanizzare V;COND;NOM(2,PL)	africanizzereste	africanizzereste
Generate the inflected form for: africanizzare V;COND;NOM(2,SG)	africanizzeresti	africanizzeresti
Generate the inflected form for: africanizzare V;COND;NOM(3,PL)	africanizzerebbero	africanizzerebbero
Generate the inflected form for: africanizzare V;COND;NOM(3,SG)	africanizzerebbe	africanizzerebbe
Generate the inflected form for: africanizzare V;IND;FUT;NOM(1,PL)	africanizzeremo	africanizzeremo
Generate the inflected form for: africanizzare V;IND;PRS;NOM(1,PL)	africanizziamo	africanizziamo
Generate the inflected form for: africanizzare V;IND;PST;IPFV;NOM(2,SG)	africanizzavi	africanizzavi
Generate the inflected form for: africanizzare V;IND;PST;PFV;NOM(1,PL)	africanizzammo	africanizzammo
Generate the inflected form for: africanizzare V;IND;PST;PFV;NOM(3,SG)	africanizzò	africanizzò
Generate the inflected form for: africanizzare V;POS;IMP;NOM(2,SG)	africanizza	africanizza
Generate the inflected form for: africanizzare V;POS;IMP;NOM(3,SG)	africanizzi	africanizzi
Generate the inflected form for: africanizzare V;SBJV;PRS;NOM(1,SG)	africanizzi	africanizzi
Generate the inflected form for: africanizzare V;SBJV;PRS;NOM(3,PL)	africanizzino	africanizzino
Generate the inflected form for: africanizzare V;SBJV;PRS;NOM(3,SG)	africanizzi	africanizzi
Generate the inflected form for: africanizzare V;SBJV;PST;NOM(1,PL)	africanizzassimo	africanizzassimo
Generate the inflected form for: africanizzare V;SBJV;PST;NOM(2,PL)	africanizzaste	africanizzaste
Generate the inflected form for: africanizzare V;SBJV;PST;NOM(2,SG)	africanizzassi	africanizzassi
Generate the inflected form for: africanizzare V;SBJV;PST;NOM(3,SG)	africanizzasse	africanizzasse
Generate the inflected form for: arraffare V.CVB;PRS	arraffando	arraffando
Generate the inflected form for: arraffare V;COND;NOM(1,SG)	arrafferei	arrafferei
Generate the inflected form for: arraffare V;COND;NOM(2,PL)	arraffereste	arraffereste
Generate the inflected form for: arraffare V;COND;NOM(2,SG)	arrafferesti	arrafferesti
Generate the inflected form for: arraffare V;COND;NOM(3,SG)	arrafferebbe	arrafferebbe
Generate the inflected form for: arraffare V;IND;FUT;NOM(2,PL)	arrafferete	arrafferete
Generate the inflected form for: arraffare V;IND;FUT;NOM(2,SG)	arrafferai	arrafferai
Generate the inflected form for: arraffare V;IND;FUT;NOM(3,PL)	arrafferanno	arrafferanno
Generate the inflected form for: arraffare V;IND;PRS;NOM(1,SG)	arraffo	arraffo
Generate the inflected form for: arraffare V;IND;PRS;NOM(2,PL)	arraffate	arraffate
Generate the inflected form for: arraffare V;IND;PRS;NOM(3,SG)	arraffa	arraffa
Generate the inflected form for: arraffare V;IND;PST;IPFV;NOM(2,PL)	arraffavate	arraffavate
Generate the inflected form for: arraffare V;IND;PST;IPFV;NOM(2,SG)	arraffavi	arraffavi
Generate the inflected form for: arraffare V;IND;PST;PFV;NOM(1,SG)	arraffai	arraffai
Generate the inflected form for: arraffare V;NFIN	arraffare	arraffare
Generate the inflected form for: arraffare V;POS;IMP;NOM(2,SG)	arraffa	arraffa
Generate the inflected form for: arraffare V;SBJV;PRS;NOM(1,PL)	arraffiamo	arraffiamo
Generate the inflected form for: arraffare V;SBJV;PST;NOM(1,PL)	arraffassimo	arraffassimo
Generate the inflected form for: arraffare V;SBJV;PST;NOM(2,SG)	arraffassi	arraffassi
Generate the inflected form for: arraffare V;SBJV;PST;NOM(3,SG)	arraffasse	arraffasse
Generate the inflected form for: asfissiare V.CVB;PRS	asfissiando	asfissiando
Generate the inflected form for: asfissiare V;COND;NOM(1,PL)	asfissieremmo	asfissieremmo
Generate the inflected form for: asfissiare V;COND;NOM(1,SG)	asfissierei	asfissierei
Generate the inflected form for: asfissiare V;COND;NOM(3,SG)	asfissierebbe	asfissierebbe
Generate the inflected form for: asfissiare V;IND;FUT;NOM(1,PL)	asfissieremo	asfissieremo
Generate the inflected form for: asfissiare V;IND;FUT;NOM(1,SG)	asfissierò	asfissierò
Generate the inflected form for: asfissiare V;IND;FUT;NOM(2,PL)	asfissierete	asfissierete
Generate the inflected form for: asfissiare V;IND;PRS;NOM(1,SG)	asfissio	asfissio
Generate the inflected form for: asfissiare V;IND;PRS;NOM(2,SG)	asfissi	asfissi
Generate the inflected form for: asfissiare V;IND;PST;IPFV;NOM(2,PL)	asfissiavate	asfissiavate
Generate the inflected form for: asfissiare V;IND;PST;IPFV;NOM(2,SG)	asfissiavi	asfissiavi
Generate the inflected form for: asfissiare V;IND;PST;PFV;NOM(1,PL)	asfissiammo	asfissiammo
Generate the inflected form for: asfissiare V;IND;PST;PFV;NOM(1,SG)	asfissiai	asfissiai
Generate the inflected form for: asfissiare V;IND;PST;PFV;NOM(2,PL)	asfissiaste	asfissiaste
Generate the inflected form for: asfissiare V;IND;PST;PFV;NOM(2,SG)	asfissiasti	asfissiasti
Generate the inflected form for: asfissiare V;IND;PST;PFV;NOM(3,PL)	asfissiarono	asfissiarono
Generate the inflected form for: asfissiare V;POS;IMP;NOM(2,SG)	asfissia	asfissia
Generate the inflected form for: asfissiare V;SBJV;PRS;NOM(1,SG)	asfissi	asfissi
Generate the inflected form for: asfissiare V;SBJV;PRS;NOM(2,SG)	asfissi	asfissi
Generate the inflected form for: asfissiare V;SBJV;PST;NOM(1,PL)	asfissiassimo	asfissiassimo
Generate the inflected form for: chioccolare V.CVB;PRS	chioccolando	chioccolando
Generate the inflected form for: chioccolare V.PTCP;PRS	chioccolante	chioccolante
Generate the inflected form for: chioccolare V.PTCP;PST	chioccolato	chioccolato
Generate the inflected form for: chioccolare V;COND;NOM(1,PL)	chioccoleremmo	chioccoleremmo
Generate the inflected form for: chioccolare V;COND;NOM(1,SG)	chioccolerei	chioccolerei
Generate the inflected form for: chioccolare V;COND;NOM(2,PL)	chioccolereste	chioccolereste
Generate the inflected form for: chioccolare V;IND;FUT;NOM(2,SG)	chioccolerai	chioccolerai
Generate the inflected form for: chioccolare V;IND;PST;IPFV;NOM(1,SG)	chioccolavo	chioccolavo
Generate the inflected form for: chioccolare V;IND;PST;PFV;NOM(1,PL)	chioccolammo	chioccolammo
Generate the inflected form for: chioccolare V;IND;PST;PFV;NOM(2,SG)	chioccolasti	chioccolasti
Generate the inflected form for: chioccolare V;IND;PST;PFV;NOM(3,SG)	chioccolò	chioccolò
Generate the inflected form for: chioccolare V;POS;IMP;NOM(2,PL)	chioccolate	chioccolate
Generate the inflected form for: chioccolare V;POS;IMP;NOM(3,PL)	chioccolino	chioccolino
Generate the inflected form for: chioccolare V;SBJV;PRS;NOM(1,PL)	chioccoliamo	chioccoliamo
Generate the inflected form for: chioccolare V;SBJV;PRS;NOM(3,PL)	chioccolino	chioccolino
Generate the inflected form for: chioccolare V;SBJV;PST;NOM(1,PL)	chioccolassimo	chioccolassimo
Generate the inflected form for: chioccolare V;SBJV;PST;NOM(1,SG)	chioccolassi	chioccolassi
Generate the inflected form for: chioccolare V;SBJV;PST;NOM(2,PL)	chioccolaste	chioccolaste
Generate the inflected form for: chioccolare V;SBJV;PST;NOM(2,SG)	chioccolassi	chioccolassi
Generate the inflected form for: chioccolare V;SBJV;PST;NOM(3,SG)	chioccolasse	chioccolasse
Generate the inflected form for: colludere V.PTCP;PST	colluto	colluso
Generate the inflected form for: colludere V;COND;NOM(1,PL)	colluderemmo	colluderemmo
Generate the inflected form for: colludere V;COND;NOM(2,SG)	colluderesti	colluderesti
Generate the inflected form for: colludere V;IND;FUT;NOM(3,PL)	colluderanno	colluderanno
Generate the inflected form for: colludere V;IND;FUT;NOM(3,SG)	colluderà	colluderà
Generate the inflected form for: colludere V;IND;PRS;NOM(2,SG)	colludi	colludi
Generate the inflected form for: colludere V;IND;PRS;NOM(3,SG)	colluda	collude
Generate the inflected form for: colludere V;IND;PST;IPFV;NOM(2,SG)	colludevi	colludevi
Generate the inflected form for: colludere V;IND;PST;PFV;NOM(1,PL)	colludemmo	colludemmo
Generate the inflected form for: colludere V;IND;PST;PFV;NOM(2,PL)	colludeste	colludeste
Generate the inflected form for: colludere V;IND;PST;PFV;NOM(2,SG)	collusesti	colludesti
Generate the inflected form for: colludere V;IND;PST;PFV;NOM(3,PL)	colluderono	collusero
Generate the inflected form for: colludere V;IND;PST;PFV;NOM(3,SG)	colluò	colluse
Generate the inflected form for: colludere V;POS;IMP;NOM(1,PL)	colludiamo	colludiamo
Generate the inflected form for: colludere V;POS;IMP;NOM(3,SG)	colluda	colluda
Generate the inflected form for: colludere V;SBJV;PRS;NOM(1,PL)	colludiamo	colludiamo
Generate the inflected form for: colludere V;SBJV;PRS;NOM(1,SG)	colluda	colluda
Generate the inflected form for: colludere V;SBJV;PST;NOM(1,PL)	colludessimo	colludessimo
Generate the inflected form for: colludere V;SBJV;PST;NOM(2,PL)	colludeste	colludeste
Generate the inflected form for: colludere V;SBJV;PST;NOM(3,SG)	colludesse	colludesse
Generate the inflected form for: convenzionare V;COND;NOM(2,PL)	convenzionereste	convenzionereste
Generate the inflected form for: convenzionare V;COND;NOM(3,PL)	convenzionerebbero	convenzionerebbero
Generate the inflected form for: convenzionare V;COND;NOM(3,SG)	convenzionerebbe	convenzionerebbe
Generate the inflected form for: convenzionare V;IND;FUT;NOM(1,SG)	convenzionerò	convenzionerò
Generate the inflected form for: convenzionare V;IND;FUT;NOM(2,SG)	convenzionerai	convenzionerai
Generate the inflected form for: convenzionare V;IND;FUT;NOM(3,SG)	convenzionerà	convenzionerà
Generate the inflected form for: convenzionare V;IND;PRS;NOM(3,SG)	convenziona	convenziona
Generate the inflected form for: convenzionare V;IND;PST;IPFV;NOM(1,PL)	convenzionavamo	convenzionavamo
Generate the inflected form for: convenzionare V;IND;PST;IPFV;NOM(1,SG)	convenzionavo	convenzionavo
Generate the inflected form for: convenzionare V;IND;PST;IPFV;NOM(2,SG)	convenzionavi	convenzionavi
Generate the inflected form for: convenzionare V;IND;PST;IPFV;NOM(3,SG)	convenzionava	convenzionava
Generate the inflected form for: convenzionare V;IND;PST;PFV;NOM(1,PL)	convenzionammo	convenzionammo
Generate the inflected form for: convenzionare V;IND;PST;PFV;NOM(1,SG)	convenzionai	convenzionai
Generate the inflected form for: convenzionare V;IND;PST;PFV;NOM(2,SG)	convenzionasti	convenzionasti
Generate the inflected form for: convenzionare V;IND;PST;PFV;NOM(3,PL)	convenzionarono	convenzionarono
Generate the inflected form for: convenzionare V;POS;IMP;NOM(3,SG)	convenzioni	convenzioni
Generate the inflected form for: convenzionare V;SBJV;PRS;NOM(2,PL)	convenzioniate	convenzioniate
Generate the inflected form for: convenzionare V;SBJV;PRS;NOM(3,PL)	convenzionino	convenzionino
Generate the inflected form for: convenzionare V;SBJV;PST;NOM(1,PL)	convenzionassimo	convenzionassimo
Generate the inflected form for: convenzionare V;SBJV;PST;NOM(3,PL)	convenzionassero	convenzionassero
Generate the inflected form for: dipingere V.CVB;PRS	dipingendo	dipingendo
Generate the inflected form for: dipingere V;COND;NOM(2,PL)	dipingereste	dipingereste
Generate the inflected form for: dipingere V;IND;FUT;NOM(1,SG)	dipingerò	dipingerò
Generate the inflected form for: dipingere V;IND;FUT;NOM(3,SG)	dipingerà	dipingerà
Generate the inflected form for: dipingere V;IND;PRS;NOM(1,PL)	dipingiamo	dipingiamo
Generate the inflected form for: dipingere V;IND;PRS;NOM(3,SG)	dipinge	dipinge
Generate the inflected form for: dipingere V;IND;PST;IPFV;NOM(1,SG)	dipingevo	dipingevo
Generate the inflected form for: dipingere V;IND;PST;IPFV;NOM(2,PL)	dipingevate	dipingevate
Generate the inflected form for: dipingere V;IND;PST;IPFV;NOM(2,SG)	dipingevi	dipingevi
Generate the inflected form for: dipingere V;IND;PST;IPFV;NOM(3,PL)	dipingevano	dipingevano
Generate the inflected form for: dipingere V;IND;PST;IPFV;NOM(3,SG)	dipingeva	dipingeva
Generate the inflected form for: dipingere V;IND;PST;PFV;NOM(1,PL)	dipingemmo	dipingemmo
Generate the inflected form for: dipingere V;IND;PST;PFV;NOM(1,SG)	dipingei	dipinsi
Generate the inflected form for: dipingere V;IND;PST;PFV;NOM(2,PL)	dipingeste	dipingeste
Generate the inflected form for: dipingere V;IND;PST;PFV;NOM(3,PL)	dipingerono	dipinsero
Generate the inflected form for: dipingere V;POS;IMP;NOM(2,PL)	dipingete	dipingete
Generate the inflected form for: dipingere V;SBJV;PRS;NOM(1,PL)	dipingamo	dipingiamo
Generate the inflected form for: dipingere V;SBJV;PRS;NOM(2,PL)	dipingiate	dipingiate
Generate the inflected form for: dipingere V;SBJV;PRS;NOM(2,SG)	dipinga	dipinga
Generate the inflected form for: dipingere V;SBJV;PST;NOM(1,PL)	dipingessimo	dipingessimo
Generate the inflected form for: giostrare V.CVB;PRS	giostrando	giostrando
Generate the inflected form for: giostrare V.PTCP;PRS	giostrante	giostrante
Generate the inflected form for: giostrare V;COND;NOM(1,SG)	giostrerei	giostrerei
Generate the inflected form for: giostrare V;COND;NOM(2,PL)	giostrereste	giostrereste
Generate the inflected form for: giostrare V;COND;NOM(3,SG)	giostrerebbe	giostrerebbe
Generate the inflected form for: giostrare V;IND;FUT;NOM(1,SG)	giostrerò	giostrerò
Generate the inflected form for: giostrare V;IND;PRS;NOM(1,PL)	giostriamo	giostriamo
Generate the inflected form for: giostrare V;IND;PRS;NOM(1,SG)	giostro	giostro
Generate the inflected form for: giostrare V;IND;PRS;NOM(2,PL)	giostrate	giostrate
Generate the inflected form for: giostrare V;IND;PRS;NOM(3,PL)	giostrano	giostrano
Generate the inflected form for: giostrare V;IND;PRS;NOM(3,SG)	giostra	giostra
Generate the inflected form for: giostrare V;IND;PST;IPFV;NOM(1,PL)	giostravamo	giostravamo
Generate the inflected form for: giostrare V;IND;PST;IPFV;NOM(2,PL)	giostravate	giostravate
Generate the inflected form for: giostrare V;IND;PST;PFV;NOM(2,SG)	giostrasti	giostrasti
Generate the inflected form for: giostrare V;IND;PST;PFV;NOM(3,PL)	giostrarono	giostrarono
Generate the inflected form for: giostrare V;IND;PST;PFV;NOM(3,SG)	giostrò	giostrò
Generate the inflected form for: giostrare V;POS;IMP;NOM(2,SG)	giostra	giostra
Generate the inflected form for: giostrare V;SBJV;PRS;NOM(2,SG)	giostri	giostri
Generate the inflected form for: giostrare V;SBJV;PRS;NOM(3,SG)	giostri	giostri
Generate the inflected form for: giostrare V;SBJV;PST;NOM(3,PL)	giostrassero	giostrassero
Generate the inflected form for: guarnire V.PTCP;PRS	guarnente	guarnente
Generate the inflected form for: guarnire V;COND;NOM(2,PL)	guarnireste	guarnireste
Generate the inflected form for: guarnire V;COND;NOM(2,SG)	guarniresti	guarniresti
Generate the inflected form for: guarnire V;COND;NOM(3,SG)	guarnirebbe	guarnirebbe
Generate the inflected form for: guarnire V;IND;FUT;NOM(1,PL)	guarniremo	guarniremo
Generate the inflected form for: guarnire V;IND;FUT;NOM(2,PL)	guarnirete	guarnirete
Generate the inflected form for: guarnire V;IND;PRS;NOM(1,PL)	guarniamo	guarniamo
Generate the inflected form for: guarnire V;IND;PRS;NOM(2,PL)	guarnite	guarnite
Generate the inflected form for: guarnire V;IND;PRS;NOM(3,PL)	guarniscono	guarniscono
Generate the inflected form for: guarnire V;IND;PRS;NOM(3,SG)	guarnisce	guarnisce
Generate the inflected form for: guarnire V;IND;PST;IPFV;NOM(3,PL)	guarnivano	guarnivano
Generate the inflected form for: guarnire V;IND;PST;IPFV;NOM(3,SG)	guarniva	guarniva
Generate the inflected form for: guarnire V;IND;PST;PFV;NOM(2,PL)	guarniste	guarniste
Generate the inflected form for: guarnire V;IND;PST;PFV;NOM(3,SG)	guarnì	guarnì
Generate the inflected form for: guarnire V;POS;IMP;NOM(2,PL)	guarnite	guarnite
Generate the inflected form for: guarnire V;SBJV;PRS;NOM(1,PL)	guarniamo	guarniamo
Generate the inflected form for: guarnire V;SBJV;PRS;NOM(2,SG)	guarnisca	guarnisca
Generate the inflected form for: guarnire V;SBJV;PST;NOM(2,PL)	guarniste	guarniste
Generate the inflected form for: guarnire V;SBJV;PST;NOM(3,PL)	guarnissero	guarnissero
Generate the inflected form for: guarnire V;SBJV;PST;NOM(3,SG)	guarnisse	guarnisse
Generate the inflected form for: imborghesirsi V.CVB;PRS	imborghesendosi	imborghesendosi
Generate the inflected form for: imborghesirsi V;COND;NOM(1,PL)	ci imborghesiremmo	ci imborghesiremmo
Generate the inflected form for: imborghesirsi V;COND;NOM(1,SG)	mi imborghesirei	mi imborghesirei
Generate the inflected form for: imborghesirsi V;COND;NOM(2,PL)	vi imborghesireste	vi imborghesireste
Generate the inflected form for: imborghesirsi V;COND;NOM(2,SG)	ti imborghesiresti	ti imborghesiresti
Generate the inflected form for: imborghesirsi V;COND;NOM(3,PL)	si imborghesirebbero	si imborghesirebbero
Generate the inflected form for: imborghesirsi V;IND;FUT;NOM(1,SG)	mi imborghesirò	mi imborghesirò
Generate the inflected form for: imborghesirsi V;IND;PRS;NOM(2,SG)	ti imborghesisci	ti imborghesisci
Generate the inflected form for: imborghesirsi V;IND;PST;IPFV;NOM(2,PL)	vi imborghesivate	vi imborghesivate
Generate the inflected form for: imborghesirsi V;IND;PST;PFV;NOM(1,PL)	ci imborghesimmo	ci imborghesimmo
Generate the inflected form for: imborghesirsi V;IND;PST;PFV;NOM(1,SG)	mi imborghesii	mi imborghesii
Generate the inflected form for: imborghesirsi V;POS;IMP;NOM(1,PL)	imborghesiamoci	imborghesiamoci
Generate the inflected form for: imborghesirsi V;POS;IMP;NOM(2,SG)	imborghesiti	imborghesisciti
Generate the inflected form for: imborghesirsi V;POS;IMP;NOM(3,PL)	si imborghesiscano	si imborghesiscano
Generate the inflected form for: imborghesirsi V;POS;IMP;NOM(3,SG)	si imborghesisca	si imborghesisca
Generate the inflected form for: imborghesirsi V;SBJV;PRS;NOM(1,PL)	ci imborghesiamo	ci imborghesiamo
Generate the inflected form for: imborghesirsi V;SBJV;PRS;NOM(1,SG)	mi imborghesisca	mi imborghesisca
Generate the inflected form for: imborghesirsi V;SBJV;PRS;NOM(2,SG)	ti imborghesisca	ti imborghesisca
Generate the inflected form for: imborghesirsi V;SBJV;PRS;NOM(3,PL)	si imborghesiscano	si imborghesiscano
Generate the inflected form for: imborghesirsi V;SBJV;PST;NOM(3,PL)	si imborghesissero	si imborghesissero
Generate the inflected form for: impadronirsi V.CVB;PRS	impadronendosi	impadronendosi
Generate the inflected form for: impadronirsi V.PTCP;PST	impadronito	impadronito
Generate the inflected form for: impadronirsi V;COND;NOM(1,PL)	ci impadroniremmo	ci impadroniremmo
Generate the inflected form for: impadronirsi V;COND;NOM(2,SG)	ti impadroniresti	ti impadroniresti
Generate the inflected form for: impadronirsi V;COND;NOM(3,PL)	si impadronirebbero	si impadronirebbero
Generate the inflected form for: impadronirsi V;IND;FUT;NOM(3,PL)	si impadroniranno	si impadroniranno
Generate the inflected form for: impadronirsi V;IND;FUT;NOM(3,SG)	si impadronirà	si impadronirà
Generate the inflected form for: impadronirsi V;IND;PRS;NOM(3,PL)	si impadroniscono	si impadroniscono
Generate the inflected form for: impadronirsi V;IND;PST;IPFV;NOM(3,PL)	si impadronivano	si impadronivano
Generate the inflected form for: impadronirsi V;IND;PST;PFV;NOM(1,PL)	ci impadronimmo	ci impadronimmo
Generate the inflected form for: impadronirsi V;IND;PST;PFV;NOM(1,SG)	mi impadronii	mi impadronii
Generate the inflected form for: impadronirsi V;IND;PST;PFV;NOM(2,SG)	ti impadronisti	ti impadronisti
Generate the inflected form for: impadronirsi V;POS;IMP;NOM(3,SG)	si impadronisca	si impadronisca
Generate the inflected form for: impadronirsi V;SBJV;PRS;NOM(2,PL)	vi impadroniate	vi impadroniate
Generate the inflected form for: impadronirsi V;SBJV;PRS;NOM(2,SG)	ti impadronisca	ti impadronisca
Generate the inflected form for: impadronirsi V;SBJV;PRS;NOM(3,SG)	si impadronisca	si impadronisca
Generate the inflected form for: impadronirsi V;SBJV;PST;NOM(2,PL)	vi impadroniste	vi impadroniste
Generate the inflected form for: impadronirsi V;SBJV;PST;NOM(2,SG)	ti impadronissi	ti impadronissi
Generate the inflected form for: impadronirsi V;SBJV;PST;NOM(3,PL)	si impadronissero	si impadronissero
Generate the inflected form for: impadronirsi V;SBJV;PST;NOM(3,SG)	si impadronisse	si impadronisse
Generate the inflected form for: impermeabilizzare V.CVB;PRS	impermeabilizzando	impermeabilizzando
Generate the inflected form for: impermeabilizzare V.PTCP;PST	impermeabilizzato	impermeabilizzato
Generate the inflected form for: impermeabilizzare V;COND;NOM(2,PL)	impermeabilizzereste	impermeabilizzereste
Generate the inflected form for: impermeabilizzare V;COND;NOM(2,SG)	impermeabilizzeresti	impermeabilizzeresti
Generate the inflected form for: impermeabilizzare V;IND;FUT;NOM(2,PL)	impermeabilizzerete	impermeabilizzerete
Generate the inflected form for: impermeabilizzare V;IND;FUT;NOM(2,SG)	impermeabilizzerai	impermeabilizzerai
Generate the inflected form for: impermeabilizzare V;IND;FUT;NOM(3,PL)	impermeabilizzeranno	impermeabilizzeranno
Generate the inflected form for: impermeabilizzare V;IND;FUT;NOM(3,SG)	impermeabilizzerà	impermeabilizzerà
Generate the inflected form for: impermeabilizzare V;IND;PRS;NOM(1,PL)	impermeabilizziamo	impermeabilizziamo
Generate the inflected form for: impermeabilizzare V;IND;PRS;NOM(2,SG)	impermeabilizzi	impermeabilizzi
Generate the inflected form for: impermeabilizzare V;IND;PST;IPFV;NOM(1,PL)	impermeabilizzavamo	impermeabilizzavamo
Generate the inflected form for: impermeabilizzare V;IND;PST;IPFV;NOM(2,SG)	impermeabilizzavi	impermeabilizzavi
Generate the inflected form for: impermeabilizzare V;IND;PST;PFV;NOM(2,SG)	impermeabilizzasti	impermeabilizzasti
Generate the inflected form for: impermeabilizzare V;IND;PST;PFV;NOM(3,PL)	impermeabilizzarono	impermeabilizzarono
Generate the inflected form for: impermeabilizzare V;IND;PST;PFV;NOM(3,SG)	impermeabilizzò	impermeabilizzò
Generate the inflected form for: impermeabilizzare V;NFIN	impermeabilizzare	impermeabilizzare
Generate the inflected form for: impermeabilizzare V;POS;IMP;NOM(3,PL)	impermeabilizzino	impermeabilizzino
Generate the inflected form for: impermeabilizzare V;POS;IMP;NOM(3,SG)	impermeabilizzi	impermeabilizzi
Generate the inflected form for: impermeabilizzare V;SBJV;PST;NOM(1,SG)	impermeabilizzassi	impermeabilizzassi
Generate the inflected form for: impermeabilizzare V;SBJV;PST;NOM(3,SG)	impermeabilizzasse	impermeabilizzasse
Generate the inflected form for: impingere V.CVB;PRS	impingendo	impingendo
Generate the inflected form for: impingere V;COND;NOM(2,PL)	impingereste	impingereste
Generate the inflected form for: impingere V;COND;NOM(3,PL)	impingerebbero	impingerebbero
Generate the inflected form for: impingere V;IND;FUT;NOM(2,PL)	impingerete	impingerete
Generate the inflected form for: impingere V;IND;FUT;NOM(2,SG)	impingerai	impingerai
Generate the inflected form for: impingere V;IND;PRS;NOM(1,SG)	impingo	impingo
Generate the inflected form for: impingere V;IND;PRS;NOM(3,SG)	impinge	impinge
Generate the inflected form for: impingere V;IND;PST;IPFV;NOM(3,PL)	impingevano	impingevano
Generate the inflected form for: impingere V;IND;PST;PFV;NOM(2,PL)	impingeste	impingeste
Generate the inflected form for: impingere V;IND;PST;PFV;NOM(2,SG)	impingesti	impingesti
Generate the inflected form for: impingere V;NFIN	impingere	impingere
Generate the inflected form for: impingere V;POS;IMP;NOM(2,PL)	impingete	impingete
Generate the inflected form for: impingere V;SBJV;PRS;NOM(1,PL)	impingamo	impingiamo
Generate the inflected form for: impingere V;SBJV;PRS;NOM(2,PL)	impingiate	impingiate
Generate the inflected form for: impingere V;SBJV;PRS;NOM(2,SG)	impinga	impinga
Generate the inflected form for: impingere V;SBJV;PRS;NOM(3,PL)	impingano	impingano
Generate the inflected form for: impingere V;SBJV;PST;NOM(1,PL)	impingessimo	impingessimo
Generate the inflected form for: impingere V;SBJV;PST;NOM(2,SG)	impingessi	impingessi
Generate the inflected form for: impingere V;SBJV;PST;NOM(3,PL)	impingessero	impingessero
Generate the inflected form for: impingere V;SBJV;PST;NOM(3,SG)	impingesse	impingesse
Generate the inflected form for: increspare V.CVB;PRS	increspando	increspando
Generate the inflected form for: increspare V.PTCP;PRS	increspante	increspante
Generate the inflected form for: increspare V.PTCP;PST	increspato	increspato
Generate the inflected form for: increspare V;COND;NOM(1,PL)	incresperemmo	incresperemmo
Generate the inflected form for: increspare V;COND;NOM(1,SG)	incresperei	incresperei
Generate the inflected form for: increspare V;COND;NOM(3,PL)	incresperebbero	incresperebbero
Generate the inflected form for: increspare V;COND;NOM(3,SG)	incresperebbe	incresperebbe
Generate the inflected form for: increspare V;IND;FUT;NOM(1,PL)	incresperemo	incresperemo
Generate the inflected form for: increspare V;IND;FUT;NOM(1,SG)	incresperò	incresperò
Generate the inflected form for: increspare V;IND;FUT;NOM(3,SG)	incresperà	incresperà
Generate the inflected form for: increspare V;IND;PRS;NOM(1,SG)	increspo	increspo
Generate the inflected form for: increspare V;IND;PRS;NOM(2,PL)	increspate	increspate
Generate the inflected form for: increspare V;IND;PRS;NOM(3,SG)	increspa	increspa
Generate the inflected form for: increspare V;IND;PST;IPFV;NOM(1,SG)	increspavo	increspavo
Generate the inflected form for: increspare V;IND;PST;IPFV;NOM(2,SG)	increspavi	increspavi
Generate the inflected form for: increspare V;NFIN	increspare	increspare
Generate the inflected form for: increspare V;POS;IMP;NOM(3,PL)	increspino	increspino
Generate the inflected form for: increspare V;SBJV;PRS;NOM(2,PL)	increspiate	increspiate
Generate the inflected form for: increspare V;SBJV;PST;NOM(2,SG)	increspassi	increspassi
Generate the inflected form for: increspare V;SBJV;PST;NOM(3,SG)	increspasse	increspasse
Generate the inflected form for: indebolirsi V.PTCP;PST	indebolito	indebolito
Generate the inflected form for: indebolirsi V;COND;NOM(2,SG)	ti indeboliresti	ti indeboliresti
Generate the inflected form for: indebolirsi V;COND;NOM(3,PL)	si indebolirebbero	si indebolirebbero
Generate the inflected form for: indebolirsi V;COND;NOM(3,SG)	si indebolirebbe	si indebolirebbe
Generate the inflected form for: indebolirsi V;IND;PRS;NOM(1,SG)	mi indebolisco	mi indebolisco
Generate the inflected form for: indebolirsi V;IND;PST;IPFV;NOM(2,SG)	ti indebolivi	ti indebolivi
Generate the inflected form for: indebolirsi V;IND;PST;IPFV;NOM(3,PL)	si indebolivano	si indebolivano
Generate the inflected form for: indebolirsi V;IND;PST;IPFV;NOM(3,SG)	si indeboliva	si indeboliva
Generate the inflected form for: indebolirsi V;IND;PST;PFV;NOM(1,PL)	ci indebolimmo	ci indebolimmo
Generate the inflected form for: indebolirsi V;IND;PST;PFV;NOM(1,SG)	mi indebolii	mi indebolii
Generate the inflected form for: indebolirsi V;IND;PST;PFV;NOM(3,PL)	si indebolirono	si indebolirono
Generate the inflected form for: indebolirsi V;IND;PST;PFV;NOM(3,SG)	si indebolì	si indebolì
Generate the inflected form for: indebolirsi V;POS;IMP;NOM(1,PL)	indeboliamoci	indeboliamoci
Generate the inflected form for: indebolirsi V;POS;IMP;NOM(2,PL)	indebolitevi	indebolitevi
Generate the inflected form for: indebolirsi V;POS;IMP;NOM(3,PL)	si indeboliscano	si indeboliscano
Generate the inflected form for: indebolirsi V;SBJV;PRS;NOM(1,SG)	mi indebolisca	mi indebolisca
Generate the inflected form for: indebolirsi V;SBJV;PRS;NOM(2,SG)	ti indebolisca	ti indebolisca
Generate the inflected form for: indebolirsi V;SBJV;PRS;NOM(3,SG)	si indebolisca	si indebolisca
Generate the inflected form for: indebolirsi V;SBJV;PST;NOM(2,SG)	ti indebolissi	ti indebolissi
Generate the inflected form for: indebolirsi V;SBJV;PST;NOM(3,PL)	si indebolissero	si indebolissero
Generate the inflected form for: infettare V.PTCP;PRS	infettante	infettante
Generate the inflected form for: infettare V.PTCP;PST	infettato	infettato
Generate the inflected form for: infettare V;COND;NOM(2,PL)	infettereste	infettereste
Generate the inflected form for: infettare V;IND;FUT;NOM(1,PL)	infetteremo	infetteremo
Generate the inflected form for: infettare V;IND;FUT;NOM(2,PL)	infetterete	infetterete
Generate the inflected form for: infettare V;IND;FUT;NOM(3,PL)	infetteranno	infetteranno
Generate the inflected form for: infettare V;IND;PRS;NOM(2,SG)	infetti	infetti
Generate the inflected form for: infettare V;IND;PST;IPFV;NOM(2,SG)	infettavi	infettavi
Generate the inflected form for: infettare V;IND;PST;PFV;NOM(1,PL)	infettammo	infettammo
Generate the inflected form for: infettare V;IND;PST;PFV;NOM(2,PL)	infettaste	infettaste
Generate the inflected form for: infettare V;IND;PST;PFV;NOM(3,SG)	infettò	infettò
Generate the inflected form for: infettare V;POS;IMP;NOM(2,SG)	infetta	infetta
Generate the inflected form for: infettare V;POS;IMP;NOM(3,PL)	infettino	infettino
Generate the inflected form for: infettare V;SBJV;PRS;NOM(1,PL)	infettiamo	infettiamo
Generate the inflected form for: infettare V;SBJV;PRS;NOM(1,SG)	infetti	infetti
Generate the inflected form for: infettare V;SBJV;PRS;NOM(3,PL)	infettino	infettino
Generate the inflected form for: infettare V;SBJV;PRS;NOM(3,SG)	infetti	infetti
Generate the inflected form for: infettare V;SBJV;PST;NOM(1,PL)	infettassimo	infettassimo
Generate the inflected form for: infettare V;SBJV;PST;NOM(2,PL)	infettaste	infettaste
Generate the inflected form for: infettare V;SBJV;PST;NOM(3,PL)	infettassero	infettassero
Generate the inflected form for: lacerarsi V.CVB;PRS	lacerandosi	lacerandosi
Generate the inflected form for: lacerarsi V.PTCP;PRS	lacerantesi	lacerantesi
Generate the inflected form for: lacerarsi V;COND;NOM(1,SG)	mi lacererei	mi lacererei
Generate the inflected form for: lacerarsi V;IND;FUT;NOM(1,PL)	ci lacereremo	ci lacereremo
Generate the inflected form for: lacerarsi V;IND;FUT;NOM(2,SG)	ti lacererai	ti lacererai
Generate the inflected form for: lacerarsi V;IND;FUT;NOM(3,PL)	si lacereranno	si lacereranno
Generate the inflected form for: lacerarsi V;IND;FUT;NOM(3,SG)	si lacererà	si lacererà
Generate the inflected form for: lacerarsi V;IND;PRS;NOM(2,SG)	ti laceri	ti laceri
Generate the inflected form for: lacerarsi V;IND;PST;IPFV;NOM(2,SG)	ti laceravi	ti laceravi
Generate the inflected form for: lacerarsi V;IND;PST;IPFV;NOM(3,SG)	si lacerava	si lacerava
Generate the inflected form for: lacerarsi V;IND;PST;PFV;NOM(1,SG)	mi lacerai	mi lacerai
Generate the inflected form for: lacerarsi V;IND;PST;PFV;NOM(3,SG)	si lacerò	si lacerò
Generate the inflected form for: lacerarsi V;POS;IMP;NOM(2,SG)	lacerati	lacerati
Generate the inflected form for: lacerarsi V;POS;IMP;NOM(3,PL)	lacerino	si lacerino
Generate the inflected form for: lacerarsi V;POS;IMP;NOM(3,SG)	si laceri	si laceri
Generate the inflected form for: lacerarsi V;SBJV;PRS;NOM(1,PL)	ci laceriamo	ci laceriamo
Generate the inflected form for: lacerarsi V;SBJV;PRS;NOM(1,SG)	mi laceri	mi laceri
Generate the inflected form for: lacerarsi V;SBJV;PRS;NOM(2,PL)	vi laceriate	vi laceriate
Generate the inflected form for: lacerarsi V;SBJV;PST;NOM(1,SG)	mi lacerassi	mi lacerassi
Generate the inflected form for: lacerarsi V;SBJV;PST;NOM(2,SG)	ti lacerassi	ti lacerassi
Generate the inflected form for: limitare V.PTCP;PRS	limitante	limitante
Generate the inflected form for: limitare V;COND;NOM(2,PL)	limitereste	limitereste
Generate the inflected form for: limitare V;COND;NOM(3,PL)	limiterebbero	limiterebbero
Generate the inflected form for: limitare V;COND;NOM(3,SG)	limiterebbe	limiterebbe
Generate the inflected form for: limitare V;IND;FUT;NOM(1,PL)	limiteremo	limiteremo
Generate the inflected form for: limitare V;IND;FUT;NOM(2,PL)	limiterete	limiterete
Generate the inflected form for: limitare V;IND;FUT;NOM(3,PL)	limiteranno	limiteranno
Generate the inflected form for: limitare V;IND;PRS;NOM(1,PL)	limitiamo	limitiamo
Generate the inflected form for: limitare V;IND;PRS;NOM(2,PL)	limitate	limitate
Generate the inflected form for: limitare V;IND;PRS;NOM(3,PL)	limitano	limitano
Generate the inflected form for: limitare V;IND;PST;IPFV;NOM(3,SG)	limitava	limitava
Generate the inflected form for: limitare V;IND;PST;PFV;NOM(2,SG)	limitasti	limitasti
Generate the inflected form for: limitare V;IND;PST;PFV;NOM(3,PL)	limitarono	limitarono
Generate the inflected form for: limitare V;POS;IMP;NOM(1,PL)	limitiamo	limitiamo
Generate the inflected form for: limitare V;POS;IMP;NOM(2,PL)	limitate	limitate
Generate the inflected form for: limitare V;POS;IMP;NOM(2,SG)	limita	limita
Generate the inflected form for: limitare V;SBJV;PRS;NOM(1,SG)	limiti	limiti
Generate the inflected form for: limitare V;SBJV;PRS;NOM(3,SG)	limiti	limiti
Generate the inflected form for: limitare V;SBJV;PST;NOM(2,SG)	limitassi	limitassi
Generate the inflected form for: limitare V;SBJV;PST;NOM(3,PL)	limitassero	limitassero
Generate the inflected form for: masturbare V.PTCP;PRS	masturbante	masturbante
Generate the inflected form for: masturbare V.PTCP;PST	masturbato	masturbato
Generate the inflected form for: masturbare V;COND;NOM(1,PL)	masturberemmo	masturberemmo
Generate the inflected form for: masturbare V;COND;NOM(2,PL)	masturbereste	masturbereste
Generate the inflected form for: masturbare V;COND;NOM(2,SG)	masturberesti	masturberesti
Generate the inflected form for: masturbare V;COND;NOM(3,SG)	masturberebbe	masturberebbe
Generate the inflected form for: masturbare V;IND;FUT;NOM(2,SG)	masturberai	masturberai
Generate the inflected form for: masturbare V;IND;FUT;NOM(3,PL)	masturberanno	masturberanno
Generate the inflected form for: masturbare V;IND;FUT;NOM(3,SG)	masturberà	masturberà
Generate the inflected form for: masturbare V;IND;PST;IPFV;NOM(1,SG)	masturbavo	masturbavo
Generate the inflected form for: masturbare V;IND;PST;IPFV;NOM(3,PL)	masturbavano	masturbavano
Generate the inflected form for: masturbare V;IND;PST;PFV;NOM(1,SG)	masturbai	masturbai
Generate the inflected form for: masturbare V;IND;PST;PFV;NOM(2,SG)	masturbasti	masturbasti
Generate the inflected form for: masturbare V;POS;IMP;NOM(2,SG)	masturba	masturba
Generate the inflected form for: masturbare V;POS;IMP;NOM(3,PL)	masturbino	masturbino
Generate the inflected form for: masturbare V;SBJV;PRS;NOM(1,SG)	masturbi	masturbi
Generate the inflected form for: masturbare V;SBJV;PRS;NOM(2,PL)	masturbiate	masturbiate
Generate the inflected form for: masturbare V;SBJV;PRS;NOM(2,SG)	masturbi	masturbi
Generate the inflected form for: masturbare V;SBJV;PRS;NOM(3,PL)	masturbino	masturbino
Generate the inflected form for: masturbare V;SBJV;PST;NOM(1,PL)	masturbassimo	masturbassimo
Generate the inflected form for: mercificare V.CVB;PRS	mercificando	mercificando
Generate the inflected form for: mercificare V.PTCP;PRS	mercificante	mercificante
Generate the inflected form for: mercificare V.PTCP;PST	mercificato	mercificato
Generate the inflected form for: mercificare V;COND;NOM(1,SG)	mercificherei	mercificherei
Generate the inflected form for: mercificare V;COND;NOM(2,PL)	mercifichereste	mercifichereste
Generate the inflected form for: mercificare V;COND;NOM(2,SG)	mercificheresti	mercificheresti
Generate the inflected form for: mercificare V;COND;NOM(3,PL)	mercificherebbero	mercificherebbero
Generate the inflected form for: mercificare V;COND;NOM(3,SG)	mercificherebbe	mercificherebbe
Generate the inflected form for: mercificare V;IND;FUT;NOM(2,SG)	mercificherai	mercificherai
Generate the inflected form for: mercificare V;IND;FUT;NOM(3,PL)	mercificheranno	mercificheranno
Generate the inflected form for: mercificare V;IND;PRS;NOM(2,PL)	mercificate	mercificate
Generate the inflected form for: mercificare V;IND;PST;IPFV;NOM(2,SG)	mercificavi	mercificavi
Generate the inflected form for: mercificare V;IND;PST;PFV;NOM(2,PL)	mercificaste	mercificaste
Generate the inflected form for: mercificare V;IND;PST;PFV;NOM(3,PL)	mercificarono	mercificarono
Generate the inflected form for: mercificare V;POS;IMP;NOM(2,SG)	mercifica	mercifica
Generate the inflected form for: mercificare V;POS;IMP;NOM(3,PL)	mercifichino	mercifichino
Generate the inflected form for: mercificare V;SBJV;PRS;NOM(2,SG)	mercifichi	mercifichi
Generate the inflected form for: mercificare V;SBJV;PST;NOM(1,PL)	mercificassimo	mercificassimo
Generate the inflected form for: mercificare V;SBJV;PST;NOM(2,SG)	mercificassi	mercificassi
Generate the inflected form for: mercificare V;SBJV;PST;NOM(3,SG)	mercificasse	mercificasse
Generate the inflected form for: naturalizzarsi V.CVB;PRS	naturalizzandosi	naturalizzandosi
Generate the inflected form for: naturalizzarsi V.PTCP;PRS	naturalizzantesi	naturalizzantesi
Generate the inflected form for: naturalizzarsi V.PTCP;PST	naturalizzato	naturalizzato
Generate the inflected form for: naturalizzarsi V;COND;NOM(2,PL)	vi naturalizzereste	vi naturalizzereste
Generate the inflected form for: naturalizzarsi V;COND;NOM(3,PL)	si naturalizzerebbero	si naturalizzerebbero
Generate the inflected form for: naturalizzarsi V;IND;FUT;NOM(1,PL)	ci naturalizzeremo	ci naturalizzeremo
Generate the inflected form for: naturalizzarsi V;IND;FUT;NOM(3,PL)	si naturalizzeranno	si naturalizzeranno
Generate the inflected form for: naturalizzarsi V;IND;FUT;NOM(3,SG)	si naturalizzerà	si naturalizzerà
Generate the inflected form for: naturalizzarsi V;IND;PRS;NOM(1,PL)	ci naturalizziamo	ci naturalizziamo
Generate the inflected form for: naturalizzarsi V;IND;PRS;NOM(2,PL)	vi naturalizzate	vi naturalizzate
Generate the inflected form for: naturalizzarsi V;IND;PRS;NOM(2,SG)	ti naturalizzi	ti naturalizzi
Generate the inflected form for: naturalizzarsi V;IND;PRS;NOM(3,SG)	si naturalizza	si naturalizza
Generate the inflected form for: naturalizzarsi V;IND;PST;IPFV;NOM(2,PL)	vi naturalizzavate	vi naturalizzavate
Generate the inflected form for: naturalizzarsi V;NFIN	naturalizzarsi	naturalizzarsi
Generate the inflected form for: naturalizzarsi V;POS;IMP;NOM(3,PL)	naturalizzino	si naturalizzino
Generate the inflected form for: naturalizzarsi V;SBJV;PRS;NOM(1,PL)	ci naturalizziamo	ci naturalizziamo
Generate the inflected form for: naturalizzarsi V;SBJV;PRS;NOM(3,PL)	si naturalizzino	si naturalizzino
Generate the inflected form for: naturalizzarsi V;SBJV;PRS;NOM(3,SG)	si naturalizzi	si naturalizzi
Generate the inflected form for: naturalizzarsi V;SBJV;PST;NOM(2,SG)	ti naturalizzassi	ti naturalizzassi
Generate the inflected form for: naturalizzarsi V;SBJV;PST;NOM(3,SG)	si naturalizzasse	si naturalizzasse
Generate the inflected form for: oscillare V.CVB;PRS	oscillando	oscillando
Generate the inflected form for: oscillare V.PTCP;PRS	oscillante	oscillante
Generate the inflected form for: oscillare V;COND;NOM(1,SG)	oscillerei	oscillerei
Generate the inflected form for: oscillare V;COND;NOM(2,PL)	oscillereste	oscillereste
Generate the inflected form for: oscillare V;IND;FUT;NOM(1,SG)	oscillerò	oscillerò
Generate the inflected form for: oscillare V;IND;FUT;NOM(2,PL)	oscillerete	oscillerete
Generate the inflected form for: oscillare V;IND;FUT;NOM(3,PL)	oscilleranno	oscilleranno
Generate the inflected form for: oscillare V;IND;PRS;NOM(1,PL)	oscilliamo	oscilliamo
Generate the inflected form for: oscillare V;IND;PRS;NOM(1,SG)	oscillo	oscillo
Generate the inflected form for: oscillare V;IND;PRS;NOM(3,PL)	oscillano	oscillano
Generate the inflected form for: oscillare V;IND;PST;IPFV;NOM(1,PL)	oscillavamo	oscillavamo
Generate the inflected form for: oscillare V;IND;PST;IPFV;NOM(3,SG)	oscillava	oscillava
Generate the inflected form for: oscillare V;IND;PST;PFV;NOM(2,SG)	oscillasti	oscillasti
Generate the inflected form for: oscillare V;POS;IMP;NOM(3,PL)	oscillino	oscillino
Generate the inflected form for: oscillare V;POS;IMP;NOM(3,SG)	oscilli	oscilli
Generate the inflected form for: oscillare V;SBJV;PRS;NOM(1,PL)	oscilliamo	oscilliamo
Generate the inflected form for: oscillare V;SBJV;PRS;NOM(3,PL)	oscillino	oscillino
Generate the inflected form for: oscillare V;SBJV;PST;NOM(2,PL)	oscillaste	oscillaste
Generate the inflected form for: oscillare V;SBJV;PST;NOM(2,SG)	oscillassi	oscillassi
Generate the inflected form for: oscillare V;SBJV;PST;NOM(3,PL)	oscillassero	oscillassero
Generate the inflected form for: ossequiare V.CVB;PRS	ossequiando	ossequiando
Generate the inflected form for: ossequiare V.PTCP;PST	ossequiato	ossequiato
Generate the inflected form for: ossequiare V;COND;NOM(2,SG)	ossequeresti	ossequieresti
Generate the inflected form for: ossequiare V;IND;FUT;NOM(2,PL)	ossequerete	ossequierete
Generate the inflected form for: ossequiare V;IND;PRS;NOM(1,PL)	ossequiamo	ossequiamo
Generate the inflected form for: ossequiare V;IND;PRS;NOM(3,SG)	ossequi	ossequia
Generate the inflected form for: ossequiare V;IND;PST;IPFV;NOM(1,PL)	ossequiavamo	ossequiavamo
Generate the inflected form for: ossequiare V;IND;PST;IPFV;NOM(1,SG)	ossequiavo	ossequiavo
Generate the inflected form for: ossequiare V;IND;PST;IPFV;NOM(2,SG)	ossequiavi	ossequiavi
Generate the inflected form for: ossequiare V;IND;PST;IPFV;NOM(3,SG)	ossequiava	ossequiava
Generate the inflected form for: ossequiare V;IND;PST;PFV;NOM(1,PL)	ossequiammo	ossequiammo
Generate the inflected form for: ossequiare V;IND;PST;PFV;NOM(2,SG)	ossequiasti	ossequiasti
Generate the inflected form for: ossequiare V;POS;IMP;NOM(3,PL)	ossequino	ossequino
Generate the inflected form for: ossequiare V;SBJV;PRS;NOM(1,PL)	ossequiamo	ossequiamo
Generate the inflected form for: ossequiare V;SBJV;PRS;NOM(2,PL)	ossequiate	ossequiate
Generate the inflected form for: ossequiare V;SBJV;PRS;NOM(2,SG)	ossequi	ossequi
Generate the inflected form for: ossequiare V;SBJV;PRS;NOM(3,SG)	ossequi	ossequi
Generate the inflected form for: ossequiare V;SBJV;PST;NOM(2,PL)	ossequiaste	ossequiaste
Generate the inflected form for: ossequiare V;SBJV;PST;NOM(2,SG)	ossequiassi	ossequiassi
Generate the inflected form for: ossequiare V;SBJV;PST;NOM(3,SG)	ossequiasse	ossequiasse
Generate the inflected form for: preludiare V;COND;NOM(3,SG)	preludierebbe	preludierebbe
Generate the inflected form for: preludiare V;IND;FUT;NOM(3,PL)	preludieranno	preludieranno
Generate the inflected form for: preludiare V;IND;PRS;NOM(1,PL)	preludiamo	preludiamo
Generate the inflected form for: preludiare V;IND;PRS;NOM(2,PL)	preludiate	preludiate
Generate the inflected form for: preludiare V;IND;PRS;NOM(2,SG)	preludi	preludi
Generate the inflected form for: preludiare V;IND;PRS;NOM(3,SG)	preludi	preludia
Generate the inflected form for: preludiare V;IND;PST;IPFV;NOM(2,PL)	preludiavate	preludiavate
Generate the inflected form for: preludiare V;IND;PST;PFV;NOM(1,PL)	preludiammo	preludiammo
Generate the inflected form for: preludiare V;IND;PST;PFV;NOM(1,SG)	preludiai	preludiai
Generate the inflected form for: preludiare V;IND;PST;PFV;NOM(2,SG)	preludiasti	preludiasti
Generate the inflected form for: preludiare V;IND;PST;PFV;NOM(3,PL)	preludiarono	preludiarono
Generate the inflected form for: preludiare V;NFIN	preludiare	preludiare
Generate the inflected form for: preludiare V;POS;IMP;NOM(2,PL)	preludiate	preludiate
Generate the inflected form for: preludiare V;POS;IMP;NOM(3,PL)	preludino	preludino
Generate the inflected form for: preludiare V;POS;IMP;NOM(3,SG)	preludi	preludi
Generate the inflected form for: preludiare V;SBJV;PRS;NOM(1,SG)	preludi	preludi
Generate the inflected form for: preludiare V;SBJV;PRS;NOM(2,SG)	preludi	preludi
Generate the inflected form for: preludiare V;SBJV;PST;NOM(1,SG)	preludiassi	preludiassi
Generate the inflected form for: preludiare V;SBJV;PST;NOM(2,PL)	preludiaste	preludiaste
Generate the inflected form for: preludiare V;SBJV;PST;NOM(2,SG)	preludiassi	preludiassi
Generate the inflected form for: rabuffare V.PTCP;PRS	rabuffante	rabuffante
Generate the inflected form for: rabuffare V.PTCP;PST	rabuffato	rabuffato
Generate the inflected form for: rabuffare V;COND;NOM(2,PL)	rabuffereste	rabuffereste
Generate the inflected form for: rabuffare V;COND;NOM(2,SG)	rabufferesti	rabufferesti
Generate the inflected form for: rabuffare V;COND;NOM(3,SG)	rabufferebbe	rabufferebbe
Generate the inflected form for: rabuffare V;IND;FUT;NOM(2,PL)	rabufferete	rabufferete
Generate the inflected form for: rabuffare V;IND;FUT;NOM(2,SG)	rabufferai	rabufferai
Generate the inflected form for: rabuffare V;IND;PRS;NOM(1,SG)	rabuffo	rabuffo
Generate the inflected form for: rabuffare V;IND;PRS;NOM(2,PL)	rabuffate	rabuffate
Generate the inflected form for: rabuffare V;IND;PRS;NOM(2,SG)	rabuffi	rabuffi
Generate the inflected form for: rabuffare V;IND;PRS;NOM(3,SG)	rabuffa	rabuffa
Generate the inflected form for: rabuffare V;IND;PST;IPFV;NOM(1,PL)	rabuffavamo	rabuffavamo
Generate the inflected form for: rabuffare V;IND;PST;IPFV;NOM(2,PL)	rabuffavate	rabuffavate
Generate the inflected form for: rabuffare V;IND;PST;PFV;NOM(1,SG)	rabuffai	rabuffai
Generate the inflected form for: rabuffare V;POS;IMP;NOM(2,SG)	rabuffa	rabuffa
Generate the inflected form for: rabuffare V;POS;IMP;NOM(3,SG)	rabuffi	rabuffi
Generate the inflected form for: rabuffare V;SBJV;PRS;NOM(1,PL)	rabuffiamo	rabuffiamo
Generate the inflected form for: rabuffare V;SBJV;PRS;NOM(3,PL)	rabuffino	rabuffino
Generate the inflected form for: rabuffare V;SBJV;PST;NOM(1,SG)	rabuffassi	rabuffassi
Generate the inflected form for: rabuffare V;SBJV;PST;NOM(2,SG)	rabuffassi	rabuffassi
Generate the inflected form for: raccostare V.PTCP;PST	raccostato	raccostato
Generate the inflected form for: raccostare V;COND;NOM(2,PL)	raccostereste	raccostereste
Generate the inflected form for: raccostare V;IND;FUT;NOM(1,PL)	raccosteremo	raccosteremo
Generate the inflected form for: raccostare V;IND;FUT;NOM(2,PL)	raccosterete	raccosterete
Generate the inflected form for: raccostare V;IND;FUT;NOM(3,PL)	raccosteranno	raccosteranno
Generate the inflected form for: raccostare V;IND;FUT;NOM(3,SG)	raccosterà	raccosterà
Generate the inflected form for: raccostare V;IND;PRS;NOM(2,PL)	raccostate	raccostate
Generate the inflected form for: raccostare V;IND;PRS;NOM(2,SG)	raccosti	raccosti
Generate the inflected form for: raccostare V;IND;PST;IPFV;NOM(1,PL)	raccostavamo	raccostavamo
Generate the inflected form for: raccostare V;IND;PST;IPFV;NOM(1,SG)	raccostavo	raccostavo
Generate the inflected form for: raccostare V;IND;PST;PFV;NOM(1,PL)	raccostammo	raccostammo
Generate the inflected form for: raccostare V;IND;PST;PFV;NOM(1,SG)	raccostai	raccostai
Generate the inflected form for: raccostare V;IND;PST;PFV;NOM(2,PL)	raccostaste	raccostaste
Generate the inflected form for: raccostare V;NFIN	raccostare	raccostare
Generate the inflected form for: raccostare V;POS;IMP;NOM(1,PL)	raccostiamo	raccostiamo
Generate the inflected form for: raccostare V;POS;IMP;NOM(3,PL)	raccostino	raccostino
Generate the inflected form for: raccostare V;SBJV;PRS;NOM(2,PL)	raccostiate	raccostiate
Generate the inflected form for: raccostare V;SBJV;PRS;NOM(3,PL)	raccostino	raccostino
Generate the inflected form for: raccostare V;SBJV;PRS;NOM(3,SG)	raccosti	raccosti
Generate the inflected form for: raccostare V;SBJV;PST;NOM(3,PL)	raccostassero	raccostassero
Generate the inflected form for: riammalarsi V.PTCP;PRS	riammalantesi	riammalantesi
Generate the inflected form for: riammalarsi V.PTCP;PST	riammalato	riammalato
Generate the inflected form for: riammalarsi V;COND;NOM(2,PL)	vi riammalereste	vi riammalereste
Generate the inflected form for: riammalarsi V;COND;NOM(2,SG)	ti riammaleresti	ti riammaleresti
Generate the inflected form for: riammalarsi V;COND;NOM(3,SG)	si riammalerebbe	si riammalerebbe
Generate the inflected form for: riammalarsi V;IND;FUT;NOM(1,PL)	ci riammaleremo	ci riammaleremo
Generate the inflected form for: riammalarsi V;IND;FUT;NOM(1,SG)	mi riammalerò	mi riammalerò
Generate the inflected form for: riammalarsi V;IND;FUT;NOM(3,PL)	si riammaleranno	si riammaleranno
Generate the inflected form for: riammalarsi V;IND;FUT;NOM(3,SG)	si riammalerà	si riammalerà
Generate the inflected form for: riammalarsi V;IND;PRS;NOM(1,SG)	mi riammalo	mi riammalo
Generate the inflected form for: riammalarsi V;IND;PRS;NOM(3,SG)	si riammala	si riammala
Generate the inflected form for: riammalarsi V;IND;PST;IPFV;NOM(1,PL)	ci riammalavamo	ci riammalavamo
Generate the inflected form for: riammalarsi V;IND;PST;IPFV;NOM(1,SG)	mi riammalavo	mi riammalavo
Generate the inflected form for: riammalarsi V;IND;PST;PFV;NOM(1,PL)	ci riammalammo	ci riammalammo
Generate the inflected form for: riammalarsi V;IND;PST;PFV;NOM(1,SG)	mi riammalai	mi riammalai
Generate the inflected form for: riammalarsi V;IND;PST;PFV;NOM(3,SG)	si riammalò	si riammalò
Generate the inflected form for: riammalarsi V;POS;IMP;NOM(1,PL)	riammaliamoci	riammaliamoci
Generate the inflected form for: riammalarsi V;SBJV;PRS;NOM(1,SG)	mi riammali	mi riammali
Generate the inflected form for: riammalarsi V;SBJV;PST;NOM(1,PL)	ci riammalassimo	ci riammalassimo
Generate the inflected form for: riammalarsi V;SBJV;PST;NOM(2,PL)	vi riammalaste	vi riammalaste
Generate the inflected form for: rimangiarsi V;COND;NOM(1,PL)	ci rimangeremmo	ci rimangeremmo
Generate the inflected form for: rimangiarsi V;COND;NOM(2,SG)	ti rimangeresti	ti rimangeresti
Generate the inflected form for: rimangiarsi V;IND;FUT;NOM(2,PL)	vi rimangerete	vi rimangerete
Generate the inflected form for: rimangiarsi V;IND;FUT;NOM(2,SG)	ti rimangerai	ti rimangerai
Generate the inflected form for: rimangiarsi V;IND;FUT;NOM(3,PL)	si rimangeranno	si rimangeranno
Generate the inflected form for: rimangiarsi V;IND;PRS;NOM(3,SG)	si rimangi	si rimangia
Generate the inflected form for: rimangiarsi V;IND;PST;IPFV;NOM(1,PL)	ci rimangiavamo	ci rimangiavamo
Generate the inflected form for: rimangiarsi V;IND;PST;IPFV;NOM(3,SG)	si rimangiava	si rimangiava
Generate the inflected form for: rimangiarsi V;IND;PST;PFV;NOM(2,SG)	ti rimangiasti	ti rimangiasti
Generate the inflected form for: rimangiarsi V;IND;PST;PFV;NOM(3,PL)	si rimangiarono	si rimangiarono
Generate the inflected form for: rimangiarsi V;IND;PST;PFV;NOM(3,SG)	si rimangò	si rimangiò
Generate the inflected form for: rimangiarsi V;NFIN	rimangiarsi	rimangiarsi
Generate the inflected form for: rimangiarsi V;POS;IMP;NOM(2,PL)	rimangiatevi	rimangiatevi
Generate the inflected form for: rimangiarsi V;POS;IMP;NOM(3,SG)	si rimangi	si rimangi
Generate the inflected form for: rimangiarsi V;SBJV;PRS;NOM(1,PL)	ci rimangiamo	ci rimangiamo
Generate the inflected form for: rimangiarsi V;SBJV;PRS;NOM(2,SG)	ti rimangi	ti rimangi
Generate the inflected form for: rimangiarsi V;SBJV;PRS;NOM(3,SG)	si rimangi	si rimangi
Generate the inflected form for: rimangiarsi V;SBJV;PST;NOM(1,PL)	ci rimangiassimo	ci rimangiassimo
Generate the inflected form for: rimangiarsi V;SBJV;PST;NOM(2,SG)	ti rimangiassi	ti rimangiassi
Generate the inflected form for: rimangiarsi V;SBJV;PST;NOM(3,PL)	si rimangiassero	si rimangiassero
Generate the inflected form for: rimbeccare V;COND;NOM(1,SG)	rimbeccherei	rimbeccherei
Generate the inflected form for: rimbeccare V;COND;NOM(3,PL)	rimbeccherebbero	rimbeccherebbero
Generate the inflected form for: rimbeccare V;IND;FUT;NOM(2,PL)	rimbeccherete	rimbeccherete
Generate the inflected form for: rimbeccare V;IND;FUT;NOM(3,PL)	rimbeccheranno	rimbeccheranno
Generate the inflected form for: rimbeccare V;IND;PRS;NOM(3,PL)	rimbeccano	rimbeccano
Generate the inflected form for: rimbeccare V;IND;PRS;NOM(3,SG)	rimbecca	rimbecca
Generate the inflected form for: rimbeccare V;IND;PST;IPFV;NOM(1,PL)	rimbeccavamo	rimbeccavamo
Generate the inflected form for: rimbeccare V;IND;PST;IPFV;NOM(2,SG)	rimbeccavi	rimbeccavi
Generate the inflected form for: rimbeccare V;IND;PST;PFV;NOM(2,SG)	rimbeccasti	rimbeccasti
Generate the inflected form for: rimbeccare V;IND;PST;PFV;NOM(3,PL)	rimbeccarono	rimbeccarono
Generate the inflected form for: rimbeccare V;POS;IMP;NOM(1,PL)	rimbecchiamo	rimbecchiamo
Generate the inflected form for: rimbeccare V;POS;IMP;NOM(3,SG)	rimbecchi	rimbecchi
Generate the inflected form for: rimbeccare V;SBJV;PRS;NOM(1,SG)	rimbecchi	rimbecchi
Generate the inflected form for: rimbeccare V;SBJV;PRS;NOM(2,PL)	rimbecchiate	rimbecchiate
Generate the inflected form for: rimbeccare V;SBJV;PRS;NOM(2,SG)	rimbecchi	rimbecchi
Generate the inflected form for: rimbeccare V;SBJV;PRS;NOM(3,PL)	rimbecchino	rimbecchino
Generate the inflected form for: rimbeccare V;SBJV;PRS;NOM(3,SG)	rimbecchi	rimbecchi
Generate the inflected form for: rimbeccare V;SBJV;PST;NOM(1,SG)	rimbeccassi	rimbeccassi
Generate the inflected form for: rimbeccare V;SBJV;PST;NOM(2,PL)	rimbeccaste	rimbeccaste
Generate the inflected form for: rimbeccare V;SBJV;PST;NOM(3,PL)	rimbeccassero	rimbeccassero
Generate the inflected form for: rintorpidire V.CVB;PRS	rintorpidendo	rintorpidendo
Generate the inflected form for: rintorpidire V.PTCP;PRS	rintorpidente	rintorpidente
Generate the inflected form for: rintorpidire V;COND;NOM(2,PL)	rintorpidireste	rintorpidireste
Generate the inflected form for: rintorpidire V;COND;NOM(2,SG)	rintorpidiresti	rintorpidiresti
Generate the inflected form for: rintorpidire V;COND;NOM(3,SG)	rintorpidirebbe	rintorpidirebbe
Generate the inflected form for: rintorpidire V;IND;FUT;NOM(1,PL)	rintorpidiremo	rintorpidiremo
Generate the inflected form for: rintorpidire V;IND;FUT;NOM(1,SG)	rintorpidirò	rintorpidirò
Generate the inflected form for: rintorpidire V;IND;PRS;NOM(2,PL)	rintorpidite	rintorpidite
Generate the inflected form for: rintorpidire V;IND;PRS;NOM(3,PL)	rintorpidiscono	rintorpidiscono
Generate the inflected form for: rintorpidire V;IND;PST;IPFV;NOM(1,SG)	rintorpidivo	rintorpidivo
Generate the inflected form for: rintorpidire V;IND;PST;IPFV;NOM(3,PL)	rintorpidivano	rintorpidivano
Generate the inflected form for: rintorpidire V;IND;PST;IPFV;NOM(3,SG)	rintorpidiva	rintorpidiva
Generate the inflected form for: rintorpidire V;IND;PST;PFV;NOM(1,SG)	rintorpidii	rintorpidii
Generate the inflected form for: rintorpidire V;IND;PST;PFV;NOM(2,PL)	rintorpidiste	rintorpidiste
Generate the inflected form for: rintorpidire V;IND;PST;PFV;NOM(2,SG)	rintorpidisti	rintorpidisti
Generate the inflected form for: rintorpidire V;NFIN	rintorpidire	rintorpidire
Generate the inflected form for: rintorpidire V;POS;IMP;NOM(2,SG)	rintorpidisci	rintorpidisci
Generate the inflected form for: rintorpidire V;SBJV;PRS;NOM(1,PL)	rintorpidiamo	rintorpidiamo
Generate the inflected form for: rintorpidire V;SBJV;PRS;NOM(3,SG)	rintorpidisca	rintorpidisca
Generate the inflected form for: rintorpidire V;SBJV;PST;NOM(1,SG)	rintorpidissi	rintorpidissi
Generate the inflected form for: rinvestire V.PTCP;PRS	rinvestente	rinvestente
Generate the inflected form for: rinvestire V.PTCP;PST	rinvestito	rinvestito
Generate the inflected form for: rinvestire V;COND;NOM(3,PL)	rinvestirebbero	rinvestirebbero
Generate the inflected form for: rinvestire V;IND;FUT;NOM(1,PL)	rinvestiremo	rinvestiremo
Generate the inflected form for: rinvestire V;IND;FUT;NOM(1,SG)	rinvestirò	rinvestirò
Generate the inflected form for: rinvestire V;IND;FUT;NOM(2,SG)	rinvestirai	rinvestirai
Generate the inflected form for: rinvestire V;IND;PRS;NOM(1,PL)	rinvestiamo	rinvestiamo
Generate the inflected form for: rinvestire V;IND;PRS;NOM(1,SG)	rinvesto	rinvesto
Generate the inflected form for: rinvestire V;IND;PRS;NOM(2,PL)	rinvestite	rinvestite
Generate the inflected form for: rinvestire V;IND;PRS;NOM(3,SG)	rinvestisce	rinveste
Generate the inflected form for: rinvestire V;IND;PST;IPFV;NOM(3,PL)	rinvestivano	rinvestivano
Generate the inflected form for: rinvestire V;IND;PST;PFV;NOM(1,SG)	rinvestii	rinvestii
Generate the inflected form for: rinvestire V;IND;PST;PFV;NOM(3,PL)	rinvestirono	rinvestirono
Generate the inflected form for: rinvestire V;IND;PST;PFV;NOM(3,SG)	rinvestì	rinvestì
Generate the inflected form for: rinvestire V;NFIN	rinvestire	rinvestire
Generate the inflected form for: rinvestire V;SBJV;PRS;NOM(1,PL)	rinvestiamo	rinvestiamo
Generate the inflected form for: rinvestire V;SBJV;PRS;NOM(2,PL)	rinvestiate	rinvestiate
Generate the inflected form for: rinvestire V;SBJV;PRS;NOM(3,PL)	rinvestiscano	rinvestano
Generate the inflected form for: rinvestire V;SBJV;PST;NOM(3,PL)	rinvestissero	rinvestissero
Generate the inflected form for: rinvestire V;SBJV;PST;NOM(3,SG)	rinvestisse	rinvestisse
Generate the inflected form for: ripercuotersi V.CVB;PRS	ripercuotendosi	ripercotendosi
Generate the inflected form for: ripercuotersi V.PTCP;PRS	ripercuotentesi	ripercotentesi
Generate the inflected form for: ripercuotersi V.PTCP;PST	ripercuoto	ripercosso
Generate the inflected form for: ripercuotersi V;COND;NOM(1,SG)	mi ripercuoterei	mi ripercoterei
Generate the inflected form for: ripercuotersi V;COND;NOM(3,PL)	si ripercuoterebbero	si ripercoterebbero
Generate the inflected form for: ripercuotersi V;IND;FUT;NOM(1,PL)	ci ripercuoteremo	ci ripercoteremo
Generate the inflected form for: ripercuotersi V;IND;PRS;NOM(1,PL)	ci ripercuotiamo	ci ripercotiamo
Generate the inflected form for: ripercuotersi V;IND;PRS;NOM(1,SG)	mi ripercuoto	mi ripercuoto
Generate the inflected form for: ripercuotersi V;IND;PRS;NOM(2,SG)	ti ripercuoti	ti ripercuoti
Generate the inflected form for: ripercuotersi V;IND;PRS;NOM(3,PL)	si ripercuotano	si ripercuotono
Generate the inflected form for: ripercuotersi V;IND;PST;IPFV;NOM(1,SG)	mi ripercuotevo	mi ripercotevo
Generate the inflected form for: ripercuotersi V;IND;PST;PFV;NOM(1,PL)	ci ripercuotemmo	ci ripercotemmo
Generate the inflected form for: ripercuotersi V;IND;PST;PFV;NOM(1,SG)	mi ripercuoti	mi ripercossi
Generate the inflected form for: ripercuotersi V;IND;PST;PFV;NOM(3,PL)	si ripercuoterono	si ripercossero
Generate the inflected form for: ripercuotersi V;POS;IMP;NOM(1,PL)	ripercuotiamoci	ripercotiamoci
Generate the inflected form for: ripercuotersi V;POS;IMP;NOM(3,PL)	si ripercuotino	si ripercuotano
Generate the inflected form for: ripercuotersi V;POS;IMP;NOM(3,SG)	si ripercuoti	si ripercuota
Generate the inflected form for: ripercuotersi V;SBJV;PRS;NOM(2,SG)	ti ripercuota	ti ripercuota
Generate the inflected form for: ripercuotersi V;SBJV;PST;NOM(1,PL)	ci ripercuotessimo	ci ripercotessimo
Generate the inflected form for: ripercuotersi V;SBJV;PST;NOM(1,SG)	mi ripercuotessi	mi ripercotessi
Generate the inflected form for: sbandierare V;COND;NOM(2,SG)	sbandiereresti	sbandiereresti
Generate the inflected form for: sbandierare V;COND;NOM(3,PL)	sbandiererebbero	sbandiererebbero
Generate the inflected form for: sbandierare V;COND;NOM(3,SG)	sbandiererebbe	sbandiererebbe
Generate the inflected form for: sbandierare V;IND;FUT;NOM(1,PL)	sbandiereremo	sbandiereremo
Generate the inflected form for: sbandierare V;IND;FUT;NOM(1,SG)	sbandiererò	sbandiererò
Generate the inflected form for: sbandierare V;IND;FUT;NOM(3,PL)	sbandiereranno	sbandiereranno
Generate the inflected form for: sbandierare V;IND;PRS;NOM(1,PL)	sbandieriamo	sbandieriamo
Generate the inflected form for: sbandierare V;IND;PST;IPFV;NOM(1,SG)	sbandieravo	sbandieravo
Generate the inflected form for: sbandierare V;IND;PST;IPFV;NOM(3,PL)	sbandieravano	sbandieravano
Generate the inflected form for: sbandierare V;IND;PST;PFV;NOM(1,SG)	sbandierai	sbandierai
Generate the inflected form for: sbandierare V;IND;PST;PFV;NOM(3,PL)	sbandierarono	sbandierarono
Generate the inflected form for: sbandierare V;POS;IMP;NOM(2,PL)	sbandierate	sbandierate
Generate the inflected form for: sbandierare V;POS;IMP;NOM(3,PL)	sbandierino	sbandierino
Generate the inflected form for: sbandierare V;POS;IMP;NOM(3,SG)	sbandieri	sbandieri
Generate the inflected form for: sbandierare V;SBJV;PRS;NOM(1,PL)	sbandieriamo	sbandieriamo
Generate the inflected form for: sbandierare V;SBJV;PRS;NOM(1,SG)	sbandieri	sbandieri
Generate the inflected form for: sbandierare V;SBJV;PRS;NOM(2,SG)	sbandieri	sbandieri
Generate the inflected form for: sbandierare V;SBJV;PRS;NOM(3,PL)	sbandierino	sbandierino
Generate the inflected form for: sbandierare V;SBJV;PST;NOM(3,PL)	sbandierassero	sbandierassero
Generate the inflected form for: sbandierare V;SBJV;PST;NOM(3,SG)	sbandierasse	sbandierasse
Generate the inflected form for: scannare V.CVB;PRS	scannando	scannando
Generate the inflected form for: scannare V.PTCP;PST	scannato	scannato
Generate the inflected form for: scannare V;COND;NOM(1,SG)	scannerei	scannerei
Generate the inflected form for: scannare V;IND;FUT;NOM(1,PL)	scanneremo	scanneremo
Generate the inflected form for: scannare V;IND;FUT;NOM(1,SG)	scannerò	scannerò
Generate the inflected form for: scannare V;IND;FUT;NOM(3,SG)	scannerà	scannerà
Generate the inflected form for: scannare V;IND;PRS;NOM(1,PL)	scanniamo	scanniamo
Generate the inflected form for: scannare V;IND;PRS;NOM(1,SG)	scanno	scanno
Generate the inflected form for: scannare V;IND;PRS;NOM(2,PL)	scannate	scannate
Generate the inflected form for: scannare V;IND;PRS;NOM(3,SG)	scanna	scanna
Generate the inflected form for: scannare V;IND;PST;IPFV;NOM(2,PL)	scannavate	scannavate
Generate the inflected form for: scannare V;IND;PST;IPFV;NOM(2,SG)	scannavi	scannavi
Generate the inflected form for: scannare V;IND;PST;IPFV;NOM(3,SG)	scannava	scannava
Generate the inflected form for: scannare V;IND;PST;PFV;NOM(2,SG)	scannasti	scannasti
Generate the inflected form for: scannare V;IND;PST;PFV;NOM(3,SG)	scannò	scannò
Generate the inflected form for: scannare V;POS;IMP;NOM(3,SG)	scanni	scanni
Generate the inflected form for: scannare V;SBJV;PRS;NOM(1,SG)	scanni	scanni
Generate the inflected form for: scannare V;SBJV;PRS;NOM(2,PL)	scanniate	scanniate
Generate the inflected form for: scannare V;SBJV;PRS;NOM(3,PL)	scannino	scannino
Generate the inflected form for: scannare V;SBJV;PST;NOM(2,SG)	scannassi	scannassi
Generate the inflected form for: sconcertare V.CVB;PRS	sconcertando	sconcertando
Generate the inflected form for: sconcertare V;COND;NOM(1,PL)	sconcerteremmo	sconcerteremmo
Generate the inflected form for: sconcertare V;COND;NOM(2,SG)	sconcerteresti	sconcerteresti
Generate the inflected form for: sconcertare V;COND;NOM(3,PL)	sconcerterebbero	sconcerterebbero
Generate the inflected form for: sconcertare V;IND;FUT;NOM(1,SG)	sconcerterò	sconcerterò
Generate the inflected form for: sconcertare V;IND;FUT;NOM(3,SG)	sconcerterà	sconcerterà
Generate the inflected form for: sconcertare V;IND;PRS;NOM(1,SG)	sconcerto	sconcerto
Generate the inflected form for: sconcertare V;IND;PRS;NOM(2,SG)	sconcerti	sconcerti
Generate the inflected form for: sconcertare V;IND;PRS;NOM(3,SG)	sconcerta	sconcerta
Generate the inflected form for: sconcertare V;IND;PST;PFV;NOM(2,PL)	sconcertaste	sconcertaste
Generate the inflected form for: sconcertare V;IND;PST;PFV;NOM(2,SG)	sconcertasti	sconcertasti
Generate the inflected form for: sconcertare V;IND;PST;PFV;NOM(3,PL)	sconcertarono	sconcertarono
Generate the inflected form for: sconcertare V;POS;IMP;NOM(2,PL)	sconcertate	sconcertate
Generate the inflected form for: sconcertare V;POS;IMP;NOM(2,SG)	sconcerta	sconcerta
Generate the inflected form for: sconcertare V;SBJV;PRS;NOM(1,PL)	sconcertiamo	sconcertiamo
Generate the inflected form for: sconcertare V;SBJV;PRS;NOM(2,PL)	sconcertiate	sconcertiate
Generate the inflected form for: sconcertare V;SBJV;PRS;NOM(2,SG)	sconcerti	sconcerti
Generate the inflected form for: sconcertare V;SBJV;PRS;NOM(3,PL)	sconcertino	sconcertino
Generate the inflected form for: sconcertare V;SBJV;PST;NOM(2,SG)	sconcertassi	sconcertassi
Generate the inflected form for: sconcertare V;SBJV;PST;NOM(3,SG)	sconcertasse	sconcertasse
Generate the inflected form for: seminare V.CVB;PRS	seminando	seminando
Generate the inflected form for: seminare V;COND;NOM(1,SG)	seminerei	seminerei
Generate the inflected form for: seminare V;COND;NOM(2,PL)	seminereste	seminereste
Generate the inflected form for: seminare V;COND;NOM(2,SG)	semineresti	semineresti
Generate the inflected form for: seminare V;IND;FUT;NOM(1,PL)	semineremo	semineremo
Generate the inflected form for: seminare V;IND;FUT;NOM(2,SG)	seminerai	seminerai
Generate the inflected form for: seminare V;IND;FUT;NOM(3,SG)	seminerà	seminerà
Generate the inflected form for: seminare V;IND;PRS;NOM(1,PL)	seminiamo	seminiamo
Generate the inflected form for: seminare V;IND;PRS;NOM(1,SG)	semino	semino
Generate the inflected form for: seminare V;IND;PRS;NOM(3,PL)	seminano	seminano
Generate the inflected form for: seminare V;IND;PST;IPFV;NOM(2,PL)	seminavate	seminavate
Generate the inflected form for: seminare V;IND;PST;IPFV;NOM(3,PL)	seminavano	seminavano
Generate the inflected form for: seminare V;IND;PST;PFV;NOM(1,PL)	seminammo	seminammo
Generate the inflected form for: seminare V;IND;PST;PFV;NOM(2,SG)	seminasti	seminasti
Generate the inflected form for: seminare V;NFIN	seminare	seminare
Generate the inflected form for: seminare V;POS;IMP;NOM(2,PL)	seminate	seminate
Generate the inflected form for: seminare V;POS;IMP;NOM(3,PL)	seminino	seminino
Generate the inflected form for: seminare V;SBJV;PRS;NOM(2,PL)	seminiate	seminiate
Generate the inflected form for: seminare V;SBJV;PST;NOM(3,PL)	seminassero	seminassero
Generate the inflected form for: seminare V;SBJV;PST;NOM(3,SG)	seminasse	seminasse
Generate the inflected form for: servire V.CVB;PRS	servendo	servendo
Generate the inflected form for: servire V.PTCP;PST	servito	servito
Generate the inflected form for: servire V;COND;NOM(1,SG)	servirei	servirei
Generate the inflected form for: servire V;COND;NOM(2,PL)	servireste	servireste
Generate the inflected form for: servire V;COND;NOM(3,SG)	servirebbe	servirebbe
Generate the inflected form for: servire V;IND;FUT;NOM(2,SG)	servirai	servirai
Generate the inflected form for: servire V;IND;FUT;NOM(3,PL)	serviranno	serviranno
Generate the inflected form for: servire V;IND;PRS;NOM(1,PL)	serviamo	serviamo
Generate the inflected form for: servire V;IND;PRS;NOM(2,PL)	servite	servite
Generate the inflected form for: servire V;IND;PST;IPFV;NOM(2,SG)	servivi	servivi
Generate the inflected form for: servire V;IND;PST;IPFV;NOM(3,PL)	servivano	servivano
Generate the inflected form for: servire V;IND;PST;PFV;NOM(3,PL)	servirono	servirono
Generate the inflected form for: servire V;IND;PST;PFV;NOM(3,SG)	servì	servì
Generate the inflected form for: servire V;NFIN	servire	servire
Generate the inflected form for: servire V;POS;IMP;NOM(2,PL)	servite	servite
Generate the inflected form for: servire V;POS;IMP;NOM(3,PL)	serviscano	servano
Generate the inflected form for: servire V;SBJV;PRS;NOM(1,SG)	servisca	serva
Generate the inflected form for: servire V;SBJV;PRS;NOM(3,SG)	servisca	serva
Generate the inflected form for: servire V;SBJV;PST;NOM(1,SG)	servissi	servissi
Generate the inflected form for: servire V;SBJV;PST;NOM(2,SG)	servissi	servissi
Generate the inflected form for: servoassistere V.CVB;PRS	servoassistendo	servoassistendo
Generate the inflected form for: servoassistere V;COND;NOM(1,PL)	servoassisteremmo	servoassisteremmo
Generate the inflected form for: servoassistere V;COND;NOM(2,SG)	servoassisteresti	servoassisteresti
Generate the inflected form for: servoassistere V;COND;NOM(3,PL)	servoassisterebbero	servoassisterebbero
Generate the inflected form for: servoassistere V;IND;FUT;NOM(1,PL)	servoassisteremo	servoassisteremo
Generate the inflected form for: servoassistere V;IND;FUT;NOM(2,PL)	servoassisterete	servoassisterete
Generate the inflected form for: servoassistere V;IND;FUT;NOM(3,PL)	servoassisteranno	servoassisteranno
Generate the inflected form for: servoassistere V;IND;PRS;NOM(2,SG)	servoassisti	servoassisti
Generate the inflected form for: servoassistere V;IND;PST;PFV;NOM(1,PL)	servoassistemmo	servoassistemmo
Generate the inflected form for: servoassistere V;IND;PST;PFV;NOM(3,PL)	servoassisterono	servoassistettero
Generate the inflected form for: servoassistere V;NFIN	servoassistere	servoassistere
Generate the inflected form for: servoassistere V;POS;IMP;NOM(1,PL)	servoassistiamo	servoassistiamo
Generate the inflected form for: servoassistere V;POS;IMP;NOM(3,PL)	servoassistino	servoassistano
Generate the inflected form for: servoassistere V;POS;IMP;NOM(3,SG)	servoassisti	servoassista
Generate the inflected form for: servoassistere V;SBJV;PRS;NOM(1,PL)	servoassistiamo	servoassistiamo
Generate the inflected form for: servoassistere V;SBJV;PRS;NOM(2,PL)	servoassistiate	servoassistiate
Generate the inflected form for: servoassistere V;SBJV;PRS;NOM(3,PL)	servoassistano	servoassistano
Generate the inflected form for: servoassistere V;SBJV;PST;NOM(1,SG)	servoassistessi	servoassistessi
Generate the inflected form for: servoassistere V;SBJV;PST;NOM(2,PL)	servoassisteste	servoassisteste
Generate the inflected form for: servoassistere V;SBJV;PST;NOM(2,SG)	servoassistessi	servoassistessi
Generate the inflected form for: sfaldarsi V.CVB;PRS	sfaldandosi	sfaldandosi
Generate the inflected form for: sfaldarsi V.PTCP;PRS	sfaldantesi	sfaldantesi
Generate the inflected form for: sfaldarsi V.PTCP;PST	sfaldato	sfaldato
Generate the inflected form for: sfaldarsi V;COND;NOM(1,PL)	ci sfalderemmo	ci sfalderemmo
Generate the inflected form for: sfaldarsi V;COND;NOM(2,PL)	vi sfaldereste	vi sfaldereste
Generate the inflected form for: sfaldarsi V;COND;NOM(3,PL)	si sfalderebbero	si sfalderebbero
Generate the inflected form for: sfaldarsi V;COND;NOM(3,SG)	si sfalderebbe	si sfalderebbe
Generate the inflected form for: sfaldarsi V;IND;FUT;NOM(2,PL)	vi sfalderete	vi sfalderete
Generate the inflected form for: sfaldarsi V;IND;FUT;NOM(2,SG)	ti sfalderai	ti sfalderai
Generate the inflected form for: sfaldarsi V;IND;FUT;NOM(3,SG)	si sfalderà	si sfalderà
Generate the inflected form for: sfaldarsi V;IND;PRS;NOM(3,SG)	si sfalda	si sfalda
Generate the inflected form for: sfaldarsi V;IND;PST;PFV;NOM(2,PL)	vi sfaldaste	vi sfaldaste
Generate the inflected form for: sfaldarsi V;NFIN	sfaldarsi	sfaldarsi
Generate the inflected form for: sfaldarsi V;POS;IMP;NOM(2,PL)	sfaldatevi	sfaldatevi
Generate the inflected form for: sfaldarsi V;SBJV;PRS;NOM(1,SG)	mi sfaldi	mi sfaldi
Generate the inflected form for: sfaldarsi V;SBJV;PRS;NOM(2,SG)	ti sfaldi	ti sfaldi
Generate the inflected form for: sfaldarsi V;SBJV;PRS;NOM(3,PL)	si sfaldino	si sfaldino
Generate the inflected form for: sfaldarsi V;SBJV;PRS;NOM(3,SG)	si sfaldi	si sfaldi
Generate the inflected form for: sfaldarsi V;SBJV;PST;NOM(2,SG)	ti sfaldassi	ti sfaldassi
Generate the inflected form for: sfaldarsi V;SBJV;PST;NOM(3,PL)	si sfaldassero	si sfaldassero
Generate the inflected form for: sognarsi V.CVB;PRS	sognandosi	sognandosi
Generate the inflected form for: sognarsi V;COND;NOM(1,SG)	mi sognerei	mi sognerei
Generate the inflected form for: sognarsi V;COND;NOM(2,PL)	vi sognereste	vi sognereste
Generate the inflected form for: sognarsi V;IND;FUT;NOM(2,PL)	vi sognerete	vi sognerete
Generate the inflected form for: sognarsi V;IND;PRS;NOM(1,PL)	ci sogniamo	ci sogniamo
Generate the inflected form for: sognarsi V;IND;PST;IPFV;NOM(1,PL)	ci sognavamo	ci sognavamo
Generate the inflected form for: sognarsi V;IND;PST;IPFV;NOM(3,PL)	si sognavano	si sognavano
Generate the inflected form for: sognarsi V;IND;PST;IPFV;NOM(3,SG)	si sognava	si sognava
Generate the inflected form for: sognarsi V;IND;PST;PFV;NOM(1,SG)	mi sognai	mi sognai
Generate the inflected form for: sognarsi V;IND;PST;PFV;NOM(2,SG)	ti sognasti	ti sognasti
Generate the inflected form for: sognarsi V;IND;PST;PFV;NOM(3,PL)	si sognarono	si sognarono
Generate the inflected form for: sognarsi V;IND;PST;PFV;NOM(3,SG)	si sognò	si sognò
Generate the inflected form for: sognarsi V;POS;IMP;NOM(2,SG)	sognati	sognati
Generate the inflected form for: sognarsi V;POS;IMP;NOM(3,PL)	sognino	si sognino
Generate the inflected form for: sognarsi V;POS;IMP;NOM(3,SG)	sogni	si sogni
Generate the inflected form for: sognarsi V;SBJV;PRS;NOM(2,SG)	ti sogni	ti sogni
Generate the inflected form for: sognarsi V;SBJV;PRS;NOM(3,SG)	si sogni	si sogni
Generate the inflected form for: sognarsi V;SBJV;PST;NOM(1,PL)	ci sognassimo	ci sognassimo
Generate the inflected form for: sognarsi V;SBJV;PST;NOM(3,PL)	si sognassero	si sognassero
Generate the inflected form for: sognarsi V;SBJV;PST;NOM(3,SG)	si sognasse	si sognasse
Generate the inflected form for: strofinarsi V.CVB;PRS	strofinandosi	strofinandosi
Generate the inflected form for: strofinarsi V.PTCP;PRS	strofinantesi	strofinantesi
Generate the inflected form for: strofinarsi V;COND;NOM(3,PL)	si strofinerebbero	si strofinerebbero
Generate the inflected form for: strofinarsi V;COND;NOM(3,SG)	si strofinerebbe	si strofinerebbe
Generate the inflected form for: strofinarsi V;IND;FUT;NOM(1,PL)	ci strofineremo	ci strofineremo
Generate the inflected form for: strofinarsi V;IND;FUT;NOM(1,SG)	mi strofinerò	mi strofinerò
Generate the inflected form for: strofinarsi V;IND;FUT;NOM(2,PL)	vi strofinerete	vi strofinerete
Generate the inflected form for: strofinarsi V;IND;PRS;NOM(1,SG)	mi strofino	mi strofino
Generate the inflected form for: strofinarsi V;IND;PRS;NOM(2,PL)	vi strofinate	vi strofinate
Generate the inflected form for: strofinarsi V;IND;PST;IPFV;NOM(1,PL)	ci strofinavamo	ci strofinavamo
Generate the inflected form for: strofinarsi V;IND;PST;IPFV;NOM(1,SG)	mi strofinavo	mi strofinavo
Generate the inflected form for: strofinarsi V;IND;PST;IPFV;NOM(2,SG)	ti strofinavi	ti strofinavi
Generate the inflected form for: strofinarsi V;IND;PST;IPFV;NOM(3,PL)	si strofinavano	si strofinavano
Generate the inflected form for: strofinarsi V;POS;IMP;NOM(1,PL)	strofiniamoci	strofiniamoci
Generate the inflected form for: strofinarsi V;POS;IMP;NOM(2,PL)	strofinatevi	strofinatevi
Generate the inflected form for: strofinarsi V;POS;IMP;NOM(2,SG)	strofinati	strofinati
Generate the inflected form for: strofinarsi V;SBJV;PRS;NOM(1,SG)	mi strofini	mi strofini
Generate the inflected form for: strofinarsi V;SBJV;PRS;NOM(2,SG)	ti strofini	ti strofini
Generate the inflected form for: strofinarsi V;SBJV;PRS;NOM(3,SG)	si strofini	si strofini
Generate the inflected form for: strofinarsi V;SBJV;PST;NOM(2,SG)	ti strofinassi	ti strofinassi
Generate the inflected form for: sussumere V;COND;NOM(2,SG)	sussumeresti	sussumeresti
Generate the inflected form for: sussumere V;IND;FUT;NOM(1,SG)	sussumerò	sussumerò
Generate the inflected form for: sussumere V;IND;FUT;NOM(3,SG)	sussumerà	sussumerà
Generate the inflected form for: sussumere V;IND;PRS;NOM(1,PL)	sussumiamo	sussumiamo
Generate the inflected form for: sussumere V;IND;PRS;NOM(1,SG)	sussumo	sussumo
Generate the inflected form for: sussumere V;IND;PRS;NOM(2,PL)	sussumete	sussumete
Generate the inflected form for: sussumere V;IND;PRS;NOM(3,PL)	sussumano	sussumono
Generate the inflected form for: sussumere V;IND;PST;PFV;NOM(1,PL)	sussumemmo	sussumemmo
Generate the inflected form for: sussumere V;IND;PST;PFV;NOM(2,SG)	sussumesti	sussumesti
Generate the inflected form for: sussumere V;IND;PST;PFV;NOM(3,SG)	sussuì	sussunse
Generate the inflected form for: sussumere V;NFIN	sussumere	sussumere
Generate the inflected form for: sussumere V;POS;IMP;NOM(3,PL)	sussumano	sussumano
Generate the inflected form for: sussumere V;SBJV;PRS;NOM(1,PL)	sussumiamo	sussumiamo
Generate the inflected form for: sussumere V;SBJV;PRS;NOM(1,SG)	sussuma	sussuma
Generate the inflected form for: sussumere V;SBJV;PRS;NOM(2,PL)	sussumiate	sussumiate
Generate the inflected form for: sussumere V;SBJV;PRS;NOM(2,SG)	sussuma	sussuma
Generate the inflected form for: sussumere V;SBJV;PST;NOM(1,PL)	sussumessimo	sussumessimo
Generate the inflected form for: sussumere V;SBJV;PST;NOM(1,SG)	sussumessi	sussumessi
Generate the inflected form for: sussumere V;SBJV;PST;NOM(2,PL)	sussumeste	sussumeste
Generate the inflected form for: sussumere V;SBJV;PST;NOM(3,PL)	sussumessero	sussumessero
Generate the inflected form for: sviscerare V;COND;NOM(1,SG)	sviscererei	sviscererei
Generate the inflected form for: sviscerare V;COND;NOM(2,PL)	sviscerereste	sviscerereste
Generate the inflected form for: sviscerare V;IND;FUT;NOM(1,SG)	sviscererò	sviscererò
Generate the inflected form for: sviscerare V;IND;FUT;NOM(2,SG)	sviscererai	sviscererai
Generate the inflected form for: sviscerare V;IND;PRS;NOM(1,PL)	svisceriamo	svisceriamo
Generate the inflected form for: sviscerare V;IND;PRS;NOM(2,SG)	svisceri	svisceri
Generate the inflected form for: sviscerare V;IND;PRS;NOM(3,PL)	sviscerano	sviscerano
Generate the inflected form for: sviscerare V;IND;PRS;NOM(3,SG)	sviscera	sviscera
Generate the inflected form for: sviscerare V;IND;PST;IPFV;NOM(2,PL)	svisceravate	svisceravate
Generate the inflected form for: sviscerare V;IND;PST;IPFV;NOM(3,PL)	svisceravano	svisceravano
Generate the inflected form for: sviscerare V;IND;PST;PFV;NOM(2,PL)	svisceraste	svisceraste
Generate the inflected form for: sviscerare V;IND;PST;PFV;NOM(3,PL)	sviscerarono	sviscerarono
Generate the inflected form for: sviscerare V;IND;PST;PFV;NOM(3,SG)	sviscerò	sviscerò
Generate the inflected form for: sviscerare V;POS;IMP;NOM(1,PL)	svisceriamo	svisceriamo
Generate the inflected form for: sviscerare V;POS;IMP;NOM(3,PL)	sviscerino	sviscerino
Generate the inflected form for: sviscerare V;POS;IMP;NOM(3,SG)	svisceri	svisceri
Generate the inflected form for: sviscerare V;SBJV;PRS;NOM(1,PL)	svisceriamo	svisceriamo
Generate the inflected form for: sviscerare V;SBJV;PRS;NOM(3,PL)	sviscerino	sviscerino
Generate the inflected form for: sviscerare V;SBJV;PRS;NOM(3,SG)	svisceri	svisceri
Generate the inflected form for: sviscerare V;SBJV;PST;NOM(3,SG)	sviscerasse	sviscerasse
Generate the inflected form for: telefonarsi V.CVB;PRS	telefonandosi	telefonandosi
Generate the inflected form for: telefonarsi V;COND;NOM(1,PL)	ci telefoneremmo	ci telefoneremmo
Generate the inflected form for: telefonarsi V;COND;NOM(1,SG)	mi telefonerei	mi telefonerei
Generate the inflected form for: telefonarsi V;COND;NOM(2,SG)	ti telefoneresti	ti telefoneresti
Generate the inflected form for: telefonarsi V;IND;FUT;NOM(1,PL)	ci telefoneremo	ci telefoneremo
Generate the inflected form for: telefonarsi V;IND;FUT;NOM(3,PL)	si telefoneranno	si telefoneranno
Generate the inflected form for: telefonarsi V;IND;PRS;NOM(1,PL)	ci telefoniamo	ci telefoniamo
Generate the inflected form for: telefonarsi V;IND;PRS;NOM(3,PL)	si telefonano	si telefonano
Generate the inflected form for: telefonarsi V;IND;PST;IPFV;NOM(1,PL)	ci telefonavamo	ci telefonavamo
Generate the inflected form for: telefonarsi V;IND;PST;IPFV;NOM(2,PL)	vi telefonavate	vi telefonavate
Generate the inflected form for: telefonarsi V;IND;PST;IPFV;NOM(2,SG)	ti telefonavi	ti telefonavi
Generate the inflected form for: telefonarsi V;IND;PST;PFV;NOM(2,SG)	ti telefonasti	ti telefonasti
Generate the inflected form for: telefonarsi V;IND;PST;PFV;NOM(3,PL)	si telefonarono	si telefonarono
Generate the inflected form for: telefonarsi V;IND;PST;PFV;NOM(3,SG)	si telefonò	si telefonò
Generate the inflected form for: telefonarsi V;SBJV;PRS;NOM(1,PL)	ci telefoniamo	ci telefoniamo
Generate the inflected form for: telefonarsi V;SBJV;PRS;NOM(1,SG)	mi telefoni	mi telefoni
Generate the inflected form for: telefonarsi V;SBJV;PRS;NOM(2,PL)	vi telefoniate	vi telefoniate
Generate the inflected form for: telefonarsi V;SBJV;PST;NOM(1,PL)	ci telefonassimo	ci telefonassimo
Generate the inflected form for: telefonarsi V;SBJV;PST;NOM(1,SG)	mi telefonassi	mi telefonassi
Generate the inflected form for: telefonarsi V;SBJV;PST;NOM(2,PL)	vi telefonaste	vi telefonaste
Generate the inflected form for: urtacchiare V.CVB;PRS	urtacchiando	urtacchiando
Generate the inflected form for: urtacchiare V;COND;NOM(1,PL)	urtacchieremmo	urtacchieremmo
Generate the inflected form for: urtacchiare V;COND;NOM(1,SG)	urtacchierei	urtacchierei
Generate the inflected form for: urtacchiare V;COND;NOM(2,PL)	urtacchiereste	urtacchiereste
Generate the inflected form for: urtacchiare V;COND;NOM(2,SG)	urtacchieresti	urtacchieresti
Generate the inflected form for: urtacchiare V;IND;FUT;NOM(3,SG)	urtacchierà	urtacchierà
Generate the inflected form for: urtacchiare V;IND;PRS;NOM(1,PL)	urtacchiamo	urtacchiamo
Generate the inflected form for: urtacchiare V;IND;PRS;NOM(2,PL)	urtacchiate	urtacchiate
Generate the inflected form for: urtacchiare V;IND;PRS;NOM(2,SG)	urtacchi	urtacchi
Generate the inflected form for: urtacchiare V;IND;PRS;NOM(3,PL)	urtacchiano	urtacchiano
Generate the inflected form for: urtacchiare V;IND;PST;IPFV;NOM(1,PL)	urtacchiavamo	urtacchiavamo
Generate the inflected form for: urtacchiare V;IND;PST;PFV;NOM(1,PL)	urtacchiammo	urtacchiammo
Generate the inflected form for: urtacchiare V;IND;PST;PFV;NOM(2,SG)	urtacchiasti	urtacchiasti
Generate the inflected form for: urtacchiare V;IND;PST;PFV;NOM(3,PL)	urtacchiarono	urtacchiarono
Generate the inflected form for: urtacchiare V;IND;PST;PFV;NOM(3,SG)	urtacchiò	urtacchiò
Generate the inflected form for: urtacchiare V;POS;IMP;NOM(1,PL)	urtacchiamo	urtacchiamo
Generate the inflected form for: urtacchiare V;SBJV;PRS;NOM(2,SG)	urtacchi	urtacchi
Generate the inflected form for: urtacchiare V;SBJV;PRS;NOM(3,SG)	urtacchi	urtacchi
Generate the inflected form for: urtacchiare V;SBJV;PST;NOM(2,PL)	urtacchiaste	urtacchiaste
Generate the inflected form for: urtacchiare V;SBJV;PST;NOM(2,SG)	urtacchiassi	urtacchiassi

Accuracy: 0.9500 (950/1000)
Mismatches (prediction | gold):
accasco | accascio
accascano | accasciano
acceci | accechi
colluto | colluso
colluda | collude
