Generate the inflected form for the lemma: "აბსტრაქტული", according to the following morphological descriptions: "ADJ;DAT(PL)"	 the inflected form for the le
Generate the inflected form for the lemma: "აბსტრაქტული", according to the following morphological descriptions: "ADJ;DAT(PL;LGSPEC2)"	 the inflected form for the le
Generate the inflected form for the lemma: "აბსტრაქტული", according to the following morphological descriptions: "ADJ;DAT(SG)"	 the inflected form for the le
Generate the inflected form for the lemma: "აბსტრაქტული", according to the following morphological descriptions: "ADJ;ERG(PL)"	 the inflected form for the le
Generate the inflected form for the lemma: "აბსტრაქტული", according to the following morphological descriptions: "ADJ;ERG(PL;LGSPEC2)"	 the inflected form for the le
Generate the inflected form for the lemma: "აბსტრაქტული", according to the following morphological descriptions: "ADJ;ERG(SG)"	 the inflected form for the le
Generate the inflected form for the lemma: "აბსტრაქტული", according to the following morphological descriptions: "ADJ;FRML(PL)"	 the inflected form for the le
Generate the inflected form for the lemma: "აბსტრაქტული", according to the following morphological descriptions: "ADJ;FRML(SG)"	 the inflected form for the le
Generate the inflected form for the lemma: "აბსტრაქტული", according to the following morphological descriptions: "ADJ;GEN(PL)"	 the inflected form for the le
Generate the inflected form for the lemma: "აბსტრაქტული", according to the following morphological descriptions: "ADJ;GEN(PL;LGSPEC2)"	 the inflected form for the le
Generate the inflected form for the lemma: "აბსტრაქტული", according to the following morphological descriptions: "ADJ;GEN(SG)"	 the inflected form for the le
Generate the inflected form for the lemma: "აბსტრაქტული", according to the following morphological descriptions: "ADJ;INS(PL)"	 the inflected form for the le
Generate the inflected form for the lemma: "აბსტრაქტული", according to the following morphological descriptions: "ADJ;INS(SG)"	 the inflected form for the le
Generate the inflected form for the lemma: "აბსტრაქტული", according to the following morphological descriptions: "ADJ;NOM(PL)"	 the inflected form for the le
Generate the inflected form for the lemma: "აბსტრაქტული", according to the following morphological descriptions: "ADJ;NOM(PL;LGSPEC2)"	 the inflected form for the le
Generate the inflected form for the lemma: "აბსტრაქტული", according to the following morphological descriptions: "ADJ;NOM(SG)"	 the inflected form for the le
Generate the inflected form for the lemma: "აბსტრაქტული", according to the following morphological descriptions: "ADJ;VOC(PL)"	 the inflected form for the le
Generate the inflected form for the lemma: "აბსტრაქტული", according to the following morphological descriptions: "ADJ;VOC(PL;LGSPEC2)"	 the inflected form for the le
Generate the inflected form for the lemma: "აბსტრაქტული", according to the following morphological descriptions: "ADJ;VOC(SG)"	 the inflected form for the le
Generate the inflected form for the lemma: "აგენტი", according to the following morphological descriptions: "N;DAT(PL)"	 for the lemma: "აგენ
Generate the inflected form for the lemma: "აგენტი", according to the following morphological descriptions: "N;DAT(PL;LGSPEC2)"	 the inflected form for the le
Generate the inflected form for the lemma: "აგენტი", according to the following morphological descriptions: "N;DAT(SG)"	 for the lemma: "აგენ
Generate the inflected form for the lemma: "აგენტი", according to the following morphological descriptions: "N;ERG(PL)"	 for the lemma: "აგენ
Generate the inflected form for the lemma: "აგენტი", according to the following morphological descriptions: "N;ERG(PL;LGSPEC2)"	 for the lemma: "აგენ
Generate the inflected form for the lemma: "აგენტი", according to the following morphological descriptions: "N;ERG(SG)"	აგენტი"
აგე
Generate the inflected form for the lemma: "აგენტი", according to the following morphological descriptions: "N;FRML(PL)"	 for the lemma: "აგენ
Generate the inflected form for the lemma: "აგენტი", according to the following morphological descriptions: "N;FRML(SG)"	 for the lemma: "აგენ
Generate the inflected form for the lemma: "აგენტი", according to the following morphological descriptions: "N;GEN(PL)"	 for the lemma: "აგენ
Generate the inflected form for the lemma: "აგენტი", according to the following morphological descriptions: "N;GEN(PL;LGSPEC2)"	 for the lemma: "აგენ
Generate the inflected form for the lemma: "აგენტი", according to the following morphological descriptions: "N;GEN(SG)"	 for the lemma: "აგენ
Generate the inflected form for the lemma: "აგენტი", according to the following morphological descriptions: "N;INS(PL)"	 for the lemma: "აგენ
Generate the inflected form for the lemma: "აგენტი", according to the following morphological descriptions: "N;INS(SG)"	 for the lemma: "აგენ
Generate the inflected form for the lemma: "აგენტი", according to the following morphological descriptions: "N;NOM(PL)"	 for the lemma: "აგენ
Generate the inflected form for the lemma: "აგენტი", according to the following morphological descriptions: "N;NOM(PL;LGSPEC2)"	 for the lemma: "აგენ
Generate the inflected form for the lemma: "აგენტი", according to the following morphological descriptions: "N;NOM(SG)"	აგენტი"
"აგე
Generate the inflected form for the lemma: "აგენტი", according to the following morphological descriptions: "N;VOC(PL)"	 for the lemma: "აგენ
Generate the inflected form for the lemma: "აგენტი", according to the following morphological descriptions: "N;VOC(PL;LGSPEC2)"	 for the lemma: "აგენ
Generate the inflected form for the lemma: "აგენტი", according to the following morphological descriptions: "N;VOC(SG)"	 for the lemma: "აგენ
Generate the inflected form for the lemma: "ათეთრებს", according to the following morphological descriptions: "V;IMP;NOM(2,PL);ACC(1,SG)"	ათეთრებს", acc
Generate the inflected form for the lemma: "ათეთრებს", according to the following morphological descriptions: "V;IND;FUT;NOM(3,PL);ACC(2,PL)"	ათეთრებს", acc
Generate the inflected form for the lemma: "ათეთრებს", according to the following morphological descriptions: "V;IND;IPFV;NOM(2,PL);ACC(1,SG)"	ათეთრებს", acc
Generate the inflected form for the lemma: "ათეთრებს", according to the following morphological descriptions: "V;IND;IPFV;NOM(2,SG);ACC(1,PL)"	ათეთრებს", acc
Generate the inflected form for the lemma: "ათეთრებს", according to the following morphological descriptions: "V;IND;IPFV;NOM(2,SG);ACC(3,PL)"	ათეთრებს", acc
Generate the inflected form for the lemma: "ათეთრებს", according to the following morphological descriptions: "V;IND;PRS;NOM(1,PL);ACC(2,SG)"	ათეთრებს", acc
Generate the inflected form for the lemma: "ათეთრებს", according to the following morphological descriptions: "V;IND;PRS;NOM(2,SG);ACC(1,SG)"	ათეთრებს", acc
Generate the inflected form for the lemma: "ათეთრებს", according to the following morphological descriptions: "V;IND;PRS;NOM(3,PL);ACC(1,PL)"	ათეთრებს", acc
Generate the inflected form for the lemma: "ათეთრებს", according to the following morphological descriptions: "V;IND;PRS;NOM(3,PL);ACC(2,PL)"	ათეთრებს", acc
Generate the inflected form for the lemma: "ათეთრებს", according to the following morphological descriptions: "V;IND;PRS;NOM(3,PL);ACC(3,SG)"	ათეთრებს", acc
Generate the inflected form for the lemma: "ათეთრებს", according to the following morphological descriptions: "V;IND;PRS;NOM(3,SG);ACC(2,PL)"	ათეთრებს", acc
Generate the inflected form for the lemma: "ათეთრებს", according to the following morphological descriptions: "V;IND;PST;PFV;NOM(3,SG);ACC(2,SG)"	ათეთრებს", "
Generate the inflected form for the lemma: "ათეთრებს", according to the following morphological descriptions: "V;IND;PST;PRF;NOM(1,PL);ACC(2,SG)"	ათეთრებს", "
Generate the inflected form for the lemma: "ათეთრებს", according to the following morphological descriptions: "V;IND;PST;PRF;NOM(1,PL);ACC(3,SG)"	ათეთრებს", "
Generate the inflected form for the lemma: "ათეთრებს", according to the following morphological descriptions: "V;IND;PST;PRF;NOM(1,SG);ACC(2,SG)"	ათეთრებს", acc
Generate the inflected form for the lemma: "ათეთრებს", according to the following morphological descriptions: "V;IND;PST;PRF;NOM(2,PL);ACC(3,PL)"	ათეთრებს", acc
Generate the inflected form for the lemma: "ათეთრებს", according to the following morphological descriptions: "V;IND;PST;PRF;NOM(3,PL);ACC(2,PL)"	ათეთრებს", acc
Generate the inflected form for the lemma: "ათეთრებს", according to the following morphological descriptions: "V;IND;PST;PRF;NOM(3,PL);ACC(3,SG)"	ათეთრებს", acc
Generate the inflected form for the lemma: "ათეთრებს", according to the following morphological descriptions: "V;OPT;NOM(3,PL);ACC(1,PL)"	 the inflected form for the le
Generate the inflected form for the lemma: "ათეთრებს", according to the following morphological descriptions: "V;OPT;NOM(3,PL);ACC(2,PL)"	 the inflected form for the le
Generate the inflected form for the lemma: "ათეთრებს", according to the following morphological descriptions: "V;SBJV;FUT;NOM(2,PL);ACC(1,PL)"	ათეთრებს", acc
Generate the inflected form for the lemma: "ათეთრებს", according to the following morphological descriptions: "V;SBJV;FUT;NOM(2,SG);ACC(3,PL)"	ათეთრებს", acc
Generate the inflected form for the lemma: "ათეთრებს", according to the following morphological descriptions: "V;SBJV;FUT;NOM(3,PL);ACC(2,SG)"	ათეთრებს", acc
Generate the inflected form for the lemma: "ათეთრებს", according to the following morphological descriptions: "V;SBJV;PRF;NOM(3,PL);ACC(3,PL)"	ათეთრებს", acc
Generate the inflected form for the lemma: "ათეთრებს", according to the following morphological descriptions: "V;SBJV;PRS;NOM(2,SG);ACC(1,PL)"	ათეთრებს", acc
Generate the inflected form for the lemma: "აკვამარინი", according to the following morphological descriptions: "N;DAT(PL)"	 the inflected form for the le
Generate the inflected form for the lemma: "აკვამარინი", according to the following morphological descriptions: "N;DAT(PL;LGSPEC2)"	 the inflected form for the le
Generate the inflected form for the lemma: "აკვამარინი", according to the following morphological descriptions: "N;DAT(SG)"	 the inflected form for the le
Generate the inflected form for the lemma: "აკვამარინი", according to the following morphological descriptions: "N;ERG(PL)"	 for the lemma: "აკვა
Generate the inflected form for the lemma: "აკვამარინი", according to the following morphological descriptions: "N;ERG(PL;LGSPEC2)"	 the inflected form for the le
Generate the inflected form for the lemma: "აკვამარინი", according to the following morphological descriptions: "N;ERG(SG)"	 the inflected form for the le
Generate the inflected form for the lemma: "აკვამარინი", according to the following morphological descriptions: "N;FRML(PL)"	 for the lemma: "აკვა
Generate the inflected form for the lemma: "აკვამარინი", according to the following morphological descriptions: "N;FRML(SG)"	 for the lemma: "აკვა
Generate the inflected form for the lemma: "აკვამარინი", according to the following morphological descriptions: "N;GEN(PL)"	 the inflected form for the le
Generate the inflected form for the lemma: "აკვამარინი", according to the following morphological descriptions: "N;GEN(PL;LGSPEC2)"	 the inflected form for the le
Generate the inflected form for the lemma: "აკვამარინი", according to the following morphological descriptions: "N;GEN(SG)"	 the inflected form for the le
Generate the inflected form for the lemma: "აკვამარინი", according to the following morphological descriptions: "N;INS(PL)"	 for the lemma: "აკვა
Generate the inflected form for the lemma: "აკვამარინი", according to the following morphological descriptions: "N;INS(SG)"	 the inflected form for the le
Generate the inflected form for the lemma: "აკვამარინი", according to the following morphological descriptions: "N;NOM(PL)"	 the inflected form for the le
Generate the inflected form for the lemma: "აკვამარინი", according to the following morphological descriptions: "N;NOM(PL;LGSPEC2)"	 the inflected form for the le
Generate the inflected form for the lemma: "აკვამარინი", according to the following morphological descriptions: "N;NOM(SG)"	 the inflected form for the le
Generate the inflected form for the lemma: "აკვამარინი", according to the following morphological descriptions: "N;VOC(PL)"	 the inflected form for the le
Generate the inflected form for the lemma: "აკვამარინი", according to the following morphological descriptions: "N;VOC(PL;LGSPEC2)"	 the inflected form for the le
Generate the inflected form for the lemma: "აკვამარინი", according to the following morphological descriptions: "N;VOC(SG)"	 "აკვამარინ
Generate the inflected form for the lemma: "ართმევს", according to the following morphological descriptions: "V;COND;NOM(2,PL);ACC(3,PL)"	 the inflected form for the le
Generate the inflected form for the lemma: "ართმევს", according to the following morphological descriptions: "V;COND;NOM(2,SG);ACC(1,SG)"	ართმევს", accord
Generate the inflected form for the lemma: "ართმევს", according to the following morphological descriptions: "V;COND;NOM(3,PL);ACC(3,PL)"	ართმევს", accord
Generate the inflected form for the lemma: "ართმევს", according to the following morphological descriptions: "V;IMP;NOM(3,PL);ACC(1,PL)"	 the inflected form for the le
Generate the inflected form for the lemma: "ართმევს", according to the following morphological descriptions: "V;IMP;NOM(3,SG);ACC(1,SG)"	ართმევს", accord
Generate the inflected form for the lemma: "ართმევს", according to the following morphological descriptions: "V;IND;FUT;NOM(1,PL);ACC(3,SG)"	ართმევს", accord
Generate the inflected form for the lemma: "ართმევს", according to the following morphological descriptions: "V;IND;FUT;NOM(2,SG);ACC(1,SG)"	ართმევს", accord
Generate the inflected form for the lemma: "ართმევს", according to the following morphological descriptions: "V;IND;FUT;NOM(3,PL);ACC(3,PL)"	ართმევს", accord
Generate the inflected form for the lemma: "ართმევს", according to the following morphological descriptions: "V;IND;FUT;NOM(3,SG);ACC(1,SG)"	ართმევს", accord
Generate the inflected form for the lemma: "ართმევს", according to the following morphological descriptions: "V;IND;IPFV;NOM(1,PL);ACC(3,SG)"	ართმევს", accord
Generate the inflected form for the lemma: "ართმევს", according to the following morphological descriptions: "V;IND;PRF;NOM(1,SG);ACC(2,PL)"	ართმევს", accord
Generate the inflected form for the lemma: "ართმევს", according to the following morphological descriptions: "V;IND;PRF;NOM(3,PL);ACC(3,PL)"	ართმევს", accord
Generate the inflected form for the lemma: "ართმევს", according to the following morphological descriptions: "V;IND;PRF;NOM(3,PL);ACC(3,SG)"	ართმევს", accord
Generate the inflected form for the lemma: "ართმევს", according to the following morphological descriptions: "V;IND;PRS;NOM(2,SG);ACC(3,PL)"	ართმევს", accord
Generate the inflected form for the lemma: "ართმევს", according to the following morphological descriptions: "V;IND;PRS;NOM(3,PL);ACC(3,SG)"	ართმევს", accord
Generate the inflected form for the lemma: "ართმევს", according to the following morphological descriptions: "V;IND;PRS;NOM(3,SG);ACC(1,SG)"	ართმევს", accord
Generate the inflected form for the lemma: "ართმევს", according to the following morphological descriptions: "V;IND;PST;PFV;NOM(2,PL);ACC(1,SG)"	ართმევს", accord
Generate the inflected form for the lemma: "ართმევს", according to the following morphological descriptions: "V;IND;PST;PFV;NOM(3,SG);ACC(3,SG)"	ართმევს", accord
Generate the inflected form for the lemma: "ართმევს", according to the following morphological descriptions: "V;OPT;NOM(2,PL);ACC(3,PL)"	 the inflected form for the le
Generate the inflected form for the lemma: "ართმევს", according to the following morphological descriptions: "V;OPT;NOM(3,PL);ACC(2,PL)"	 the inflected form for the le
Generate the inflected form for the lemma: "ართმევს", according to the following morphological descriptions: "V;SBJV;PRF;NOM(1,SG);ACC(3,PL)"	ართმევს", accord
Generate the inflected form for the lemma: "ართმევს", according to the following morphological descriptions: "V;SBJV;PRF;NOM(2,SG);ACC(3,SG)"	ართმევს", accord
Generate the inflected form for the lemma: "ართმევს", according to the following morphological descriptions: "V;SBJV;PRF;NOM(3,PL);ACC(2,SG)"	ართმევს", accord
Generate the inflected form for the lemma: "ართმევს", according to the following morphological descriptions: "V;SBJV;PRS;NOM(2,PL);ACC(1,PL)"	ართმევს", accord
Generate the inflected form for the lemma: "ართმევს", according to the following morphological descriptions: "V;SBJV;PRS;NOM(2,SG);ACC(1,PL)"	ართმევს", accord
Generate the inflected form for the lemma: "ართმევს", according to the following morphological descriptions: "V;SBJV;PRS;NOM(3,SG);ACC(3,SG)"	ართმევს", accord
Generate the inflected form for the lemma: "ასისტენტი", according to the following morphological descriptions: "N;DAT(PL)"	 ასისტენტი 
Generate the inflected form for the lemma: "ასისტენტი", according to the following morphological descriptions: "N;DAT(PL;LGSPEC2)"	 the inflected form for the le
Generate the inflected form for the lemma: "ასისტენტი", according to the following morphological descriptions: "N;DAT(SG)"	 ასისტენტი 
Generate the inflected form for the lemma: "ასისტენტი", according to the following morphological descriptions: "N;ERG(PL)"	 ასისტენტი",
Generate the inflected form for the lemma: "ასისტენტი", according to the following morphological descriptions: "N;ERG(PL;LGSPEC2)"	 the inflected form for the le
Generate the inflected form for the lemma: "ასისტენტი", according to the following morphological descriptions: "N;ERG(SG)"	 the inflected form for the le
Generate the inflected form for the lemma: "ასისტენტი", according to the following morphological descriptions: "N;FRML(PL)"	 for the lemma: "ასის
Generate the inflected form for the lemma: "ასისტენტი", according to the following morphological descriptions: "N;FRML(SG)"	 for the lemma: "ასის
Generate the inflected form for the lemma: "ასისტენტი", according to the following morphological descriptions: "N;GEN(PL)"	 the inflected form for the le
Generate the inflected form for the lemma: "ასისტენტი", according to the following morphological descriptions: "N;GEN(PL;LGSPEC2)"	 the inflected form for the le
Generate the inflected form for the lemma: "ასისტენტი", according to the following morphological descriptions: "N;GEN(SG)"	 the inflected form for the le
Generate the inflected form for the lemma: "ასისტენტი", according to the following morphological descriptions: "N;INS(PL)"	 ასისტენტი 
Generate the inflected form for the lemma: "ასისტენტი", according to the following morphological descriptions: "N;INS(SG)"	 for the lemma: "ასის
Generate the inflected form for the lemma: "ასისტენტი", according to the following morphological descriptions: "N;NOM(PL)"	 ასისტენტი",
Generate the inflected form for the lemma: "ასისტენტი", according to the following morphological descriptions: "N;NOM(PL;LGSPEC2)"	 the inflected form for the le
Generate the inflected form for the lemma: "ასისტენტი", according to the following morphological descriptions: "N;NOM(SG)"	 the inflected form for the le
Generate the inflected form for the lemma: "ასისტენტი", according to the following morphological descriptions: "N;VOC(PL)"	 the inflected form for the le
Generate the inflected form for the lemma: "ასისტენტი", according to the following morphological descriptions: "N;VOC(PL;LGSPEC2)"	 the inflected form for the le
Generate the inflected form for the lemma: "ასისტენტი", according to the following morphological descriptions: "N;VOC(SG)"	 the inflected form for the le
Generate the inflected form for the lemma: "ატიპური", according to the following morphological descriptions: "ADJ;DAT(PL)"	ატიპური", accord
Generate the inflected form for the lemma: "ატიპური", according to the following morphological descriptions: "ADJ;DAT(PL;LGSPEC2)"	ატიპური", accord
Generate the inflected form for the lemma: "ატიპური", according to the following morphological descriptions: "ADJ;DAT(SG)"	ატიპური", accord
Generate the inflected form for the lemma: "ატიპური", according to the following morphological descriptions: "ADJ;ERG(PL)"	ატიპური", accord
Generate the inflected form for the lemma: "ატიპური", according to the following morphological descriptions: "ADJ;ERG(PL;LGSPEC2)"	ატიპური", accord
Generate the inflected form for the lemma: "ატიპური", according to the following morphological descriptions: "ADJ;ERG(SG)"	ატიპური", accord
Generate the inflected form for the lemma: "ატიპური", according to the following morphological descriptions: "ADJ;FRML(PL)"	ატიპური", accord
Generate the inflected form for the lemma: "ატიპური", according to the following morphological descriptions: "ADJ;FRML(SG)"	ატიპური", accord
Generate the inflected form for the lemma: "ატიპური", according to the following morphological descriptions: "ADJ;GEN(PL)"	ატიპური", accord
Generate the inflected form for the lemma: "ატიპური", according to the following morphological descriptions: "ADJ;GEN(PL;LGSPEC2)"	ატიპური", accord
Generate the inflected form for the lemma: "ატიპური", according to the following morphological descriptions: "ADJ;GEN(SG)"	ატიპური", accord
Generate the inflected form for the lemma: "ატიპური", according to the following morphological descriptions: "ADJ;INS(PL)"	ატიპური", accord
Generate the inflected form for the lemma: "ატიპური", according to the following morphological descriptions: "ADJ;INS(SG)"	ატიპური", accord
Generate the inflected form for the lemma: "ატიპური", according to the following morphological descriptions: "ADJ;NOM(PL)"	ატიპური", accord
Generate the inflected form for the lemma: "ატიპური", according to the following morphological descriptions: "ADJ;NOM(PL;LGSPEC2)"	ატიპური", accord
Generate the inflected form for the lemma: "ატიპური", according to the following morphological descriptions: "ADJ;NOM(SG)"	ატიპური", accord
Generate the inflected form for the lemma: "ატიპური", according to the following morphological descriptions: "ADJ;VOC(PL)"	 ატიპური", accor
Generate the inflected form for the lemma: "ატიპური", according to the following morphological descriptions: "ADJ;VOC(PL;LGSPEC2)"	ატიპური"
ატ
Generate the inflected form for the lemma: "ატიპური", according to the following morphological descriptions: "ADJ;VOC(SG)"	 ატიპური ატ
Generate the inflected form for the lemma: "ბიოლოგი", according to the following morphological descriptions: "N;DAT(PL)"	 the inflected form for the le
Generate the inflected form for the lemma: "ბიოლოგი", according to the following morphological descriptions: "N;DAT(PL;LGSPEC2)"	 for the lemma: "ბიოლ
Generate the inflected form for the lemma: "ბიოლოგი", according to the following morphological descriptions: "N;DAT(SG)"	 the inflected form for the le
Generate the inflected form for the lemma: "ბიოლოგი", according to the following morphological descriptions: "N;ERG(PL)"	 "ბიოლოგი", acco
Generate the inflected form for the lemma: "ბიოლოგი", according to the following morphological descriptions: "N;ERG(PL;LGSPEC2)"	 for the lemma: "ბიოლ
Generate the inflected form for the lemma: "ბიოლოგი", according to the following morphological descriptions: "N;ERG(SG)"	 "ბიოლოგი", acco
Generate the inflected form for the lemma: "ბიოლოგი", according to the following morphological descriptions: "N;FRML(PL)"	 for the lemma: "ბიოლ
Generate the inflected form for the lemma: "ბიოლოგი", according to the following morphological descriptions: "N;FRML(SG)"	 for the lemma: "ბიოლ
Generate the inflected form for the lemma: "ბიოლოგი", according to the following morphological descriptions: "N;GEN(PL)"	 for the lemma: "ბიოლ
Generate the inflected form for the lemma: "ბიოლოგი", according to the following morphological descriptions: "N;GEN(PL;LGSPEC2)"	 for the lemma: "ბიოლ
Generate the inflected form for the lemma: "ბიოლოგი", according to the following morphological descriptions: "N;GEN(SG)"	ალათი", according to
Generate the inflected form for the lemma: "ბიოლოგი", according to the following morphological descriptions: "N;INS(PL)"	 for the lemma: "ბიოლ
Generate the inflected form for the lemma: "ბიოლოგი", according to the following morphological descriptions: "N;INS(SG)"	 for the lemma: "ბიოლ
Generate the inflected form for the lemma: "ბიოლოგი", according to the following morphological descriptions: "N;NOM(PL)"	 the inflected form for the le
Generate the inflected form for the lemma: "ბიოლოგი", according to the following morphological descriptions: "N;NOM(PL;LGSPEC2)"	 for the lemma: "ბიოლ
Generate the inflected form for the lemma: "ბიოლოგი", according to the following morphological descriptions: "N;NOM(SG)"	 "ბიოლოგი", acco
Generate the inflected form for the lemma: "ბიოლოგი", according to the following morphological descriptions: "N;VOC(PL)"	 the inflected form for the le
Generate the inflected form for the lemma: "ბიოლოგი", according to the following morphological descriptions: "N;VOC(PL;LGSPEC2)"	 for the lemma: "ბიოლ
Generate the inflected form for the lemma: "ბიოლოგი", according to the following morphological descriptions: "N;VOC(SG)"	 "ბიოლოგი", acco
Generate the inflected form for the lemma: "გარანტი", according to the following morphological descriptions: "N;DAT(PL)"	 გარანტი", accor
Generate the inflected form for the lemma: "გარანტი", according to the following morphological descriptions: "N;DAT(PL;LGSPEC2)"	 გარანტი", accor
Generate the inflected form for the lemma: "გარანტი", according to the following morphological descriptions: "N;DAT(SG)"	არანტი", according
Generate the inflected form for the lemma: "გარანტი", according to the following morphological descriptions: "N;ERG(PL)"	 გარანტი", accor
Generate the inflected form for the lemma: "გარანტი", according to the following morphological descriptions: "N;ERG(PL;LGSPEC2)"	 გარანტი", accor
Generate the inflected form for the lemma: "გარანტი", according to the following morphological descriptions: "N;ERG(SG)"	არანტი", according
Generate the inflected form for the lemma: "გარანტი", according to the following morphological descriptions: "N;FRML(PL)"	არანტი", according
Generate the inflected form for the lemma: "გარანტი", according to the following morphological descriptions: "N;FRML(SG)"	არანტი", according
Generate the inflected form for the lemma: "გარანტი", according to the following morphological descriptions: "N;GEN(PL)"	არანტი", according
Generate the inflected form for the lemma: "გარანტი", according to the following morphological descriptions: "N;GEN(PL;LGSPEC2)"	 გარანტი", accor
Generate the inflected form for the lemma: "გარანტი", according to the following morphological descriptions: "N;GEN(SG)"	არანტი", according
Generate the inflected form for the lemma: "გარანტი", according to the following morphological descriptions: "N;INS(PL)"	 გარანტი", accor
Generate the inflected form for the lemma: "გარანტი", according to the following morphological descriptions: "N;INS(SG)"	 გარანტი", accor
Generate the inflected form for the lemma: "გარანტი", according to the following morphological descriptions: "N;NOM(PL)"	არანტი", according
Generate the inflected form for the lemma: "გარანტი", according to the following morphological descriptions: "N;NOM(PL;LGSPEC2)"	 გარანტი", accor
Generate the inflected form for the lemma: "გარანტი", according to the following morphological descriptions: "N;NOM(SG)"	არანტი", according
Generate the inflected form for the lemma: "გარანტი", according to the following morphological descriptions: "N;VOC(PL)"	 გარანტი", accor
Generate the inflected form for the lemma: "გარანტი", according to the following morphological descriptions: "N;VOC(PL;LGSPEC2)"	 გარანტი", accor
Generate the inflected form for the lemma: "გარანტი", according to the following morphological descriptions: "N;VOC(SG)"	 გარანტი", accor
Generate the inflected form for the lemma: "გუთანი", according to the following morphological descriptions: "N;DAT(PL)"	უთანი"
"გუთა
Generate the inflected form for the lemma: "გუთანი", according to the following morphological descriptions: "N;DAT(PL;LGSPEC2)"	 for the lemma: "გუთა
Generate the inflected form for the lemma: "გუთანი", according to the following morphological descriptions: "N;DAT(SG)"	უთანი"
"გუთა
Generate the inflected form for the lemma: "გუთანი", according to the following morphological descriptions: "N;ERG(PL)"	უთანი"
გუთა
Generate the inflected form for the lemma: "გუთანი", according to the following morphological descriptions: "N;ERG(PL;LGSPEC2)"	 for the lemma: "გუთა
Generate the inflected form for the lemma: "გუთანი", according to the following morphological descriptions: "N;ERG(SG)"	უთანი"
გუთა
Generate the inflected form for the lemma: "გუთანი", according to the following morphological descriptions: "N;FRML(PL)"	უთანი"
გუთა
Generate the inflected form for the lemma: "გუთანი", according to the following morphological descriptions: "N;FRML(SG)"	უთანი"
გუთა
Generate the inflected form for the lemma: "გუთანი", according to the following morphological descriptions: "N;GEN(PL)"	უთანი" - გუთ
Generate the inflected form for the lemma: "გუთანი", according to the following morphological descriptions: "N;GEN(PL;LGSPEC2)"	 for the lemma: "გუთა
Generate the inflected form for the lemma: "გუთანი", according to the following morphological descriptions: "N;GEN(SG)"	უთანი" სახე
Generate the inflected form for the lemma: "გუთანი", according to the following morphological descriptions: "N;INS(PL)"	უთანი"
გუთა
Generate the inflected form for the lemma: "გუთანი", according to the following morphological descriptions: "N;INS(SG)"	უთანი"
Generate the 
Generate the inflected form for the lemma: "გუთანი", according to the following morphological descriptions: "N;NOM(PL)"	უთანი"
გუთა
Generate the inflected form for the lemma: "გუთანი", according to the following morphological descriptions: "N;NOM(PL;LGSPEC2)"	 for the lemma: "გუთა
Generate the inflected form for the lemma: "გუთანი", according to the following morphological descriptions: "N;NOM(SG)"	უთანი"
გუთა
Generate the inflected form for the lemma: "გუთანი", according to the following morphological descriptions: "N;VOC(PL)"	 "გუთანი" სა
Generate the inflected form for the lemma: "გუთანი", according to the following morphological descriptions: "N;VOC(PL;LGSPEC2)"	 for the lemma: "გუთა
Generate the inflected form for the lemma: "გუთანი", according to the following morphological descriptions: "N;VOC(SG)"	 "გუთანი" სა
Generate the inflected form for the lemma: "დოლარი", according to the following morphological descriptions: "N;DAT(PL)"	არის დოლარ
Generate the inflected form for the lemma: "დოლარი", according to the following morphological descriptions: "N;DAT(PL;LGSPEC2)"	არის სახელ
Generate the inflected form for the lemma: "დოლარი", according to the following morphological descriptions: "N;DAT(SG)"	არის დოლარ
Generate the inflected form for the lemma: "დოლარი", according to the following morphological descriptions: "N;ERG(PL)"	არის დოლარ
Generate the inflected form for the lemma: "დოლარი", according to the following morphological descriptions: "N;ERG(PL;LGSPEC2)"	არის დოლარ
Generate the inflected form for the lemma: "დოლარი", according to the following morphological descriptions: "N;ERG(SG)"	არის დოლარ
Generate the inflected form for the lemma: "დოლარი", according to the following morphological descriptions: "N;FRML(PL)"	არის დოლარ
Generate the inflected form for the lemma: "დოლარი", according to the following morphological descriptions: "N;FRML(SG)"	არის დოლარ
Generate the inflected form for the lemma: "დოლარი", according to the following morphological descriptions: "N;GEN(PL)"	არის დოლარ
Generate the inflected form for the lemma: "დოლარი", according to the following morphological descriptions: "N;GEN(PL;LGSPEC2)"	არის დოლარ
Generate the inflected form for the lemma: "დოლარი", according to the following morphological descriptions: "N;GEN(SG)"	არის დოლარ
Generate the inflected form for the lemma: "დოლარი", according to the following morphological descriptions: "N;INS(PL)"	არის დოლარ
Generate the inflected form for the lemma: "დოლარი", according to the following morphological descriptions: "N;INS(SG)"	არის დოლარ
Generate the inflected form for the lemma: "დოლარი", according to the following morphological descriptions: "N;NOM(PL)"	არის დოლარ
Generate the inflected form for the lemma: "დოლარი", according to the following morphological descriptions: "N;NOM(PL;LGSPEC2)"	არის დოლარ
Generate the inflected form for the lemma: "დოლარი", according to the following morphological descriptions: "N;NOM(SG)"	არის დოლარ
Generate the inflected form for the lemma: "დოლარი", according to the following morphological descriptions: "N;VOC(PL)"	არის დოლარ
Generate the inflected form for the lemma: "დოლარი", according to the following morphological descriptions: "N;VOC(PL;LGSPEC2)"	არის დოლარ
Generate the inflected form for the lemma: "დოლარი", according to the following morphological descriptions: "N;VOC(SG)"	არის დოლარ
Generate the inflected form for the lemma: "ებონიტი", according to the following morphological descriptions: "N;DAT(PL)"	 for the lemma: "ებონ
Generate the inflected form for the lemma: "ებონიტი", according to the following morphological descriptions: "N;DAT(PL;LGSPEC2)"	 the inflected form for the le
Generate the inflected form for the lemma: "ებონიტი", according to the following morphological descriptions: "N;DAT(SG)"	 the inflected form for the le
Generate the inflected form for the lemma: "ებონიტი", according to the following morphological descriptions: "N;ERG(PL)"	 for the lemma: "ებონ
Generate the inflected form for the lemma: "ებონიტი", according to the following morphological descriptions: "N;ERG(PL;LGSPEC2)"	 the inflected form for the le
Generate the inflected form for the lemma: "ებონიტი", according to the following morphological descriptions: "N;ERG(SG)"	 for the lemma: "ებონ
Generate the inflected form for the lemma: "ებონიტი", according to the following morphological descriptions: "N;FRML(PL)"	ანალიზიტი", 
Generate the inflected form for the lemma: "ებონიტი", according to the following morphological descriptions: "N;FRML(SG)"	ანალიზიტი", 
Generate the inflected form for the lemma: "ებონიტი", according to the following morphological descriptions: "N;GEN(PL)"	 for the lemma: "ებონ
Generate the inflected form for the lemma: "ებონიტი", according to the following morphological descriptions: "N;GEN(PL;LGSPEC2)"	 the inflected form for the le
Generate the inflected form for the lemma: "ებონიტი", according to the following morphological descriptions: "N;GEN(SG)"	 for the lemma: "ებონ
Generate the inflected form for the lemma: "ებონიტი", according to the following morphological descriptions: "N;INS(PL)"	 for the lemma: "ებონ
Generate the inflected form for the lemma: "ებონიტი", according to the following morphological descriptions: "N;INS(SG)"	 for the lemma: "ებონ
Generate the inflected form for the lemma: "ებონიტი", according to the following morphological descriptions: "N;NOM(PL)"	 for the lemma: "ებონ
Generate the inflected form for the lemma: "ებონიტი", according to the following morphological descriptions: "N;NOM(PL;LGSPEC2)"	 the inflected form for the le
Generate the inflected form for the lemma: "ებონიტი", according to the following morphological descriptions: "N;NOM(SG)"	 for the lemma: "ებონ
Generate the inflected form for the lemma: "ებონიტი", according to the following morphological descriptions: "N;VOC(PL)"	 for the lemma: "ებონ
Generate the inflected form for the lemma: "ებონიტი", according to the following morphological descriptions: "N;VOC(PL;LGSPEC2)"	 the inflected form for the le
Generate the inflected form for the lemma: "ებონიტი", according to the following morphological descriptions: "N;VOC(SG)"	 "ებონიტი" accor
Generate the inflected form for the lemma: "ეზო", according to the following morphological descriptions: "N;DAT(PL)"	ო" - "ეზო" - "ეზ
Generate the inflected form for the lemma: "ეზო", according to the following morphological descriptions: "N;DAT(PL;LGSPEC2)"	ო" ეზო" ეზო" ე
Generate the inflected form for the lemma: "ეზო", according to the following morphological descriptions: "N;DAT(SG)"	ო" - ეზოოოოო
Generate the inflected form for the lemma: "ეზო", according to the following morphological descriptions: "N;ERG(PL)"	ო" - ეზო" - ეზო"
Generate the inflected form for the lemma: "ეზო", according to the following morphological descriptions: "N;ERG(PL;LGSPEC2)"	ო" ეზო" ეზო" ე
Generate the inflected form for the lemma: "ეზო", according to the following morphological descriptions: "N;ERG(SG)"	ო" ეზო" ეზო" ე
Generate the inflected form for the lemma: "ეზო", according to the following morphological descriptions: "N;FRML(PL)"	ო" ეზო" ეზო" ე
Generate the inflected form for the lemma: "ეზო", according to the following morphological descriptions: "N;FRML(SG)"	ო" ეზო" ეზო" ე
Generate the inflected form for the lemma: "ეზო", according to the following morphological descriptions: "N;GEN(PL)"	ო" - ეზო" - ეზო"
Generate the inflected form for the lemma: "ეზო", according to the following morphological descriptions: "N;GEN(PL;LGSPEC2)"	ო" ეზო" ეზო" ე
Generate the inflected form for the lemma: "ეზო", according to the following morphological descriptions: "N;GEN(SG)"	ო" (ეზო) (ეზო) (
Generate the inflected form for the lemma: "ეზო", according to the following morphological descriptions: "N;INS(PL)"	ო" - ეზო" - ეზო"
Generate the inflected form for the lemma: "ეზო", according to the following morphological descriptions: "N;INS(SG)"	ო" - ეზო" - ეზო"
Generate the inflected form for the lemma: "ეზო", according to the following morphological descriptions: "N;NOM(PL)"	ო" ეზო" ეზო" ე
Generate the inflected form for the lemma: "ეზო", according to the following morphological descriptions: "N;NOM(PL;LGSPEC2)"	ო" ეზო" ეზო" ე
Generate the inflected form for the lemma: "ეზო", according to the following morphological descriptions: "N;NOM(SG)"	ო" (ეზო) (ეზო) (
Generate the inflected form for the lemma: "ეზო", according to the following morphological descriptions: "N;VOC(PL)"	ო" - ეზო" - ეზო"
Generate the inflected form for the lemma: "ეზო", according to the following morphological descriptions: "N;VOC(PL;LGSPEC2)"	ო" ეზო" ეზო" ე
Generate the inflected form for the lemma: "ეზო", according to the following morphological descriptions: "N;VOC(SG)"	ო" (ეზო) (ეზო) (
Generate the inflected form for the lemma: "ეპიდემიოლოგი", according to the following morphological descriptions: "N;DAT(PL)"	 the inflected form for the le
Generate the inflected form for the lemma: "ეპიდემიოლოგი", according to the following morphological descriptions: "N;DAT(PL;LGSPEC2)"	 the inflected form for the le
Generate the inflected form for the lemma: "ეპიდემიოლოგი", according to the following morphological descriptions: "N;DAT(SG)"	 the inflected form for the le
Generate the inflected form for the lemma: "ეპიდემიოლოგი", according to the following morphological descriptions: "N;ERG(PL)"	 for the lemma: "ეპიდ
Generate the inflected form for the lemma: "ეპიდემიოლოგი", according to the following morphological descriptions: "N;ERG(PL;LGSPEC2)"	 the inflected form for the le
Generate the inflected form for the lemma: "ეპიდემიოლოგი", according to the following morphological descriptions: "N;ERG(SG)"	 for the lemma: "ეპიდ
Generate the inflected form for the lemma: "ეპიდემიოლოგი", according to the following morphological descriptions: "N;FRML(PL)"	 for the lemma: "ეპიდ
Generate the inflected form for the lemma: "ეპიდემიოლოგი", according to the following morphological descriptions: "N;FRML(SG)"	 for the lemma: "ეპიდ
Generate the inflected form for the lemma: "ეპიდემიოლოგი", according to the following morphological descriptions: "N;GEN(PL)"	 the inflected form for the le
Generate the inflected form for the lemma: "ეპიდემიოლოგი", according to the following morphological descriptions: "N;GEN(PL;LGSPEC2)"	 the inflected form for the le
Generate the inflected form for the lemma: "ეპიდემიოლოგი", according to the following morphological descriptions: "N;GEN(SG)"	 the inflected form for the le
Generate the inflected form for the lemma: "ეპიდემიოლოგი", according to the following morphological descriptions: "N;INS(PL)"	 for the lemma: "ეპიდ
Generate the inflected form for the lemma: "ეპიდემიოლოგი", according to the following morphological descriptions: "N;INS(SG)"	 the inflected form for the le
Generate the inflected form for the lemma: "ეპიდემიოლოგი", according to the following morphological descriptions: "N;NOM(PL)"	 for the lemma: "ეპიდ
Generate the inflected form for the lemma: "ეპიდემიოლოგი", according to the following morphological descriptions: "N;NOM(PL;LGSPEC2)"	 the inflected form for the le
Generate the inflected form for the lemma: "ეპიდემიოლოგი", according to the following morphological descriptions: "N;NOM(SG)"	 for the lemma: "ეპიდ
Generate the inflected form for the lemma: "ეპიდემიოლოგი", according to the following morphological descriptions: "N;VOC(PL)"	 for the lemma: "ეპიდ
Generate the inflected form for the lemma: "ეპიდემიოლოგი", according to the following morphological descriptions: "N;VOC(PL;LGSPEC2)"	 the inflected form for the le
Generate the inflected form for the lemma: "ეპიდემიოლოგი", according to the following morphological descriptions: "N;VOC(SG)"	 the inflected form for the le
Generate the inflected form for the lemma: "ვაჟი", according to the following morphological descriptions: "N;DAT(PL)"	აჟი" - ვაჟი" - 
Generate the inflected form for the lemma: "ვაჟი", according to the following morphological descriptions: "N;DAT(PL;LGSPEC2)"	აჟი", according to the f
Generate the inflected form for the lemma: "ვაჟი", according to the following morphological descriptions: "N;DAT(SG)"	აჟი" სახელი 
Generate the inflected form for the lemma: "ვაჟი", according to the following morphological descriptions: "N;ERG(PL)"	აჟი", according to the f
Generate the inflected form for the lemma: "ვაჟი", according to the following morphological descriptions: "N;ERG(PL;LGSPEC2)"	აჟი", according to the f
Generate the inflected form for the lemma: "ვაჟი", according to the following morphological descriptions: "N;ERG(SG)"	აჟი" - ვაჟი" - 
Generate the inflected form for the lemma: "ვაჟი", according to the following morphological descriptions: "N;FRML(PL)"	აჟი" და "ვაჟ
Generate the inflected form for the lemma: "ვაჟი", according to the following morphological descriptions: "N;FRML(SG)"	აჟი" და "ვაჟ
Generate the inflected form for the lemma: "ვაჟი", according to the following morphological descriptions: "N;GEN(PL)"	აჟი" და "ვაჟ
Generate the inflected form for the lemma: "ვაჟი", according to the following morphological descriptions: "N;GEN(PL;LGSPEC2)"	აჟი", according to the f
Generate the inflected form for the lemma: "ვაჟი", according to the following morphological descriptions: "N;GEN(SG)"	აჟი" და "ვაჟ
Generate the inflected form for the lemma: "ვაჟი", according to the following morphological descriptions: "N;INS(PL)"	აჟი" - ვაჟი" - 
Generate the inflected form for the lemma: "ვაჟი", according to the following morphological descriptions: "N;INS(SG)"	აჟი" - ვაჟი - 
Generate the inflected form for the lemma: "ვაჟი", according to the following morphological descriptions: "N;NOM(PL)"	აჟი" და "ვაჟ
Generate the inflected form for the lemma: "ვაჟი", according to the following morphological descriptions: "N;NOM(PL;LGSPEC2)"	აჟი", according to the f
Generate the inflected form for the lemma: "ვაჟი", according to the following morphological descriptions: "N;NOM(SG)"	აჟი" - ვაჟი" - 
Generate the inflected form for the lemma: "ვაჟი", according to the following morphological descriptions: "N;VOC(PL)"	აჟი" - ვაჟი" - 
Generate the inflected form for the lemma: "ვაჟი", according to the following morphological descriptions: "N;VOC(PL;LGSPEC2)"	აჟი", according to the f
Generate the inflected form for the lemma: "ვაჟი", according to the following morphological descriptions: "N;VOC(SG)"	აჟი" - ვაჟი" - 
Generate the inflected form for the lemma: "ზამბახიანი", according to the following morphological descriptions: "ADJ;DAT(PL)"	 ზამბახიან
Generate the inflected form for the lemma: "ზამბახიანი", according to the following morphological descriptions: "ADJ;DAT(PL;LGSPEC2)"	 the inflected form for the le
Generate the inflected form for the lemma: "ზამბახიანი", according to the following morphological descriptions: "ADJ;DAT(SG)"	 the inflected form for the le
Generate the inflected form for the lemma: "ზამბახიანი", according to the following morphological descriptions: "ADJ;ERG(PL)"	 ზამბახიან
Generate the inflected form for the lemma: "ზამბახიანი", according to the following morphological descriptions: "ADJ;ERG(PL;LGSPEC2)"	 the inflected form for the le
Generate the inflected form for the lemma: "ზამბახიანი", according to the following morphological descriptions: "ADJ;ERG(SG)"	 the inflected form for the le
Generate the inflected form for the lemma: "ზამბახიანი", according to the following morphological descriptions: "ADJ;FRML(PL)"	 for the lemma: "ზამბ
Generate the inflected form for the lemma: "ზამბახიანი", according to the following morphological descriptions: "ADJ;FRML(SG)"	 for the lemma: "ზამბ
Generate the inflected form for the lemma: "ზამბახიანი", according to the following morphological descriptions: "ADJ;GEN(PL)"	 ზამბახიან
Generate the inflected form for the lemma: "ზამბახიანი", according to the following morphological descriptions: "ADJ;GEN(PL;LGSPEC2)"	 the inflected form for the le
Generate the inflected form for the lemma: "ზამბახიანი", according to the following morphological descriptions: "ADJ;GEN(SG)"	 the inflected form for the le
Generate the inflected form for the lemma: "ზამბახიანი", according to the following morphological descriptions: "ADJ;INS(PL)"	 ზამბახიან
Generate the inflected form for the lemma: "ზამბახიანი", according to the following morphological descriptions: "ADJ;INS(SG)"	 ზამბახიან
Generate the inflected form for the lemma: "ზამბახიანი", according to the following morphological descriptions: "ADJ;NOM(PL)"	 ზამბახიან
Generate the inflected form for the lemma: "ზამბახიანი", according to the following morphological descriptions: "ADJ;NOM(PL;LGSPEC2)"	 the inflected form for the le
Generate the inflected form for the lemma: "ზამბახიანი", according to the following morphological descriptions: "ADJ;NOM(SG)"	 the inflected form for the le
Generate the inflected form for the lemma: "ზამბახიანი", according to the following morphological descriptions: "ADJ;VOC(PL)"	 the inflected form for the le
Generate the inflected form for the lemma: "ზამბახიანი", according to the following morphological descriptions: "ADJ;VOC(PL;LGSPEC2)"	 the inflected form for the le
Generate the inflected form for the lemma: "ზამბახიანი", according to the following morphological descriptions: "ADJ;VOC(SG)"	 the inflected form for the le
Generate the inflected form for the lemma: "თარაზო", according to the following morphological descriptions: "N;DAT(PL)"	აზო" - თარაზ
Generate the inflected form for the lemma: "თარაზო", according to the following morphological descriptions: "N;DAT(PL;LGSPEC2)"	 თარაზო", accordin
Generate the inflected form for the lemma: "თარაზო", according to the following morphological descriptions: "N;DAT(SG)"	აზო" თარაზო 
Generate the inflected form for the lemma: "თარაზო", according to the following morphological descriptions: "N;ERG(PL)"	აზო" - თარაზ
Generate the inflected form for the lemma: "თარაზო", according to the following morphological descriptions: "N;ERG(PL;LGSPEC2)"	 თარაზო", accordin
Generate the inflected form for the lemma: "თარაზო", according to the following morphological descriptions: "N;ERG(SG)"	აზო" - თარაზ
Generate the inflected form for the lemma: "თარაზო", according to the following morphological descriptions: "N;FRML(PL)"	აზო" თარაზო 
Generate the inflected form for the lemma: "თარაზო", according to the following morphological descriptions: "N;FRML(SG)"	აზო" თარაზო 
Generate the inflected form for the lemma: "თარაზო", according to the following morphological descriptions: "N;GEN(PL)"	აზო" თარაზო 
Generate the inflected form for the lemma: "თარაზო", according to the following morphological descriptions: "N;GEN(PL;LGSPEC2)"	 თარაზო", accordin
Generate the inflected form for the lemma: "თარაზო", according to the following morphological descriptions: "N;GEN(SG)"	აზო" თარაზო 
Generate the inflected form for the lemma: "თარაზო", according to the following morphological descriptions: "N;INS(PL)"	აზო" - თარაზ
Generate the inflected form for the lemma: "თარაზო", according to the following morphological descriptions: "N;INS(SG)"	აზო" - თარაზ
Generate the inflected form for the lemma: "თარაზო", according to the following morphological descriptions: "N;NOM(PL)"	აზო" - თარაზ
Generate the inflected form for the lemma: "თარაზო", according to the following morphological descriptions: "N;NOM(PL;LGSPEC2)"	 თარაზო", accordin
Generate the inflected form for the lemma: "თარაზო", according to the following morphological descriptions: "N;NOM(SG)"	აზო" - თარაზ
Generate the inflected form for the lemma: "თარაზო", according to the following morphological descriptions: "N;VOC(PL)"	 "თარაზო" - თა
Generate the inflected form for the lemma: "თარაზო", according to the following morphological descriptions: "N;VOC(PL;LGSPEC2)"	 თარაზო", accordin
Generate the inflected form for the lemma: "თარაზო", according to the following morphological descriptions: "N;VOC(SG)"	 "თარაზო" თა
Generate the inflected form for the lemma: "თეთრდება", according to the following morphological descriptions: "V;COND;NOM(1,PL)"	 the inflected form for the le
Generate the inflected form for the lemma: "თეთრდება", according to the following morphological descriptions: "V;COND;NOM(1,SG)"	 the inflected form for the le
Generate the inflected form for the lemma: "თეთრდება", according to the following morphological descriptions: "V;COND;NOM(2,PL)"	 the inflected form for the le
Generate the inflected form for the lemma: "თეთრდება", according to the following morphological descriptions: "V;COND;NOM(3,PL)"	 the inflected form for the le
Generate the inflected form for the lemma: "თეთრდება", according to the following morphological descriptions: "V;COND;NOM(3,SG)"	 the inflected form for the le
Generate the inflected form for the lemma: "თეთრდება", according to the following morphological descriptions: "V;IMP;NOM(1,PL)"	 the inflected form for the le
Generate the inflected form for the lemma: "თეთრდება", according to the following morphological descriptions: "V;IND;FUT;NOM(3,SG)"	 the inflected form for the le
Generate the inflected form for the lemma: "თეთრდება", according to the following morphological descriptions: "V;IND;IPFV;NOM(1,PL)"	 the inflected form for the le
Generate the inflected form for the lemma: "თეთრდება", according to the following morphological descriptions: "V;IND;IPFV;NOM(3,SG)"	 the inflected form for the le
Generate the inflected form for the lemma: "თეთრდება", according to the following morphological descriptions: "V;IND;PRS;NOM(2,PL)"	 the inflected form for the le
Generate the inflected form for the lemma: "თეთრდება", according to the following morphological descriptions: "V;IND;PRS;NOM(2,SG)"	 the inflected form for the le
Generate the inflected form for the lemma: "თეთრდება", according to the following morphological descriptions: "V;IND;PRS;NOM(3,PL)"	 the inflected form for the le
Generate the inflected form for the lemma: "თეთრდება", according to the following morphological descriptions: "V;IND;PRS;NOM(3,SG)"	 the inflected form for the le
Generate the inflected form for the lemma: "თეთრდება", according to the following morphological descriptions: "V;IND;PST;PFV;NOM(2,SG)"	 the inflected form for the le
Generate the inflected form for the lemma: "თეთრდება", according to the following morphological descriptions: "V;IND;PST;PFV;NOM(3,PL)"	 the inflected form for the le
Generate the inflected form for the lemma: "თეთრდება", according to the following morphological descriptions: "V;IND;PST;PFV;NOM(3,SG)"	 the inflected form for the le
Generate the inflected form for the lemma: "თეთრდება", according to the following morphological descriptions: "V;IND;PST;PRF;NOM(2,PL)"	 the inflected form for the le
Generate the inflected form for the lemma: "თეთრდება", according to the following morphological descriptions: "V;IND;PST;PRF;NOM(2,SG)"	 the inflected form for the le
Generate the inflected form for the lemma: "თეთრდება", according to the following morphological descriptions: "V;OPT;NOM(1,SG)"	 the inflected form for the le
Generate the inflected form for the lemma: "თეთრდება", according to the following morphological descriptions: "V;SBJV;FUT;NOM(1,PL)"	 the inflected form for the le
Generate the inflected form for the lemma: "თეთრდება", according to the following morphological descriptions: "V;SBJV;FUT;NOM(2,PL)"	 the inflected form for the le
Generate the inflected form for the lemma: "თეთრდება", according to the following morphological descriptions: "V;SBJV;FUT;NOM(2,SG)"	 the inflected form for the le
Generate the inflected form for the lemma: "თეთრდება", according to the following morphological descriptions: "V;SBJV;FUT;NOM(3,PL)"	 the inflected form for the le
Generate the inflected form for the lemma: "თეთრდება", according to the following morphological descriptions: "V;SBJV;PRF;NOM(1,SG)"	 the inflected form for the le
Generate the inflected form for the lemma: "თეთრდება", according to the following morphological descriptions: "V;SBJV;PRS;NOM(1,PL)"	 the inflected form for the le
Generate the inflected form for the lemma: "თეთრდება", according to the following morphological descriptions: "V;V.MSDR;PRF"	 form for the lemma: "თე
Generate the inflected form for the lemma: "ილი", according to the following morphological descriptions: "N;DAT(PL)"	ი" - ილიკი - ი
Generate the inflected form for the lemma: "ილი", according to the following morphological descriptions: "N;DAT(PL;LGSPEC2)"	ი", according to the followi
Generate the inflected form for the lemma: "ილი", according to the following morphological descriptions: "N;DAT(SG)"	ი" - ილი" - ილი"
Generate the inflected form for the lemma: "ილი", according to the following morphological descriptions: "N;ERG(PL)"	ი" ილიკი ილი
Generate the inflected form for the lemma: "ილი", according to the following morphological descriptions: "N;ERG(PL;LGSPEC2)"	ი", according to the followi
Generate the inflected form for the lemma: "ილი", according to the following morphological descriptions: "N;ERG(SG)"	ი" ილი" ილი" ი
Generate the inflected form for the lemma: "ილი", according to the following morphological descriptions: "N;FRML(PL)"	ი" ილი" ილი" ი
Generate the inflected form for the lemma: "ილი", according to the following morphological descriptions: "N;FRML(SG)"	ი" ილი" ილი" ი
Generate the inflected form for the lemma: "ილი", according to the following morphological descriptions: "N;GEN(PL)"	ი" - ილიკი"ილ
Generate the inflected form for the lemma: "ილი", according to the following morphological descriptions: "N;GEN(PL;LGSPEC2)"	ი", according to the followi
Generate the inflected form for the lemma: "ილი", according to the following morphological descriptions: "N;GEN(SG)"	ი", according to the followi
Generate the inflected form for the lemma: "ილი", according to the following morphological descriptions: "N;INS(PL)"	ი" - ილიკი"ილ
Generate the inflected form for the lemma: "ილი", according to the following morphological descriptions: "N;INS(SG)"	ი" (ილიკი) (ილ
Generate the inflected form for the lemma: "ილი", according to the following morphological descriptions: "N;NOM(PL)"	ი" ილი" ილი" ი
Generate the inflected form for the lemma: "ილი", according to the following morphological descriptions: "N;NOM(PL;LGSPEC2)"	ი" ილი" ილი" ი
Generate the inflected form for the lemma: "ილი", according to the following morphological descriptions: "N;NOM(SG)"	ი" (ილი) (ილი) (
Generate the inflected form for the lemma: "ილი", according to the following morphological descriptions: "N;VOC(PL)"	ი" ილი" ილი" ი
Generate the inflected form for the lemma: "ილი", according to the following morphological descriptions: "N;VOC(PL;LGSPEC2)"	ი", according to the followi
Generate the inflected form for the lemma: "ილი", according to the following morphological descriptions: "N;VOC(SG)"	ი" ილი" ილი" ი
Generate the inflected form for the lemma: "იმპერიალისტი", according to the following morphological descriptions: "N;DAT(PL)"	 the inflected form for the le
Generate the inflected form for the lemma: "იმპერიალისტი", according to the following morphological descriptions: "N;DAT(PL;LGSPEC2)"	 the inflected form for the le
Generate the inflected form for the lemma: "იმპერიალისტი", according to the following morphological descriptions: "N;DAT(SG)"	 the inflected form for the le
Generate the inflected form for the lemma: "იმპერიალისტი", according to the following morphological descriptions: "N;ERG(PL)"	 the inflected form for the le
Generate the inflected form for the lemma: "იმპერიალისტი", according to the following morphological descriptions: "N;ERG(PL;LGSPEC2)"	 the inflected form for the le
Generate the inflected form for the lemma: "იმპერიალისტი", according to the following morphological descriptions: "N;ERG(SG)"	 the inflected form for the le
Generate the inflected form for the lemma: "იმპერიალისტი", according to the following morphological descriptions: "N;FRML(PL)"	 for the lemma: "იმპე
Generate the inflected form for the lemma: "იმპერიალისტი", according to the following morphological descriptions: "N;FRML(SG)"	 for the lemma: "იმპე
Generate the inflected form for the lemma: "იმპერიალისტი", according to the following morphological descriptions: "N;GEN(PL)"	 the inflected form for the le
Generate the inflected form for the lemma: "იმპერიალისტი", according to the following morphological descriptions: "N;GEN(PL;LGSPEC2)"	 the inflected form for the le
Generate the inflected form for the lemma: "იმპერიალისტი", according to the following morphological descriptions: "N;GEN(SG)"	 the inflected form for the le
Generate the inflected form for the lemma: "იმპერიალისტი", according to the following morphological descriptions: "N;INS(PL)"	 the inflected form for the le
Generate the inflected form for the lemma: "იმპერიალისტი", according to the following morphological descriptions: "N;INS(SG)"	 the inflected form for the le
Generate the inflected form for the lemma: "იმპერიალისტი", according to the following morphological descriptions: "N;NOM(PL)"	 for the lemma: "იმპე
Generate the inflected form for the lemma: "იმპერიალისტი", according to the following morphological descriptions: "N;NOM(PL;LGSPEC2)"	 the inflected form for the le
Generate the inflected form for the lemma: "იმპერიალისტი", according to the following morphological descriptions: "N;NOM(SG)"	 the inflected form for the le
Generate the inflected form for the lemma: "იმპერიალისტი", according to the following morphological descriptions: "N;VOC(PL)"	 the inflected form for the le
Generate the inflected form for the lemma: "იმპერიალისტი", according to the following morphological descriptions: "N;VOC(PL;LGSPEC2)"	 the inflected form for the le
Generate the inflected form for the lemma: "იმპერიალისტი", according to the following morphological descriptions: "N;VOC(SG)"	 the inflected form for the le
Generate the inflected form for the lemma: "იმპორტი", according to the following morphological descriptions: "N;DAT(PL)"	 იმპორტი", accor
Generate the inflected form for the lemma: "იმპორტი", according to the following morphological descriptions: "N;DAT(PL;LGSPEC2)"	 იმპორტი", accor
Generate the inflected form for the lemma: "იმპორტი", according to the following morphological descriptions: "N;DAT(SG)"	 იმპორტი", accor
Generate the inflected form for the lemma: "იმპორტი", according to the following morphological descriptions: "N;ERG(PL)"	 "იმპორტი" ი
Generate the inflected form for the lemma: "იმპორტი", according to the following morphological descriptions: "N;ERG(PL;LGSPEC2)"	 for the lemma: "იმპო
Generate the inflected form for the lemma: "იმპორტი", according to the following morphological descriptions: "N;ERG(SG)"	იმპორტი", accord
Generate the inflected form for the lemma: "იმპორტი", according to the following morphological descriptions: "N;FRML(PL)"	 იმპორტი", accor
Generate the inflected form for the lemma: "იმპორტი", according to the following morphological descriptions: "N;FRML(SG)"	იმპორტი", accord
Generate the inflected form for the lemma: "იმპორტი", according to the following morphological descriptions: "N;GEN(PL)"	 for the lemma: "იმპო
Generate the inflected form for the lemma: "იმპორტი", according to the following morphological descriptions: "N;GEN(PL;LGSPEC2)"	 for the lemma: "იმპო
Generate the inflected form for the lemma: "იმპორტი", according to the following morphological descriptions: "N;GEN(SG)"	იმპორტი", accord
Generate the inflected form for the lemma: "იმპორტი", according to the following morphological descriptions: "N;INS(PL)"	 იმპორტი", accor
Generate the inflected form for the lemma: "იმპორტი", according to the following morphological descriptions: "N;INS(SG)"	 for the lemma: "იმპო
Generate the inflected form for the lemma: "იმპორტი", according to the following morphological descriptions: "N;NOM(PL)"	 იმპორტი", accor
Generate the inflected form for the lemma: "იმპორტი", according to the following morphological descriptions: "N;NOM(PL;LGSPEC2)"	 for the lemma: "იმპო
Generate the inflected form for the lemma: "იმპორტი", according to the following morphological descriptions: "N;NOM(SG)"	 იმპორტი", accor
Generate the inflected form for the lemma: "იმპორტი", according to the following morphological descriptions: "N;VOC(PL)"	 იმპორტი", accor
Generate the inflected form for the lemma: "იმპორტი", according to the following morphological descriptions: "N;VOC(PL;LGSPEC2)"	 for the lemma: "იმპო
Generate the inflected form for the lemma: "იმპორტი", according to the following morphological descriptions: "N;VOC(SG)"	 "იმპორტი" ს
Generate the inflected form for the lemma: "იღება", according to the following morphological descriptions: "V;COND;NOM(1,PL)"	 for the lemma: "იღებ
Generate the inflected form for the lemma: "იღება", according to the following morphological descriptions: "V;COND;NOM(3,SG)"	 "იღება", according 
Generate the inflected form for the lemma: "იღება", according to the following morphological descriptions: "V;IMP;NOM(1,PL)"	 for the lemma: "იღებ
Generate the inflected form for the lemma: "იღება", according to the following morphological descriptions: "V;IMP;NOM(2,PL)"	 for the lemma: "იღებ
Generate the inflected form for the lemma: "იღება", according to the following morphological descriptions: "V;IND;FUT;NOM(1,SG)"	 for the lemma: "იღებ
Generate the inflected form for the lemma: "იღება", according to the following morphological descriptions: "V;IND;FUT;NOM(2,SG)"	 for the lemma: "იღებ
Generate the inflected form for the lemma: "იღება", according to the following morphological descriptions: "V;IND;FUT;NOM(3,PL)"	 for the lemma: "იღებ
Generate the inflected form for the lemma: "იღება", according to the following morphological descriptions: "V;IND;IPFV;NOM(2,PL)"	 for the lemma: "იღებ
Generate the inflected form for the lemma: "იღება", according to the following morphological descriptions: "V;IND;PRF;NOM(1,PL)"	 for the lemma: "იღებ
Generate the inflected form for the lemma: "იღება", according to the following morphological descriptions: "V;IND;PRF;NOM(1,SG)"	 for the lemma: "იღებ
Generate the inflected form for the lemma: "იღება", according to the following morphological descriptions: "V;IND;PRF;NOM(2,SG)"	 for the lemma: "იღებ
Generate the inflected form for the lemma: "იღება", according to the following morphological descriptions: "V;IND;PRF;NOM(3,PL)"	 for the lemma: "იღებ
Generate the inflected form for the lemma: "იღება", according to the following morphological descriptions: "V;IND;PRF;NOM(3,SG)"	 for the lemma: "იღებ
Generate the inflected form for the lemma: "იღება", according to the following morphological descriptions: "V;IND;PRS;NOM(1,PL)"	 for the lemma: "იღებ
Generate the inflected form for the lemma: "იღება", according to the following morphological descriptions: "V;IND;PRS;NOM(1,SG)"	 for the lemma: "იღებ
Generate the inflected form for the lemma: "იღება", according to the following morphological descriptions: "V;IND;PRS;NOM(2,SG)"	 for the lemma: "იღებ
Generate the inflected form for the lemma: "იღება", according to the following morphological descriptions: "V;IND;PST;PFV;NOM(1,PL)"	 for the lemma: "იღებ
Generate the inflected form for the lemma: "იღება", according to the following morphological descriptions: "V;IND;PST;PFV;NOM(2,PL)"	 form for the lemma: "იღ
Generate the inflected form for the lemma: "იღება", according to the following morphological descriptions: "V;IND;PST;PFV;NOM(3,PL)"	 for the lemma: "იღებ
Generate the inflected form for the lemma: "იღება", according to the following morphological descriptions: "V;IND;PST;PRF;NOM(1,PL)"	 for the lemma: "იღებ
Generate the inflected form for the lemma: "იღება", according to the following morphological descriptions: "V;IND;PST;PRF;NOM(3,PL)"	 for the lemma: "იღებ
Generate the inflected form for the lemma: "იღება", according to the following morphological descriptions: "V;OPT;NOM(3,SG)"	 "იღება", according 
Generate the inflected form for the lemma: "იღება", according to the following morphological descriptions: "V;SBJV;PRF;NOM(2,PL)"	 for the lemma: "იღებ
Generate the inflected form for the lemma: "იღება", according to the following morphological descriptions: "V;SBJV;PRF;NOM(2,SG)"	 for the lemma: "იღებ
Generate the inflected form for the lemma: "იღება", according to the following morphological descriptions: "V;SBJV;PRS;NOM(2,PL)"	 for the lemma: "იღებ
Generate the inflected form for the lemma: "იღება", according to the following morphological descriptions: "V;SBJV;PRS;NOM(3,SG)"	 for the lemma: "იღებ
Generate the inflected form for the lemma: "კანდიდატი", according to the following morphological descriptions: "N;DAT(PL)"	 for the lemma: "კანდ
Generate the inflected form for the lemma: "კანდიდატი", according to the following morphological descriptions: "N;DAT(PL;LGSPEC2)"	 the inflected form for the le
Generate the inflected form for the lemma: "კანდიდატი", according to the following morphological descriptions: "N;DAT(SG)"	 for the lemma: "კანდ
Generate the inflected form for the lemma: "კანდიდატი", according to the following morphological descriptions: "N;ERG(PL)"	 for the lemma: "კანდ
Generate the inflected form for the lemma: "კანდიდატი", according to the following morphological descriptions: "N;ERG(PL;LGSPEC2)"	 the inflected form for the le
Generate the inflected form for the lemma: "კანდიდატი", according to the following morphological descriptions: "N;ERG(SG)"	 for the lemma: "კანდ
Generate the inflected form for the lemma: "კანდიდატი", according to the following morphological descriptions: "N;FRML(PL)"	 for the lemma: "კანდ
Generate the inflected form for the lemma: "კანდიდატი", according to the following morphological descriptions: "N;FRML(SG)"	 for the lemma: "კანდ
Generate the inflected form for the lemma: "კანდიდატი", according to the following morphological descriptions: "N;GEN(PL)"	 for the lemma: "კანდ
Generate the inflected form for the lemma: "კანდიდატი", according to the following morphological descriptions: "N;GEN(PL;LGSPEC2)"	 the inflected form for the le
Generate the inflected form for the lemma: "კანდიდატი", according to the following morphological descriptions: "N;GEN(SG)"	 for the lemma: "კანდ
Generate the inflected form for the lemma: "კანდიდატი", according to the following morphological descriptions: "N;INS(PL)"	 for the lemma: "კანდ
Generate the inflected form for the lemma: "კანდიდატი", according to the following morphological descriptions: "N;INS(SG)"	 for the lemma: "კანდ
Generate the inflected form for the lemma: "კანდიდატი", according to the following morphological descriptions: "N;NOM(PL)"	 for the lemma: "კანდ
Generate the inflected form for the lemma: "კანდიდატი", according to the following morphological descriptions: "N;NOM(PL;LGSPEC2)"	 the inflected form for the le
Generate the inflected form for the lemma: "კანდიდატი", according to the following morphological descriptions: "N;NOM(SG)"	 for the lemma: "კანდ
Generate the inflected form for the lemma: "კანდიდატი", according to the following morphological descriptions: "N;VOC(PL)"	 for the lemma: "კანდ
Generate the inflected form for the lemma: "კანდიდატი", according to the following morphological descriptions: "N;VOC(PL;LGSPEC2)"	 the inflected form for the le
Generate the inflected form for the lemma: "კანდიდატი", according to the following morphological descriptions: "N;VOC(SG)"	 for the lemma: "კანდ
Generate the inflected form for the lemma: "კონტური", according to the following morphological descriptions: "N;DAT(PL)"	 form for the lemma: "კო
Generate the inflected form for the lemma: "კონტური", according to the following morphological descriptions: "N;DAT(PL;LGSPEC2)"	 for the lemma: "კონტ
Generate the inflected form for the lemma: "კონტური", according to the following morphological descriptions: "N;DAT(SG)"	 form for the lemma: "კო
Generate the inflected form for the lemma: "კონტური", according to the following morphological descriptions: "N;ERG(PL)"	 კონტური", accor
Generate the inflected form for the lemma: "კონტური", according to the following morphological descriptions: "N;ERG(PL;LGSPEC2)"	 for the lemma: "კონტ
Generate the inflected form for the lemma: "კონტური", according to the following morphological descriptions: "N;ERG(SG)"	 form for the lemma: "კო
Generate the inflected form for the lemma: "კონტური", according to the following morphological descriptions: "N;FRML(PL)"	 for the lemma: "კონტ
Generate the inflected form for the lemma: "კონტური", according to the following morphological descriptions: "N;FRML(SG)"	 for the lemma: "კონტ
Generate the inflected form for the lemma: "კონტური", according to the following morphological descriptions: "N;GEN(PL)"	 for the lemma: "კონტ
Generate the inflected form for the lemma: "კონტური", according to the following morphological descriptions: "N;GEN(PL;LGSPEC2)"	 for the lemma: "კონტ
Generate the inflected form for the lemma: "კონტური", according to the following morphological descriptions: "N;GEN(SG)"	 for the lemma: "კონტ
Generate the inflected form for the lemma: "კონტური", according to the following morphological descriptions: "N;INS(PL)"	 form for the lemma: "კო
Generate the inflected form for the lemma: "კონტური", according to the following morphological descriptions: "N;INS(SG)"	 form for the lemma: "კო
Generate the inflected form for the lemma: "კონტური", according to the following morphological descriptions: "N;NOM(PL)"	 form for the lemma: "კო
Generate the inflected form for the lemma: "კონტური", according to the following morphological descriptions: "N;NOM(PL;LGSPEC2)"	 for the lemma: "კონტ
Generate the inflected form for the lemma: "კონტური", according to the following morphological descriptions: "N;NOM(SG)"	 form for the lemma: "კო
Generate the inflected form for the lemma: "კონტური", according to the following morphological descriptions: "N;VOC(PL)"	 the inflected form for the le
Generate the inflected form for the lemma: "კონტური", according to the following morphological descriptions: "N;VOC(PL;LGSPEC2)"	 for the lemma: "კონტ
Generate the inflected form for the lemma: "კონტური", according to the following morphological descriptions: "N;VOC(SG)"	 form for the lemma: "კო
Generate the inflected form for the lemma: "კორიდორი", according to the following morphological descriptions: "N;DAT(PL)"	 კორიდორის 
Generate the inflected form for the lemma: "კორიდორი", according to the following morphological descriptions: "N;DAT(PL;LGSPEC2)"	 the inflected form for the le
Generate the inflected form for the lemma: "კორიდორი", according to the following morphological descriptions: "N;ERG(PL)"	 კორიდორი", ac
Generate the inflected form for the lemma: "კორიდორი", according to the following morphological descriptions: "N;ERG(PL;LGSPEC2)"	 the inflected form for the le
Generate the inflected form for the lemma: "კორიდორი", according to the following morphological descriptions: "N;ERG(SG)"	 form for the lemma: "კო
Generate the inflected form for the lemma: "კორიდორი", according to the following morphological descriptions: "N;FRML(SG)"	 for the lemma: "კორი
Generate the inflected form for the lemma: "კორიდორი", according to the following morphological descriptions: "N;GEN(PL)"	კორიდორი", acc
Generate the inflected form for the lemma: "კორიდორი", according to the following morphological descriptions: "N;GEN(PL;LGSPEC2)"	 for the lemma: "კორი
Generate the inflected form for the lemma: "კორიდორი", according to the following morphological descriptions: "N;GEN(SG)"	კორიდორი", acc
Generate the inflected form for the lemma: "კორიდორი", according to the following morphological descriptions: "N;INS(PL)"	 კორიდორი", ac
Generate the inflected form for the lemma: "კორიდორი", according to the following morphological descriptions: "N;INS(SG)"	 form for the lemma: "კო
Generate the inflected form for the lemma: "კორიდორი", according to the following morphological descriptions: "N;NOM(PL)"	 კორიდორი", ac
Generate the inflected form for the lemma: "კორიდორი", according to the following morphological descriptions: "N;NOM(PL;LGSPEC2)"	 the inflected form for the le
Generate the inflected form for the lemma: "კორიდორი", according to the following morphological descriptions: "N;NOM(SG)"	 form for the lemma: "კო
Generate the inflected form for the lemma: "კორიდორი", according to the following morphological descriptions: "N;VOC(PL)"	 კორიდორი", ac
Generate the inflected form for the lemma: "კორიდორი", according to the following morphological descriptions: "N;VOC(PL;LGSPEC2)"	 the inflected form for the le
Generate the inflected form for the lemma: "კორიდორი", according to the following morphological descriptions: "N;VOC(SG)"	 "კორიდორი", a
Generate the inflected form for the lemma: "მთისწინეთი", according to the following morphological descriptions: "N;DAT(PL)"	ის მთის მთი
Generate the inflected form for the lemma: "მთისწინეთი", according to the following morphological descriptions: "N;DAT(PL;LGSPEC2)"	ათის მთის მ
Generate the inflected form for the lemma: "მთისწინეთი", according to the following morphological descriptions: "N;DAT(SG)"	ათის მთის მ
Generate the inflected form for the lemma: "მთისწინეთი", according to the following morphological descriptions: "N;ERG(PL)"	ის მთის მთი
Generate the inflected form for the lemma: "მთისწინეთი", according to the following morphological descriptions: "N;ERG(PL;LGSPEC2)"	ის მთის მთი
Generate the inflected form for the lemma: "მთისწინეთი", according to the following morphological descriptions: "N;ERG(SG)"	ათის მთის მ
Generate the inflected form for the lemma: "მთისწინეთი", according to the following morphological descriptions: "N;FRML(PL)"	ის მთისწინ
Generate the inflected form for the lemma: "მთისწინეთი", according to the following morphological descriptions: "N;FRML(SG)"	ათის მთისწ
Generate the inflected form for the lemma: "მთისწინეთი", according to the following morphological descriptions: "N;GEN(PL)"	ის მთის მთი
Generate the inflected form for the lemma: "მთისწინეთი", according to the following morphological descriptions: "N;GEN(PL;LGSPEC2)"	ის მთის მთი
Generate the inflected form for the lemma: "მთისწინეთი", according to the following morphological descriptions: "N;GEN(SG)"	ის მთის მთი
Generate the inflected form for the lemma: "მთისწინეთი", according to the following morphological descriptions: "N;INS(PL)"	ის მთის მთი
Generate the inflected form for the lemma: "მთისწინეთი", according to the following morphological descriptions: "N;INS(SG)"	 მთისწინეთ
Generate the inflected form for the lemma: "მთისწინეთი", according to the following morphological descriptions: "N;NOM(PL)"	ის მთის მთი
Generate the inflected form for the lemma: "მთისწინეთი", according to the following morphological descriptions: "N;NOM(PL;LGSPEC2)"	ის მთის მთი
Generate the inflected form for the lemma: "მთისწინეთი", according to the following morphological descriptions: "N;NOM(SG)"	ის მთისწინ
Generate the inflected form for the lemma: "მთისწინეთი", according to the following morphological descriptions: "N;VOC(PL)"	ის მთის მთი
Generate the inflected form for the lemma: "მთისწინეთი", according to the following morphological descriptions: "N;VOC(PL;LGSPEC2)"	ათის მთის მ
Generate the inflected form for the lemma: "მთისწინეთი", according to the following morphological descriptions: "N;VOC(SG)"	 "მთისწინეთ
Generate the inflected form for the lemma: "მშვიდი", according to the following morphological descriptions: "ADJ;DAT(PL)"	 მშვიდი", accordin
Generate the inflected form for the lemma: "მშვიდი", according to the following morphological descriptions: "ADJ;DAT(PL;LGSPEC2)"	 მშვიდი", accordin
Generate the inflected form for the lemma: "მშვიდი", according to the following morphological descriptions: "ADJ;DAT(SG)"	 for the lemma: "მშვი
Generate the inflected form for the lemma: "მშვიდი", according to the following morphological descriptions: "ADJ;ERG(PL)"	 მშვიდი", accordin
Generate the inflected form for the lemma: "მშვიდი", according to the following morphological descriptions: "ADJ;ERG(PL;LGSPEC2)"	 მშვიდი", accordin
Generate the inflected form for the lemma: "მშვიდი", according to the following morphological descriptions: "ADJ;ERG(SG)"	 for the lemma: "მშვი
Generate the inflected form for the lemma: "მშვიდი", according to the following morphological descriptions: "ADJ;FRML(PL)"	 მშვიდი", accordin
Generate the inflected form for the lemma: "მშვიდი", according to the following morphological descriptions: "ADJ;FRML(SG)"	 for the lemma: "მშვი
Generate the inflected form for the lemma: "მშვიდი", according to the following morphological descriptions: "ADJ;GEN(PL)"	ის მშვიდი", ac
Generate the inflected form for the lemma: "მშვიდი", according to the following morphological descriptions: "ADJ;GEN(PL;LGSPEC2)"	 მშვიდი", accordin
Generate the inflected form for the lemma: "მშვიდი", according to the following morphological descriptions: "ADJ;GEN(SG)"	ის მშვიდის 
Generate the inflected form for the lemma: "მშვიდი", according to the following morphological descriptions: "ADJ;INS(PL)"	 მშვიდი", accordin
Generate the inflected form for the lemma: "მშვიდი", according to the following morphological descriptions: "ADJ;INS(SG)"	 მშვიდი", accordin
Generate the inflected form for the lemma: "მშვიდი", according to the following morphological descriptions: "ADJ;NOM(PL)"	ის მშვიდის 
Generate the inflected form for the lemma: "მშვიდი", according to the following morphological descriptions: "ADJ;NOM(PL;LGSPEC2)"	 მშვიდი", accordin
Generate the inflected form for the lemma: "მშვიდი", according to the following morphological descriptions: "ADJ;NOM(SG)"	 for the lemma: "მშვი
Generate the inflected form for the lemma: "მშვიდი", according to the following morphological descriptions: "ADJ;VOC(PL)"	 მშვიდი", accordin
Generate the inflected form for the lemma: "მშვიდი", according to the following morphological descriptions: "ADJ;VOC(PL;LGSPEC2)"	 მშვიდი", accordin
Generate the inflected form for the lemma: "მშვიდი", according to the following morphological descriptions: "ADJ;VOC(SG)"	 for the lemma: "მშვი
Generate the inflected form for the lemma: "მძინარე", according to the following morphological descriptions: "ADJ;DAT(PL)"	 მძინარე", accor
Generate the inflected form for the lemma: "მძინარე", according to the following morphological descriptions: "ADJ;DAT(PL;LGSPEC2)"	 მძინარე", accor
Generate the inflected form for the lemma: "მძინარე", according to the following morphological descriptions: "ADJ;DAT(SG)"	 მძინარე", accor
Generate the inflected form for the lemma: "მძინარე", according to the following morphological descriptions: "ADJ;ERG(PL)"	 მძინარე", accor
Generate the inflected form for the lemma: "მძინარე", according to the following morphological descriptions: "ADJ;ERG(PL;LGSPEC2)"	 მძინარე", accor
Generate the inflected form for the lemma: "მძინარე", according to the following morphological descriptions: "ADJ;ERG(SG)"	 მძინარე", accor
Generate the inflected form for the lemma: "მძინარე", according to the following morphological descriptions: "ADJ;FRML(PL)"	 მძინარე", accor
Generate the inflected form for the lemma: "მძინარე", according to the following morphological descriptions: "ADJ;FRML(SG)"	 მძინარე", accor
Generate the inflected form for the lemma: "მძინარე", according to the following morphological descriptions: "ADJ;GEN(PL)"	 მძინარე", accor
Generate the inflected form for the lemma: "მძინარე", according to the following morphological descriptions: "ADJ;GEN(PL;LGSPEC2)"	 მძინარე", accor
Generate the inflected form for the lemma: "მძინარე", according to the following morphological descriptions: "ADJ;GEN(SG)"	 მძინარე", accor
Generate the inflected form for the lemma: "მძინარე", according to the following morphological descriptions: "ADJ;INS(PL)"	 მძინარე", accor
Generate the inflected form for the lemma: "მძინარე", according to the following morphological descriptions: "ADJ;INS(SG)"	 მძინარე", accor
Generate the inflected form for the lemma: "მძინარე", according to the following morphological descriptions: "ADJ;NOM(PL)"	 მძინარე", accor
Generate the inflected form for the lemma: "მძინარე", according to the following morphological descriptions: "ADJ;NOM(PL;LGSPEC2)"	 მძინარე", accor
Generate the inflected form for the lemma: "მძინარე", according to the following morphological descriptions: "ADJ;NOM(SG)"	 მძინარე", accor
Generate the inflected form for the lemma: "მძინარე", according to the following morphological descriptions: "ADJ;VOC(PL)"	 მძინარე", accor
Generate the inflected form for the lemma: "მძინარე", according to the following morphological descriptions: "ADJ;VOC(PL;LGSPEC2)"	 მძინარე", accor
Generate the inflected form for the lemma: "მძინარე", according to the following morphological descriptions: "ADJ;VOC(SG)"	 მძინარე", accor
Generate the inflected form for the lemma: "ნამდვილი", according to the following morphological descriptions: "ADJ;DAT(PL)"	 the inflected form for the le
Generate the inflected form for the lemma: "ნამდვილი", according to the following morphological descriptions: "ADJ;DAT(PL;LGSPEC2)"	 the inflected form for the le
Generate the inflected form for the lemma: "ნამდვილი", according to the following morphological descriptions: "ADJ;DAT(SG)"	 the inflected form for the le
Generate the inflected form for the lemma: "ნამდვილი", according to the following morphological descriptions: "ADJ;ERG(PL)"	 ნამდვილი", ac
Generate the inflected form for the lemma: "ნამდვილი", according to the following morphological descriptions: "ADJ;ERG(PL;LGSPEC2)"	 the inflected form for the le
Generate the inflected form for the lemma: "ნამდვილი", according to the following morphological descriptions: "ADJ;ERG(SG)"	 the inflected form for the le
Generate the inflected form for the lemma: "ნამდვილი", according to the following morphological descriptions: "ADJ;FRML(PL)"	 the inflected form for the le
Generate the inflected form for the lemma: "ნამდვილი", according to the following morphological descriptions: "ADJ;FRML(SG)"	 the inflected form for the le
Generate the inflected form for the lemma: "ნამდვილი", according to the following morphological descriptions: "ADJ;GEN(PL)"	ამდვილი", accord
Generate the inflected form for the lemma: "ნამდვილი", according to the following morphological descriptions: "ADJ;GEN(PL;LGSPEC2)"	 the inflected form for the le
Generate the inflected form for the lemma: "ნამდვილი", according to the following morphological descriptions: "ADJ;GEN(SG)"	ამდვილი", accord
Generate the inflected form for the lemma: "ნამდვილი", according to the following morphological descriptions: "ADJ;INS(PL)"	 ნამდვილი", ac
Generate the inflected form for the lemma: "ნამდვილი", according to the following morphological descriptions: "ADJ;INS(SG)"	 the inflected form for the le
Generate the inflected form for the lemma: "ნამდვილი", according to the following morphological descriptions: "ADJ;NOM(PL)"	 the inflected form for the le
Generate the inflected form for the lemma: "ნამდვილი", according to the following morphological descriptions: "ADJ;NOM(PL;LGSPEC2)"	 the inflected form for the le
Generate the inflected form for the lemma: "ნამდვილი", according to the following morphological descriptions: "ADJ;NOM(SG)"	 the inflected form for the le
Generate the inflected form for the lemma: "ნამდვილი", according to the following morphological descriptions: "ADJ;VOC(PL)"	 the inflected form for the le
Generate the inflected form for the lemma: "ნამდვილი", according to the following morphological descriptions: "ADJ;VOC(PL;LGSPEC2)"	 the inflected form for the le
Generate the inflected form for the lemma: "ნამდვილი", according to the following morphological descriptions: "ADJ;VOC(SG)"	 the inflected form for the le
Generate the inflected form for the lemma: "ოლქი", according to the following morphological descriptions: "N;DAT(PL)"	ოლქი", according to th
Generate the inflected form for the lemma: "ოლქი", according to the following morphological descriptions: "N;DAT(PL;LGSPEC2)"	ოლქი" ოლქი ო
Generate the inflected form for the lemma: "ოლქი", according to the following morphological descriptions: "N;DAT(SG)"	ოლქი", according to th
Generate the inflected form for the lemma: "ოლქი", according to the following morphological descriptions: "N;ERG(PL)"	ოლქი", according to th
Generate the inflected form for the lemma: "ოლქი", according to the following morphological descriptions: "N;ERG(PL;LGSPEC2)"	ოლქი" ოლქი ო
Generate the inflected form for the lemma: "ოლქი", according to the following morphological descriptions: "N;ERG(SG)"	ოლქი", according to th
Generate the inflected form for the lemma: "ოლქი", according to the following morphological descriptions: "N;FRML(PL)"	ოლქი", according to th
Generate the inflected form for the lemma: "ოლქი", according to the following morphological descriptions: "N;FRML(SG)"	ოლქი", according to th
Generate the inflected form for the lemma: "ოლქი", according to the following morphological descriptions: "N;GEN(PL)"	ოლქი", according to th
Generate the inflected form for the lemma: "ოლქი", according to the following morphological descriptions: "N;GEN(PL;LGSPEC2)"	ოლქი" ოლქი ო
Generate the inflected form for the lemma: "ოლქი", according to the following morphological descriptions: "N;GEN(SG)"	ოლქი", according to th
Generate the inflected form for the lemma: "ოლქი", according to the following morphological descriptions: "N;INS(PL)"	ოლქი", according to th
Generate the inflected form for the lemma: "ოლქი", according to the following morphological descriptions: "N;INS(SG)"	ოლქი", according to th
Generate the inflected form for the lemma: "ოლქი", according to the following morphological descriptions: "N;NOM(PL)"	ოლქი", according to th
Generate the inflected form for the lemma: "ოლქი", according to the following morphological descriptions: "N;NOM(PL;LGSPEC2)"	ოლქი" ოლქი ო
Generate the inflected form for the lemma: "ოლქი", according to the following morphological descriptions: "N;NOM(SG)"	ოლქი", according to th
Generate the inflected form for the lemma: "ოლქი", according to the following morphological descriptions: "N;VOC(PL)"	ოლქი", according to th
Generate the inflected form for the lemma: "ოლქი", according to the following morphological descriptions: "N;VOC(PL;LGSPEC2)"	ოლქი" ოლქი" 
Generate the inflected form for the lemma: "ოლქი", according to the following morphological descriptions: "N;VOC(SG)"	ოლქი", according to th
Generate the inflected form for the lemma: "სამერცხული", according to the following morphological descriptions: "N;DAT(PL)"	 the inflected form for the le
Generate the inflected form for the lemma: "სამერცხული", according to the following morphological descriptions: "N;DAT(PL;LGSPEC2)"	 the inflected form for the le
Generate the inflected form for the lemma: "სამერცხული", according to the following morphological descriptions: "N;DAT(SG)"	 the inflected form for the le
Generate the inflected form for the lemma: "სამერცხული", according to the following morphological descriptions: "N;ERG(PL)"	 "სამერცხულ
Generate the inflected form for the lemma: "სამერცხული", according to the following morphological descriptions: "N;ERG(PL;LGSPEC2)"	 the inflected form for the le
Generate the inflected form for the lemma: "სამერცხული", according to the following morphological descriptions: "N;ERG(SG)"	არაკონტაქტ
Generate the inflected form for the lemma: "სამერცხული", according to the following morphological descriptions: "N;FRML(PL)"	 for the lemma: "სამე
Generate the inflected form for the lemma: "სამერცხული", according to the following morphological descriptions: "N;FRML(SG)"	 for the lemma: "სამე
Generate the inflected form for the lemma: "სამერცხული", according to the following morphological descriptions: "N;GEN(PL)"	არაკონტაქტ
Generate the inflected form for the lemma: "სამერცხული", according to the following morphological descriptions: "N;GEN(PL;LGSPEC2)"	 the inflected form for the le
Generate the inflected form for the lemma: "სამერცხული", according to the following morphological descriptions: "N;GEN(SG)"	არაკონტაქტ
Generate the inflected form for the lemma: "სამერცხული", according to the following morphological descriptions: "N;INS(PL)"	 the inflected form for the le
Generate the inflected form for the lemma: "სამერცხული", according to the following morphological descriptions: "N;INS(SG)"	 "სამერცხულ
Generate the inflected form for the lemma: "სამერცხული", according to the following morphological descriptions: "N;NOM(PL)"	არაკონტაქტ
Generate the inflected form for the lemma: "სამერცხული", according to the following morphological descriptions: "N;NOM(PL;LGSPEC2)"	 the inflected form for the le
Generate the inflected form for the lemma: "სამერცხული", according to the following morphological descriptions: "N;NOM(SG)"	არაკონტაქტ
Generate the inflected form for the lemma: "სამერცხული", according to the following morphological descriptions: "N;VOC(PL)"	 the inflected form for the le
Generate the inflected form for the lemma: "სამერცხული", according to the following morphological descriptions: "N;VOC(PL;LGSPEC2)"	 the inflected form for the le
Generate the inflected form for the lemma: "სამერცხული", according to the following morphological descriptions: "N;VOC(SG)"	 "სამერცხულ
Generate the inflected form for the lemma: "სარჩელი", according to the following morphological descriptions: "N;DAT(PL)"	 სარჩელი", accor
Generate the inflected form for the lemma: "სარჩელი", according to the following morphological descriptions: "N;DAT(PL;LGSPEC2)"	 the inflected form for the le
Generate the inflected form for the lemma: "სარჩელი", according to the following morphological descriptions: "N;DAT(SG)"	 სარჩელი", accor
Generate the inflected form for the lemma: "სარჩელი", according to the following morphological descriptions: "N;ERG(PL)"	 სარჩელი", accor
Generate the inflected form for the lemma: "სარჩელი", according to the following morphological descriptions: "N;ERG(PL;LGSPEC2)"	 the inflected form for the le
Generate the inflected form for the lemma: "სარჩელი", according to the following morphological descriptions: "N;ERG(SG)"	 სარჩელი", accor
Generate the inflected form for the lemma: "სარჩელი", according to the following morphological descriptions: "N;FRML(PL)"	 for the lemma: "სარჩ
Generate the inflected form for the lemma: "სარჩელი", according to the following morphological descriptions: "N;FRML(SG)"	 for the lemma: "სარჩ
Generate the inflected form for the lemma: "სარჩელი", according to the following morphological descriptions: "N;GEN(PL)"	 for the lemma: "სარჩ
Generate the inflected form for the lemma: "სარჩელი", according to the following morphological descriptions: "N;GEN(PL;LGSPEC2)"	 the inflected form for the le
Generate the inflected form for the lemma: "სარჩელი", according to the following morphological descriptions: "N;GEN(SG)"	 for the lemma: "სარჩ
Generate the inflected form for the lemma: "სარჩელი", according to the following morphological descriptions: "N;INS(PL)"	 სარჩელი", accor
Generate the inflected form for the lemma: "სარჩელი", according to the following morphological descriptions: "N;INS(SG)"	 for the lemma: "სარჩ
Generate the inflected form for the lemma: "სარჩელი", according to the following morphological descriptions: "N;NOM(PL)"	 სარჩელი", accor
Generate the inflected form for the lemma: "სარჩელი", according to the following morphological descriptions: "N;NOM(PL;LGSPEC2)"	 the inflected form for the le
Generate the inflected form for the lemma: "სარჩელი", according to the following morphological descriptions: "N;NOM(SG)"	 სარჩელი", accor
Generate the inflected form for the lemma: "სარჩელი", according to the following morphological descriptions: "N;VOC(PL)"	 სარჩელი", accor
Generate the inflected form for the lemma: "სარჩელი", according to the following morphological descriptions: "N;VOC(PL;LGSPEC2)"	 the inflected form for the le
Generate the inflected form for the lemma: "სარჩელი", according to the following morphological descriptions: "N;VOC(SG)"	 "სარჩელი", acco
Generate the inflected form for the lemma: "საწყალი", according to the following morphological descriptions: "ADJ;DAT(PL)"	ალათი", according to
Generate the inflected form for the lemma: "საწყალი", according to the following morphological descriptions: "ADJ;DAT(PL;LGSPEC2)"	 the inflected form for the le
Generate the inflected form for the lemma: "საწყალი", according to the following morphological descriptions: "ADJ;DAT(SG)"	ალათი", according to
Generate the inflected form for the lemma: "საწყალი", according to the following morphological descriptions: "ADJ;ERG(PL)"	ალისტური ს
Generate the inflected form for the lemma: "საწყალი", according to the following morphological descriptions: "ADJ;ERG(PL;LGSPEC2)"	 the inflected form for the le
Generate the inflected form for the lemma: "საწყალი", according to the following morphological descriptions: "ADJ;ERG(SG)"	ალისტური ს
Generate the inflected form for the lemma: "საწყალი", according to the following morphological descriptions: "ADJ;FRML(PL)"	 საწყალი", accor
Generate the inflected form for the lemma: "საწყალი", according to the following morphological descriptions: "ADJ;FRML(SG)"	 for the lemma: "საწყ
Generate the inflected form for the lemma: "საწყალი", according to the following morphological descriptions: "ADJ;GEN(PL)"	ალი", according to the f
Generate the inflected form for the lemma: "საწყალი", according to the following morphological descriptions: "ADJ;GEN(PL;LGSPEC2)"	 the inflected form for the le
Generate the inflected form for the lemma: "საწყალი", according to the following morphological descriptions: "ADJ;GEN(SG)"	ალათი", according to
Generate the inflected form for the lemma: "საწყალი", according to the following morphological descriptions: "ADJ;INS(PL)"	ალის საწყა
Generate the inflected form for the lemma: "საწყალი", according to the following morphological descriptions: "ADJ;INS(SG)"	ალის საწყა
Generate the inflected form for the lemma: "საწყალი", according to the following morphological descriptions: "ADJ;NOM(PL)"	ალისტური ს
Generate the inflected form for the lemma: "საწყალი", according to the following morphological descriptions: "ADJ;NOM(PL;LGSPEC2)"	 the inflected form for the le
Generate the inflected form for the lemma: "საწყალი", according to the following morphological descriptions: "ADJ;NOM(SG)"	ალათი", according to
Generate the inflected form for the lemma: "საწყალი", according to the following morphological descriptions: "ADJ;VOC(PL)"	 საწყალი", accor
Generate the inflected form for the lemma: "საწყალი", according to the following morphological descriptions: "ADJ;VOC(PL;LGSPEC2)"	 the inflected form for the le
Generate the inflected form for the lemma: "საწყალი", according to the following morphological descriptions: "ADJ;VOC(SG)"	 the inflected form for the le
Generate the inflected form for the lemma: "სკანერი", according to the following morphological descriptions: "N;DAT(PL)"	 სკანერი", accor
Generate the inflected form for the lemma: "სკანერი", according to the following morphological descriptions: "N;DAT(PL;LGSPEC2)"	 სკანერი", accor
Generate the inflected form for the lemma: "სკანერი", according to the following morphological descriptions: "N;DAT(SG)"	 "სკანერი" ს
Generate the inflected form for the lemma: "სკანერი", according to the following morphological descriptions: "N;ERG(PL)"	 "სკანერი", acco
Generate the inflected form for the lemma: "სკანერი", according to the following morphological descriptions: "N;ERG(PL;LGSPEC2)"	 the inflected form for the le
Generate the inflected form for the lemma: "სკანერი", according to the following morphological descriptions: "N;ERG(SG)"	 "სკანერი", acco
Generate the inflected form for the lemma: "სკანერი", according to the following morphological descriptions: "N;FRML(PL)"	 სკანერი", accor
Generate the inflected form for the lemma: "სკანერი", according to the following morphological descriptions: "N;FRML(SG)"	ანერი", according to
Generate the inflected form for the lemma: "სკანერი", according to the following morphological descriptions: "N;GEN(PL)"	 სკანერი", accor
Generate the inflected form for the lemma: "სკანერი", according to the following morphological descriptions: "N;GEN(PL;LGSPEC2)"	 სკანერი", accor
Generate the inflected form for the lemma: "სკანერი", according to the following morphological descriptions: "N;GEN(SG)"	ანერი", according to
Generate the inflected form for the lemma: "სკანერი", according to the following morphological descriptions: "N;INS(PL)"	 სკანერი", accor
Generate the inflected form for the lemma: "სკანერი", according to the following morphological descriptions: "N;INS(SG)"	 "სკანერი", acco
Generate the inflected form for the lemma: "სკანერი", according to the following morphological descriptions: "N;NOM(PL)"	 სკანერი", accor
Generate the inflected form for the lemma: "სკანერი", according to the following morphological descriptions: "N;NOM(PL;LGSPEC2)"	 სკანერი", accor
Generate the inflected form for the lemma: "სკანერი", according to the following morphological descriptions: "N;NOM(SG)"	 "სკანერი", acco
Generate the inflected form for the lemma: "სკანერი", according to the following morphological descriptions: "N;VOC(PL)"	 "სკანერი", acco
Generate the inflected form for the lemma: "სკანერი", according to the following morphological descriptions: "N;VOC(PL;LGSPEC2)"	 the inflected form for the le
Generate the inflected form for the lemma: "სკანერი", according to the following morphological descriptions: "N;VOC(SG)"	 "სკანერი", acco
Generate the inflected form for the lemma: "ტექტონა", according to the following morphological descriptions: "N;DAT(PL)"	არაკონტაქტ
Generate the inflected form for the lemma: "ტექტონა", according to the following morphological descriptions: "N;DAT(PL;LGSPEC2)"	 ტექტონა", accor
Generate the inflected form for the lemma: "ტექტონა", according to the following morphological descriptions: "N;ERG(PL)"	 ტექტონა", accor
Generate the inflected form for the lemma: "ტექტონა", according to the following morphological descriptions: "N;ERG(PL;LGSPEC2)"	ანალიზაცია
Generate the inflected form for the lemma: "ტექტონა", according to the following morphological descriptions: "N;ERG(SG)"	არაკონტაქტ
Generate the inflected form for the lemma: "ტექტონა", according to the following morphological descriptions: "N;FRML(PL)"	ანალიზაცია
Generate the inflected form for the lemma: "ტექტონა", according to the following morphological descriptions: "N;FRML(SG)"	ანალიზაცია
Generate the inflected form for the lemma: "ტექტონა", according to the following morphological descriptions: "N;GEN(PL)"	არაკონტაქტ
Generate the inflected form for the lemma: "ტექტონა", according to the following morphological descriptions: "N;GEN(PL;LGSPEC2)"	 ტექტონა", accor
Generate the inflected form for the lemma: "ტექტონა", according to the following morphological descriptions: "N;GEN(SG)"	ანალიზაცია
Generate the inflected form for the lemma: "ტექტონა", according to the following morphological descriptions: "N;INS(PL)"	 ტექტონა", accor
Generate the inflected form for the lemma: "ტექტონა", according to the following morphological descriptions: "N;INS(SG)"	 ტექტონა", accor
Generate the inflected form for the lemma: "ტექტონა", according to the following morphological descriptions: "N;NOM(PL)"	არაკონტაქტ
Generate the inflected form for the lemma: "ტექტონა", according to the following morphological descriptions: "N;NOM(PL;LGSPEC2)"	 ტექტონა", accor
Generate the inflected form for the lemma: "ტექტონა", according to the following morphological descriptions: "N;NOM(SG)"	არაკონტაქტ
Generate the inflected form for the lemma: "ტექტონა", according to the following morphological descriptions: "N;VOC(PL)"	 ტექტონა", accor
Generate the inflected form for the lemma: "ტექტონა", according to the following morphological descriptions: "N;VOC(PL;LGSPEC2)"	ანალიზაცია
Generate the inflected form for the lemma: "უტყვი", according to the following morphological descriptions: "ADJ;DAT(PL)"	ის უტყვი უტ
Generate the inflected form for the lemma: "უტყვი", according to the following morphological descriptions: "ADJ;DAT(PL;LGSPEC2)"	ი", according to the followi
Generate the inflected form for the lemma: "უტყვი", according to the following morphological descriptions: "ADJ;DAT(SG)"	ის უტყვი უტ
Generate the inflected form for the lemma: "უტყვი", according to the following morphological descriptions: "ADJ;ERG(PL)"	ის უტყვი უტ
Generate the inflected form for the lemma: "უტყვი", according to the following morphological descriptions: "ADJ;ERG(PL;LGSPEC2)"	ის უტყვი უტ
Generate the inflected form for the lemma: "უტყვი", according to the following morphological descriptions: "ADJ;ERG(SG)"	ის უტყვი უტ
Generate the inflected form for the lemma: "უტყვი", according to the following morphological descriptions: "ADJ;FRML(PL)"	ის უტყვი უტ
Generate the inflected form for the lemma: "უტყვი", according to the following morphological descriptions: "ADJ;FRML(SG)"	ის უტყვი უტ
Generate the inflected form for the lemma: "უტყვი", according to the following morphological descriptions: "ADJ;GEN(PL)"	ი", according to the followi
Generate the inflected form for the lemma: "უტყვი", according to the following morphological descriptions: "ADJ;GEN(PL;LGSPEC2)"	ი", according to the followi
Generate the inflected form for the lemma: "უტყვი", according to the following morphological descriptions: "ADJ;GEN(SG)"	ი", according to the followi
Generate the inflected form for the lemma: "უტყვი", according to the following morphological descriptions: "ADJ;INS(PL)"	უტყვი", according to
Generate the inflected form for the lemma: "უტყვი", according to the following morphological descriptions: "ADJ;INS(SG)"	უტყვი", according to
Generate the inflected form for the lemma: "უტყვი", according to the following morphological descriptions: "ADJ;NOM(PL)"	ის უტყვი უტ
Generate the inflected form for the lemma: "უტყვი", according to the following morphological descriptions: "ADJ;NOM(PL;LGSPEC2)"	ი", according to the followi
Generate the inflected form for the lemma: "უტყვი", according to the following morphological descriptions: "ADJ;NOM(SG)"	ის უტყვი უტ
Generate the inflected form for the lemma: "უტყვი", according to the following morphological descriptions: "ADJ;VOC(PL)"	ის უტყვი უტ
Generate the inflected form for the lemma: "უტყვი", according to the following morphological descriptions: "ADJ;VOC(PL;LGSPEC2)"	ი", according to the followi
Generate the inflected form for the lemma: "უტყვი", according to the following morphological descriptions: "ADJ;VOC(SG)"	ის უტყვი უტ
Generate the inflected form for the lemma: "ფრაზა", according to the following morphological descriptions: "N;DAT(PL)"	 ფრაზა" ფრაზ
Generate the inflected form for the lemma: "ფრაზა", according to the following morphological descriptions: "N;DAT(PL;LGSPEC2)"	 ფრაზა", according t
Generate the inflected form for the lemma: "ფრაზა", according to the following morphological descriptions: "N;DAT(SG)"	აზარიანი" ფ
Generate the inflected form for the lemma: "ფრაზა", according to the following morphological descriptions: "N;ERG(PL)"	 ფრაზა". "N;ERG(PL)"
Generate the inflected form for the lemma: "ფრაზა", according to the following morphological descriptions: "N;ERG(PL;LGSPEC2)"	 for the lemma: "ფრაზ
Generate the inflected form for the lemma: "ფრაზა", according to the following morphological descriptions: "N;ERG(SG)"	აზარიანი ფ
Generate the inflected form for the lemma: "ფრაზა", according to the following morphological descriptions: "N;FRML(PL)"	აზარიანი ფ
Generate the inflected form for the lemma: "ფრაზა", according to the following morphological descriptions: "N;FRML(SG)"	აზარიანი ფ
Generate the inflected form for the lemma: "ფრაზა", according to the following morphological descriptions: "N;GEN(PL)"	აზარიანი" ფ
Generate the inflected form for the lemma: "ფრაზა", according to the following morphological descriptions: "N;GEN(PL;LGSPEC2)"	 ფრაზა", according t
Generate the inflected form for the lemma: "ფრაზა", according to the following morphological descriptions: "N;GEN(SG)"	აზარიანი ფ
Generate the inflected form for the lemma: "ფრაზა", according to the following morphological descriptions: "N;INS(PL)"	 ფრაზა" ფრაზ
Generate the inflected form for the lemma: "ფრაზა", according to the following morphological descriptions: "N;INS(SG)"	 ფრაზა" ფრაზ
Generate the inflected form for the lemma: "ფრაზა", according to the following morphological descriptions: "N;NOM(PL)"	აზარიანი". "N;
Generate the inflected form for the lemma: "ფრაზა", according to the following morphological descriptions: "N;NOM(PL;LGSPEC2)"	 ფრაზა", according t
Generate the inflected form for the lemma: "ფრაზა", according to the following morphological descriptions: "N;NOM(SG)"	აზარიანი ფ
Generate the inflected form for the lemma: "ფრაზა", according to the following morphological descriptions: "N;VOC(PL)"	 "ფრაზა" ფრა
Generate the inflected form for the lemma: "ფრაზა", according to the following morphological descriptions: "N;VOC(PL;LGSPEC2)"	 for the lemma: "ფრაზ
Generate the inflected form for the lemma: "ფრაზა", according to the following morphological descriptions: "N;VOC(SG)"	 "ფრაზა" ფრა
Generate the inflected form for the lemma: "ღერო", according to the following morphological descriptions: "N;DAT(PL)"	არო" - "ღერო" - 
Generate the inflected form for the lemma: "ღერო", according to the following morphological descriptions: "N;DAT(PL;LGSPEC2)"	 for the lemma: "ღერო"
Generate the inflected form for the lemma: "ღერო", according to the following morphological descriptions: "N;DAT(SG)"	არო" - "ღერო" - 
Generate the inflected form for the lemma: "ღერო", according to the following morphological descriptions: "N;ERG(PL)"	არო" - ღეროს 
Generate the inflected form for the lemma: "ღერო", according to the following morphological descriptions: "N;ERG(PL;LGSPEC2)"	არო" (ღერო) (ღ
Generate the inflected form for the lemma: "ღერო", according to the following morphological descriptions: "N;ERG(SG)"	არო" - "ღერო" - 
Generate the inflected form for the lemma: "ღერო", according to the following morphological descriptions: "N;FRML(PL)"	არო" - "ღერო" - 
Generate the inflected form for the lemma: "ღერო", according to the following morphological descriptions: "N;FRML(SG)"	არო" - "ღერო" - 
Generate the inflected form for the lemma: "ღერო", according to the following morphological descriptions: "N;GEN(PL)"	არო" - "ღერო" - 
Generate the inflected form for the lemma: "ღერო", according to the following morphological descriptions: "N;GEN(PL;LGSPEC2)"	 for the lemma: "ღერო"
Generate the inflected form for the lemma: "ღერო", according to the following morphological descriptions: "N;GEN(SG)"	არო" - "ღერო" - 
Generate the inflected form for the lemma: "ღერო", according to the following morphological descriptions: "N;INS(PL)"	არო" - "ღერო" - 
Generate the inflected form for the lemma: "ღერო", according to the following morphological descriptions: "N;INS(SG)"	არო" - "ღერო" - 
Generate the inflected form for the lemma: "ღერო", according to the following morphological descriptions: "N;NOM(PL)"	არო" - "ღერო" - 
Generate the inflected form for the lemma: "ღერო", according to the following morphological descriptions: "N;NOM(PL;LGSPEC2)"	 for the lemma: "ღერო"
Generate the inflected form for the lemma: "ღერო", according to the following morphological descriptions: "N;NOM(SG)"	არო" - "ღერო" - 
Generate the inflected form for the lemma: "ღერო", according to the following morphological descriptions: "N;VOC(PL)"	არო" - "ღერო" - 
Generate the inflected form for the lemma: "ღერო", according to the following morphological descriptions: "N;VOC(PL;LGSPEC2)"	 ღერო" ღერო" 
Generate the inflected form for the lemma: "ღერო", according to the following morphological descriptions: "N;VOC(SG)"	არო" - "ღერო" - 
Generate the inflected form for the lemma: "ყვერული", according to the following morphological descriptions: "N;DAT(PL)"	 ყვერული", accor
Generate the inflected form for the lemma: "ყვერული", according to the following morphological descriptions: "N;DAT(PL;LGSPEC2)"	 ყვერული", accor
Generate the inflected form for the lemma: "ყვერული", according to the following morphological descriptions: "N;DAT(SG)"	არისკაცი", acc
Generate the inflected form for the lemma: "ყვერული", according to the following morphological descriptions: "N;ERG(PL)"	არისკაცი", acc
Generate the inflected form for the lemma: "ყვერული", according to the following morphological descriptions: "N;ERG(PL;LGSPEC2)"	 the inflected form for the le
Generate the inflected form for the lemma: "ყვერული", according to the following morphological descriptions: "N;ERG(SG)"	არისკაცი", acc
Generate the inflected form for the lemma: "ყვერული", according to the following morphological descriptions: "N;FRML(PL)"	არისკული", acc
Generate the inflected form for the lemma: "ყვერული", according to the following morphological descriptions: "N;FRML(SG)"	არისკულაცი
Generate the inflected form for the lemma: "ყვერული", according to the following morphological descriptions: "N;GEN(PL)"	არისკაცი", acc
Generate the inflected form for the lemma: "ყვერული", according to the following morphological descriptions: "N;GEN(PL;LGSPEC2)"	 ყვერული", accor
Generate the inflected form for the lemma: "ყვერული", according to the following morphological descriptions: "N;GEN(SG)"	არისკაცი", acc
Generate the inflected form for the lemma: "ყვერული", according to the following morphological descriptions: "N;INS(PL)"	 ყვერული", accor
Generate the inflected form for the lemma: "ყვერული", according to the following morphological descriptions: "N;INS(SG)"	არისხალი ყ
Generate the inflected form for the lemma: "ყვერული", according to the following morphological descriptions: "N;NOM(PL)"	არისკაცი", acc
Generate the inflected form for the lemma: "ყვერული", according to the following morphological descriptions: "N;NOM(PL;LGSPEC2)"	 ყვერული", accor
Generate the inflected form for the lemma: "ყვერული", according to the following morphological descriptions: "N;NOM(SG)"	არისკაცი", acc
Generate the inflected form for the lemma: "ყვერული", according to the following morphological descriptions: "N;VOC(PL)"	 ყვერული", accor
Generate the inflected form for the lemma: "ყვერული", according to the following morphological descriptions: "N;VOC(PL;LGSPEC2)"	 the inflected form for the le
Generate the inflected form for the lemma: "ყვერული", according to the following morphological descriptions: "N;VOC(SG)"	 "ყვერული", acco
Generate the inflected form for the lemma: "შხაპი", according to the following morphological descriptions: "N;DAT(PL)"	არის შხაპი".
Generate the inflected form for the lemma: "შხაპი", according to the following morphological descriptions: "N;DAT(PL;LGSPEC2)"	 შხაპი", according t
Generate the inflected form for the lemma: "შხაპი", according to the following morphological descriptions: "N;DAT(SG)"	არის შხაპი".
Generate the inflected form for the lemma: "შხაპი", according to the following morphological descriptions: "N;ERG(PL)"	 შხაპი". "N;ERG(PL)"
Generate the inflected form for the lemma: "შხაპი", according to the following morphological descriptions: "N;ERG(PL;LGSPEC2)"	 შხაპი", according t
Generate the inflected form for the lemma: "შხაპი", according to the following morphological descriptions: "N;ERG(SG)"	არის შხაპი".
Generate the inflected form for the lemma: "შხაპი", according to the following morphological descriptions: "N;FRML(PL)"	არის შხაპი".
Generate the inflected form for the lemma: "შხაპი", according to the following morphological descriptions: "N;FRML(SG)"	არის შხაპი".
Generate the inflected form for the lemma: "შხაპი", according to the following morphological descriptions: "N;GEN(PL)"	არის შხაპი".
Generate the inflected form for the lemma: "შხაპი", according to the following morphological descriptions: "N;GEN(PL;LGSPEC2)"	 შხაპი", according t
Generate the inflected form for the lemma: "შხაპი", according to the following morphological descriptions: "N;GEN(SG)"	არის შხაპი".
Generate the inflected form for the lemma: "შხაპი", according to the following morphological descriptions: "N;INS(PL)"	არის შხაპი".
Generate the inflected form for the lemma: "შხაპი", according to the following morphological descriptions: "N;INS(SG)"	არის შხაპი".
Generate the inflected form for the lemma: "შხაპი", according to the following morphological descriptions: "N;NOM(PL)"	არის შხაპი".
Generate the inflected form for the lemma: "შხაპი", according to the following morphological descriptions: "N;NOM(PL;LGSPEC2)"	 შხაპი", according t
Generate the inflected form for the lemma: "შხაპი", according to the following morphological descriptions: "N;NOM(SG)"	არის შხაპი".
Generate the inflected form for the lemma: "შხაპი", according to the following morphological descriptions: "N;VOC(PL)"	 შხაპი". "N;VOC(PL)"
Generate the inflected form for the lemma: "შხაპი", according to the following morphological descriptions: "N;VOC(PL;LGSPEC2)"	 შხაპი", according t
Generate the inflected form for the lemma: "შხაპი", according to the following morphological descriptions: "N;VOC(SG)"	 შხაპი" (შხა
Generate the inflected form for the lemma: "ჩქარობს", according to the following morphological descriptions: "V;COND;NOM(3,PL)"	არს", according to the f
Generate the inflected form for the lemma: "ჩქარობს", according to the following morphological descriptions: "V;COND;NOM(3,SG)"	არსახს ჩქა
Generate the inflected form for the lemma: "ჩქარობს", according to the following morphological descriptions: "V;IND;FUT;NOM(2,SG)"	არს", according to the f
Generate the inflected form for the lemma: "ჩქარობს", according to the following morphological descriptions: "V;IND;FUT;NOM(3,PL)"	 for the lemma: "ჩქარ
Generate the inflected form for the lemma: "ჩქარობს", according to the following morphological descriptions: "V;IND;FUT;NOM(3,SG)"	არს", according to the f
Generate the inflected form for the lemma: "ჩქარობს", according to the following morphological descriptions: "V;IND;IPFV;NOM(1,PL)"	 for the lemma: "ჩქარ
Generate the inflected form for the lemma: "ჩქარობს", according to the following morphological descriptions: "V;IND;IPFV;NOM(3,PL)"	 for the lemma: "ჩქარ
Generate the inflected form for the lemma: "ჩქარობს", according to the following morphological descriptions: "V;IND;IPFV;NOM(3,SG)"	 for the lemma: "ჩქარ
Generate the inflected form for the lemma: "ჩქარობს", according to the following morphological descriptions: "V;IND;PRF;NOM(2,PL)"	 for the lemma: "ჩქარ
Generate the inflected form for the lemma: "ჩქარობს", according to the following morphological descriptions: "V;IND;PRF;NOM(2,SG)"	 for the lemma: "ჩქარ
Generate the inflected form for the lemma: "ჩქარობს", according to the following morphological descriptions: "V;IND;PRS;NOM(3,PL)"	 for the lemma: "ჩქარ
Generate the inflected form for the lemma: "ჩქარობს", according to the following morphological descriptions: "V;IND;PST;PFV;NOM(1,PL)"	 the inflected form for the le
Generate the inflected form for the lemma: "ჩქარობს", according to the following morphological descriptions: "V;IND;PST;PFV;NOM(1,SG)"	 the inflected form for the le
Generate the inflected form for the lemma: "ჩქარობს", according to the following morphological descriptions: "V;IND;PST;PFV;NOM(3,PL)"	 the inflected form for the le
Generate the inflected form for the lemma: "ჩქარობს", according to the following morphological descriptions: "V;IND;PST;PRF;NOM(1,PL)"	 the inflected form for the le
Generate the inflected form for the lemma: "ჩქარობს", according to the following morphological descriptions: "V;IND;PST;PRF;NOM(3,SG)"	 the inflected form for the le
Generate the inflected form for the lemma: "ჩქარობს", according to the following morphological descriptions: "V;OPT;NOM(1,PL)"	 the inflected form for the le
Generate the inflected form for the lemma: "ჩქარობს", according to the following morphological descriptions: "V;SBJV;FUT;NOM(1,SG)"	 the inflected form for the le
Generate the inflected form for the lemma: "ჩქარობს", according to the following morphological descriptions: "V;SBJV;FUT;NOM(2,PL)"	 the inflected form for the le
Generate the inflected form for the lemma: "ჩქარობს", according to the following morphological descriptions: "V;SBJV;FUT;NOM(3,PL)"	 the inflected form for the le
Generate the inflected form for the lemma: "ჩქარობს", according to the following morphological descriptions: "V;SBJV;FUT;NOM(3,SG)"	 the inflected form for the le
Generate the inflected form for the lemma: "ჩქარობს", according to the following morphological descriptions: "V;SBJV;PRF;NOM(2,SG)"	 the inflected form for the le
Generate the inflected form for the lemma: "ჩქარობს", according to the following morphological descriptions: "V;SBJV;PRF;NOM(3,PL)"	 the inflected form for the le
Generate the inflected form for the lemma: "ჩქარობს", according to the following morphological descriptions: "V;SBJV;PRS;NOM(2,PL)"	 the inflected form for the le
Generate the inflected form for the lemma: "ჩქარობს", according to the following morphological descriptions: "V;SBJV;PRS;NOM(2,SG)"	არსახს ჩქა
Generate the inflected form for the lemma: "ჩქარობს", according to the following morphological descriptions: "V;SBJV;PRS;NOM(3,PL)"	 the inflected form for the le
Generate the inflected form for the lemma: "ცერობი", according to the following morphological descriptions: "N;DAT(PL)"	არის ცერობ
Generate the inflected form for the lemma: "ცერობი", according to the following morphological descriptions: "N;DAT(PL;LGSPEC2)"	 the inflected form for the le
Generate the inflected form for the lemma: "ცერობი", according to the following morphological descriptions: "N;DAT(SG)"	არის ცერობ
Generate the inflected form for the lemma: "ცერობი", according to the following morphological descriptions: "N;ERG(PL)"	არის მიზნი
Generate the inflected form for the lemma: "ცერობი", according to the following morphological descriptions: "N;ERG(PL;LGSPEC2)"	 the inflected form for the le
Generate the inflected form for the lemma: "ცერობი", according to the following morphological descriptions: "N;ERG(SG)"	არის მიზნი
Generate the inflected form for the lemma: "ცერობი", according to the following morphological descriptions: "N;FRML(PL)"	არის ცერობ
Generate the inflected form for the lemma: "ცერობი", according to the following morphological descriptions: "N;FRML(SG)"	არის ცერობ
Generate the inflected form for the lemma: "ცერობი", according to the following morphological descriptions: "N;GEN(PL)"	არის ცერობ
Generate the inflected form for the lemma: "ცერობი", according to the following morphological descriptions: "N;GEN(PL;LGSPEC2)"	 the inflected form for the le
Generate the inflected form for the lemma: "ცერობი", according to the following morphological descriptions: "N;GEN(SG)"	არის ცერობ
Generate the inflected form for the lemma: "ცერობი", according to the following morphological descriptions: "N;INS(PL)"	არის ცერობ
Generate the inflected form for the lemma: "ცერობი", according to the following morphological descriptions: "N;INS(SG)"	არის ცერობ
Generate the inflected form for the lemma: "ცერობი", according to the following morphological descriptions: "N;NOM(PL)"	არის სისხლ
Generate the inflected form for the lemma: "ცერობი", according to the following morphological descriptions: "N;NOM(PL;LGSPEC2)"	 the inflected form for the le
Generate the inflected form for the lemma: "ცერობი", according to the following morphological descriptions: "N;NOM(SG)"	არის ცერობ
Generate the inflected form for the lemma: "ცერობი", according to the following morphological descriptions: "N;VOC(PL)"	 ცერობი"
ცერ
Generate the inflected form for the lemma: "ცერობი", according to the following morphological descriptions: "N;VOC(PL;LGSPEC2)"	 the inflected form for the le
Generate the inflected form for the lemma: "ცერობი", according to the following morphological descriptions: "N;VOC(SG)"	 for the lemma: "ცერო
Generate the inflected form for the lemma: "ცური", according to the following morphological descriptions: "N;DAT(PL)"	ური" - ცური - 
Generate the inflected form for the lemma: "ცური", according to the following morphological descriptions: "N;DAT(PL;LGSPEC2)"	 ცური", according to t
Generate the inflected form for the lemma: "ცური", according to the following morphological descriptions: "N;DAT(SG)"	ური" - ცური - 
Generate the inflected form for the lemma: "ცური", according to the following morphological descriptions: "N;ERG(PL)"	ური", according to the f
Generate the inflected form for the lemma: "ცური", according to the following morphological descriptions: "N;ERG(PL;LGSPEC2)"	 ცური", according to t
Generate the inflected form for the lemma: "ცური", according to the following morphological descriptions: "N;ERG(SG)"	ური", according to the f
Generate the inflected form for the lemma: "ცური", according to the following morphological descriptions: "N;FRML(PL)"	ური" ცური" ც
Generate the inflected form for the lemma: "ცური", according to the following morphological descriptions: "N;FRML(SG)"	ური" ცური" ც
Generate the inflected form for the lemma: "ცური", according to the following morphological descriptions: "N;GEN(PL)"	ური", according to the f
Generate the inflected form for the lemma: "ცური", according to the following morphological descriptions: "N;GEN(PL;LGSPEC2)"	 ცური" ცური" 
Generate the inflected form for the lemma: "ცური", according to the following morphological descriptions: "N;GEN(SG)"	ური", according to the f
Generate the inflected form for the lemma: "ცური", according to the following morphological descriptions: "N;INS(PL)"	ური" ცური ცუ
Generate the inflected form for the lemma: "ცური", according to the following morphological descriptions: "N;INS(SG)"	ური" (ცური) (ც
Generate the inflected form for the lemma: "ცური", according to the following morphological descriptions: "N;NOM(PL)"	ური" ცური ცუ
Generate the inflected form for the lemma: "ცური", according to the following morphological descriptions: "N;NOM(PL;LGSPEC2)"	 for the lemma: "ცური"
Generate the inflected form for the lemma: "ცური", according to the following morphological descriptions: "N;VOC(PL)"	ური" ცური ცუ
Generate the inflected form for the lemma: "ცური", according to the following morphological descriptions: "N;VOC(PL;LGSPEC2)"	 ცური" ცური" 
Generate the inflected form for the lemma: "ცური", according to the following morphological descriptions: "N;VOC(SG)"	ური" ცური ცუ
Generate the inflected form for the lemma: "წონის", according to the following morphological descriptions: "V;COND;NOM(1,PL);ACC(2,PL)"	 for the lemma: "წონი
Generate the inflected form for the lemma: "წონის", according to the following morphological descriptions: "V;COND;NOM(1,PL);ACC(3,SG)"	 წონის", according t
Generate the inflected form for the lemma: "წონის", according to the following morphological descriptions: "V;IND;IPFV;NOM(1,PL);ACC(2,PL)"	 წონის", according t
Generate the inflected form for the lemma: "წონის", according to the following morphological descriptions: "V;IND;IPFV;NOM(1,PL);ACC(3,SG)"	 წონის", according t
Generate the inflected form for the lemma: "წონის", according to the following morphological descriptions: "V;IND;IPFV;NOM(1,SG);ACC(3,PL)"	 წონის", according t
Generate the inflected form for the lemma: "წონის", according to the following morphological descriptions: "V;IND;IPFV;NOM(2,PL);ACC(3,PL)"	 წონის", according t
Generate the inflected form for the lemma: "წონის", according to the following morphological descriptions: "V;IND;PRS;NOM(3,SG);ACC(2,SG)"	 წონის", according t
Generate the inflected form for the lemma: "წონის", according to the following morphological descriptions: "V;IND;PRS;NOM(3,SG);ACC(3,PL)"	 წონის", according t
Generate the inflected form for the lemma: "წონის", according to the following morphological descriptions: "V;IND;PST;PFV;NOM(1,PL);ACC(3,SG)"	 the inflected form for the le
Generate the inflected form for the lemma: "წონის", according to the following morphological descriptions: "V;IND;PST;PFV;NOM(1,SG);ACC(2,PL)"	 the inflected form for the le
Generate the inflected form for the lemma: "წონის", according to the following morphological descriptions: "V;IND;PST;PFV;NOM(1,SG);ACC(3,PL)"	 the inflected form for the le
Generate the inflected form for the lemma: "წონის", according to the following morphological descriptions: "V;IND;PST;PFV;NOM(2,PL);ACC(1,PL)"	ანის", according to th
Generate the inflected form for the lemma: "წონის", according to the following morphological descriptions: "V;IND;PST;PFV;NOM(2,SG);ACC(1,PL)"	 the inflected form for the le
Generate the inflected form for the lemma: "წონის", according to the following morphological descriptions: "V;IND;PST;PFV;NOM(3,SG);ACC(3,SG)"	ანის", according to th
Generate the inflected form for the lemma: "წონის", according to the following morphological descriptions: "V;IND;PST;PRF;NOM(1,PL);ACC(2,SG)"	 წონის", according t
Generate the inflected form for the lemma: "წონის", according to the following morphological descriptions: "V;OPT;NOM(2,SG);ACC(1,PL)"	 for the lemma: "წონი
Generate the inflected form for the lemma: "წონის", according to the following morphological descriptions: "V;OPT;NOM(3,PL);ACC(1,PL)"	 for the lemma: "წონი
Generate the inflected form for the lemma: "წონის", according to the following morphological descriptions: "V;OPT;NOM(3,PL);ACC(2,SG)"	 for the lemma: "წონი
Generate the inflected form for the lemma: "წონის", according to the following morphological descriptions: "V;OPT;NOM(3,SG);ACC(2,PL)"	 for the lemma: "წონი
Generate the inflected form for the lemma: "წონის", according to the following morphological descriptions: "V;SBJV;FUT;NOM(1,SG);ACC(3,PL)"	 the inflected form for the le
Generate the inflected form for the lemma: "წონის", according to the following morphological descriptions: "V;SBJV;FUT;NOM(3,PL);ACC(1,SG)"	 წონის", according t
Generate the inflected form for the lemma: "წონის", according to the following morphological descriptions: "V;SBJV;FUT;NOM(3,SG);ACC(1,SG)"	 წონის", according t
Generate the inflected form for the lemma: "წონის", according to the following morphological descriptions: "V;SBJV;PRF;NOM(1,PL);ACC(3,SG)"	 წონის", according t
Generate the inflected form for the lemma: "წონის", according to the following morphological descriptions: "V;SBJV;PRF;NOM(2,PL);ACC(3,SG)"	 წონის", according t
Generate the inflected form for the lemma: "წონის", according to the following morphological descriptions: "V;SBJV;PRF;NOM(3,PL);ACC(2,SG)"	 წონის", according t
Generate the inflected form for the lemma: "წონის", according to the following morphological descriptions: "V;SBJV;PRS;NOM(2,PL);ACC(1,PL)"	 the inflected form for the le
Generate the inflected form for the lemma: "ჭილიბი", according to the following morphological descriptions: "N;DAT(PL)"	ილიბი"
"ჭილი
Generate the inflected form for the lemma: "ჭილიბი", according to the following morphological descriptions: "N;DAT(PL;LGSPEC2)"	 for the lemma: "ჭილი
Generate the inflected form for the lemma: "ჭილიბი", according to the following morphological descriptions: "N;DAT(SG)"	ილიბი"
"ჭილი
Generate the inflected form for the lemma: "ჭილიბი", according to the following morphological descriptions: "N;ERG(PL)"	იბი" - "ჭილიბ
Generate the inflected form for the lemma: "ჭილიბი", according to the following morphological descriptions: "N;ERG(PL;LGSPEC2)"	 for the lemma: "ჭილი
Generate the inflected form for the lemma: "ჭილიბი", according to the following morphological descriptions: "N;ERG(SG)"	იბი" - "ჭილიბ
Generate the inflected form for the lemma: "ჭილიბი", according to the following morphological descriptions: "N;FRML(PL)"	იბი"
"ჭილიბი
Generate the inflected form for the lemma: "ჭილიბი", according to the following morphological descriptions: "N;FRML(SG)"	იბი"
"ჭილიბი
Generate the inflected form for the lemma: "ჭილიბი", according to the following morphological descriptions: "N;GEN(PL)"	ილიბი" - "ჭილ
Generate the inflected form for the lemma: "ჭილიბი", according to the following morphological descriptions: "N;GEN(PL;LGSPEC2)"	 for the lemma: "ჭილი
Generate the inflected form for the lemma: "ჭილიბი", according to the following morphological descriptions: "N;GEN(SG)"	ილიბი" - "ჭილ
Generate the inflected form for the lemma: "ჭილიბი", according to the following morphological descriptions: "N;INS(PL)"	ილიბი"
Generate the 
Generate the inflected form for the lemma: "ჭილიბი", according to the following morphological descriptions: "N;INS(SG)"	იბი"
Generate the inflec
Generate the inflected form for the lemma: "ჭილიბი", according to the following morphological descriptions: "N;NOM(PL)"	იბი" - "ჭილიბ
Generate the inflected form for the lemma: "ჭილიბი", according to the following morphological descriptions: "N;NOM(PL;LGSPEC2)"	 for the lemma: "ჭილი
Generate the inflected form for the lemma: "ჭილიბი", according to the following morphological descriptions: "N;NOM(SG)"	იბი" - "ჭილიბ
Generate the inflected form for the lemma: "ჭილიბი", according to the following morphological descriptions: "N;VOC(PL)"	ილიბი"
Generate the 
Generate the inflected form for the lemma: "ჭილიბი", according to the following morphological descriptions: "N;VOC(PL;LGSPEC2)"	 for the lemma: "ჭილი
Generate the inflected form for the lemma: "ჭილიბი", according to the following morphological descriptions: "N;VOC(SG)"	 "ჭილიბის ჭი
Generate the inflected form for the lemma: "ჭრის", according to the following morphological descriptions: "V;COND;NOM(2,PL);ACC(1,PL)"	 form for the lemma: "ჭრ
Generate the inflected form for the lemma: "ჭრის", according to the following morphological descriptions: "V;IMP;NOM(2,PL);ACC(3,PL)"	 form for the lemma: "ჭრ
Generate the inflected form for the lemma: "ჭრის", according to the following morphological descriptions: "V;IMP;NOM(3,SG);ACC(3,PL)"	 form for the lemma: "ჭრ
Generate the inflected form for the lemma: "ჭრის", according to the following morphological descriptions: "V;IND;FUT;NOM(1,PL);ACC(3,PL)"	 ჭრის", according to t
Generate the inflected form for the lemma: "ჭრის", according to the following morphological descriptions: "V;IND;FUT;NOM(1,PL);ACC(3,SG)"	 ჭრის", according to t
Generate the inflected form for the lemma: "ჭრის", according to the following morphological descriptions: "V;IND;FUT;NOM(1,SG);ACC(2,SG)"	 ჭრის", according to t
Generate the inflected form for the lemma: "ჭრის", according to the following morphological descriptions: "V;IND;FUT;NOM(2,PL);ACC(3,SG)"	 ჭრის", according to t
Generate the inflected form for the lemma: "ჭრის", according to the following morphological descriptions: "V;IND;FUT;NOM(3,SG);ACC(1,SG)"	 ჭრის", according to t
Generate the inflected form for the lemma: "ჭრის", according to the following morphological descriptions: "V;IND;PRF;NOM(1,PL);ACC(2,PL)"	 ჭრის", according to t
Generate the inflected form for the lemma: "ჭრის", according to the following morphological descriptions: "V;IND;PRF;NOM(1,PL);ACC(2,SG)"	 ჭრის", according to t
Generate the inflected form for the lemma: "ჭრის", according to the following morphological descriptions: "V;IND;PRF;NOM(2,SG);ACC(1,SG)"	 ჭრის", according to t
Generate the inflected form for the lemma: "ჭრის", according to the following morphological descriptions: "V;IND;PRF;NOM(3,PL);ACC(1,PL)"	 ჭრის", according to t
Generate the inflected form for the lemma: "ჭრის", according to the following morphological descriptions: "V;IND;PRF;NOM(3,PL);ACC(3,SG)"	 ჭრის", according to t
Generate the inflected form for the lemma: "ჭრის", according to the following morphological descriptions: "V;IND;PRS;NOM(1,PL);ACC(3,PL)"	 ჭრის", according to t
Generate the inflected form for the lemma: "ჭრის", according to the following morphological descriptions: "V;IND;PRS;NOM(3,SG);ACC(1,SG)"	 ჭრის", according to t
Generate the inflected form for the lemma: "ჭრის", according to the following morphological descriptions: "V;IND;PST;PFV;NOM(3,PL);ACC(1,SG)"	 ჭრის", according to t
Generate the inflected form for the lemma: "ჭრის", according to the following morphological descriptions: "V;IND;PST;PFV;NOM(3,PL);ACC(2,SG)"	 ჭრის", according to t
Generate the inflected form for the lemma: "ჭრის", according to the following morphological descriptions: "V;IND;PST;PFV;NOM(3,SG);ACC(2,SG)"	ის", according to the foll
Generate the inflected form for the lemma: "ჭრის", according to the following morphological descriptions: "V;IND;PST;PRF;NOM(1,PL);ACC(2,PL)"	 ჭრის", according to t
Generate the inflected form for the lemma: "ჭრის", according to the following morphological descriptions: "V;IND;PST;PRF;NOM(2,PL);ACC(3,PL)"	 ჭრის", according to t
Generate the inflected form for the lemma: "ჭრის", according to the following morphological descriptions: "V;OPT;NOM(3,PL);ACC(3,PL)"	 for the lemma: "ჭრის"
Generate the inflected form for the lemma: "ჭრის", according to the following morphological descriptions: "V;OPT;NOM(3,SG);ACC(1,SG)"	 for the lemma: "ჭრის"
Generate the inflected form for the lemma: "ჭრის", according to the following morphological descriptions: "V;SBJV;FUT;NOM(1,PL);ACC(2,PL)"	 ჭრის", according to t
Generate the inflected form for the lemma: "ჭრის", according to the following morphological descriptions: "V;SBJV;FUT;NOM(1,SG);ACC(2,PL)"	 the inflected form for the le
Generate the inflected form for the lemma: "ჭრის", according to the following morphological descriptions: "V;SBJV;FUT;NOM(3,SG);ACC(3,SG)"	 ჭრის", according to t
Generate the inflected form for the lemma: "ჭრის", according to the following morphological descriptions: "V;SBJV;PRS;NOM(3,SG);ACC(1,PL)"	 ჭრის", according to t
Generate the inflected form for the lemma: "ხვართქლა", according to the following morphological descriptions: "N;DAT(PL)"	 the inflected form for the le
Generate the inflected form for the lemma: "ხვართქლა", according to the following morphological descriptions: "N;DAT(PL;LGSPEC2)"	 the inflected form for the le
Generate the inflected form for the lemma: "ხვართქლა", according to the following morphological descriptions: "N;DAT(SG)"	 the inflected form for the le
Generate the inflected form for the lemma: "ხვართქლა", according to the following morphological descriptions: "N;ERG(PL)"	 the inflected form for the le
Generate the inflected form for the lemma: "ხვართქლა", according to the following morphological descriptions: "N;ERG(PL;LGSPEC2)"	 for the lemma: "ხვარ
Generate the inflected form for the lemma: "ხვართქლა", according to the following morphological descriptions: "N;ERG(SG)"	 the inflected form for the le
Generate the inflected form for the lemma: "ხვართქლა", according to the following morphological descriptions: "N;FRML(PL)"	ართქლა", according
Generate the inflected form for the lemma: "ხვართქლა", according to the following morphological descriptions: "N;FRML(SG)"	 for the lemma: "ხვარ
Generate the inflected form for the lemma: "ხვართქლა", according to the following morphological descriptions: "N;GEN(PL)"	ართქლა", according
Generate the inflected form for the lemma: "ხვართქლა", according to the following morphological descriptions: "N;GEN(PL;LGSPEC2)"	 for the lemma: "ხვარ
Generate the inflected form for the lemma: "ხვართქლა", according to the following morphological descriptions: "N;GEN(SG)"	ართქლა", according
Generate the inflected form for the lemma: "ხვართქლა", according to the following morphological descriptions: "N;INS(PL)"	 for the lemma: "ხვარ
Generate the inflected form for the lemma: "ხვართქლა", according to the following morphological descriptions: "N;INS(SG)"	 the inflected form for the le
Generate the inflected form for the lemma: "ხვართქლა", according to the following morphological descriptions: "N;NOM(PL)"	ართქლა", according
Generate the inflected form for the lemma: "ხვართქლა", according to the following morphological descriptions: "N;NOM(PL;LGSPEC2)"	 for the lemma: "ხვარ
Generate the inflected form for the lemma: "ხვართქლა", according to the following morphological descriptions: "N;NOM(SG)"	 the inflected form for the le
Generate the inflected form for the lemma: "ხვართქლა", according to the following morphological descriptions: "N;VOC(PL)"	 the inflected form for the le
Generate the inflected form for the lemma: "ხვართქლა", according to the following morphological descriptions: "N;VOC(PL;LGSPEC2)"	 for the lemma: "ხვარ
Generate the inflected form for the lemma: "ხვართქლა", according to the following morphological descriptions: "N;VOC(SG)"	 the inflected form for the le
Generate the inflected form for the lemma: "ხვია", according to the following morphological descriptions: "N;DAT(PL)"	ია", according to the foll
Generate the inflected form for the lemma: "ხვია", according to the following morphological descriptions: "N;DAT(PL;LGSPEC2)"	 for the lemma: "ხვია"
Generate the inflected form for the lemma: "ხვია", according to the following morphological descriptions: "N;DAT(SG)"	ია", according to the foll
Generate the inflected form for the lemma: "ხვია", according to the following morphological descriptions: "N;ERG(PL)"	აააააააააა
Generate the inflected form for the lemma: "ხვია", according to the following morphological descriptions: "N;ERG(PL;LGSPEC2)"	 for the lemma: "ხვია"
Generate the inflected form for the lemma: "ხვია", according to the following morphological descriptions: "N;ERG(SG)"	ია", according to the foll
Generate the inflected form for the lemma: "ხვია", according to the following morphological descriptions: "N;FRML(PL)"	აააააააააა
Generate the inflected form for the lemma: "ხვია", according to the following morphological descriptions: "N;FRML(SG)"	ანალიზაცია
Generate the inflected form for the lemma: "ხვია", according to the following morphological descriptions: "N;GEN(PL)"	ია", according to the foll
Generate the inflected form for the lemma: "ხვია", according to the following morphological descriptions: "N;GEN(PL;LGSPEC2)"	 for the lemma: "ხვია"
Generate the inflected form for the lemma: "ხვია", according to the following morphological descriptions: "N;GEN(SG)"	ია", according to the foll
Generate the inflected form for the lemma: "ხვია", according to the following morphological descriptions: "N;INS(PL)"	ია", according to the foll
Generate the inflected form for the lemma: "ხვია", according to the following morphological descriptions: "N;INS(SG)"	ია", according to the foll
Generate the inflected form for the lemma: "ხვია", according to the following morphological descriptions: "N;NOM(PL)"	ია". "N;NOM(PL)". "N;NOM(P
Generate the inflected form for the lemma: "ხვია", according to the following morphological descriptions: "N;NOM(PL;LGSPEC2)"	 for the lemma: "ხვია"
Generate the inflected form for the lemma: "ხვია", according to the following morphological descriptions: "N;NOM(SG)"	ია". "N;NOM(SG)". "N;NOM(S
Generate the inflected form for the lemma: "ხვია", according to the following morphological descriptions: "N;VOC(PL)"	აააააააააა
Generate the inflected form for the lemma: "ხვია", according to the following morphological descriptions: "N;VOC(PL;LGSPEC2)"	 for the lemma: "ხვია"
Generate the inflected form for the lemma: "ხვია", according to the following morphological descriptions: "N;VOC(SG)"	აააააააააა
Generate the inflected form for the lemma: "ხუმარა", according to the following morphological descriptions: "N;DAT(PL)"	 ხუმარა" - accessi
Generate the inflected form for the lemma: "ხუმარა", according to the following morphological descriptions: "N;DAT(PL;LGSPEC2)"	 the inflected form for the le
Generate the inflected form for the lemma: "ხუმარა", according to the following morphological descriptions: "N;DAT(SG)"	არაააააააა
Generate the inflected form for the lemma: "ხუმარა", according to the following morphological descriptions: "N;ERG(PL)"	არაააააააა
Generate the inflected form for the lemma: "ხუმარა", according to the following morphological descriptions: "N;ERG(PL;LGSPEC2)"	 for the lemma: "ხუმა
Generate the inflected form for the lemma: "ხუმარა", according to the following morphological descriptions: "N;ERG(SG)"	არაააააააა
Generate the inflected form for the lemma: "ხუმარა", according to the following morphological descriptions: "N;FRML(PL)"	არაააააააა
Generate the inflected form for the lemma: "ხუმარა", according to the following morphological descriptions: "N;FRML(SG)"	არაააააააა
Generate the inflected form for the lemma: "ხუმარა", according to the following morphological descriptions: "N;GEN(PL)"	არაააააააა
Generate the inflected form for the lemma: "ხუმარა", according to the following morphological descriptions: "N;GEN(PL;LGSPEC2)"	 for the lemma: "ხუმა
Generate the inflected form for the lemma: "ხუმარა", according to the following morphological descriptions: "N;GEN(SG)"	არაააააააა
Generate the inflected form for the lemma: "ხუმარა", according to the following morphological descriptions: "N;INS(PL)"	 ხუმარა" according
Generate the inflected form for the lemma: "ხუმარა", according to the following morphological descriptions: "N;INS(SG)"	არაააააააა
Generate the inflected form for the lemma: "ხუმარა", according to the following morphological descriptions: "N;NOM(PL)"	არაააააააა
Generate the inflected form for the lemma: "ხუმარა", according to the following morphological descriptions: "N;NOM(PL;LGSPEC2)"	 for the lemma: "ხუმა
Generate the inflected form for the lemma: "ხუმარა", according to the following morphological descriptions: "N;NOM(SG)"	არაააააააა
Generate the inflected form for the lemma: "ხუმარა", according to the following morphological descriptions: "N;VOC(PL)"	 ხუმარა" according
Generate the inflected form for the lemma: "ხუმარა", according to the following morphological descriptions: "N;VOC(PL;LGSPEC2)"	 the inflected form for the le
Generate the inflected form for the lemma: "ხუმარა", according to the following morphological descriptions: "N;VOC(SG)"	 for the lemma: "ხუმა
Generate the inflected form for the lemma: "ჰქვია", according to the following morphological descriptions: "V;IND;FUT;NOM(1,PL)"	 for the lemma: "ჰქვი
Generate the inflected form for the lemma: "ჰქვია", according to the following morphological descriptions: "V;IND;FUT;NOM(1,SG)"	 for the lemma: "ჰქვი
Generate the inflected form for the lemma: "ჰქვია", according to the following morphological descriptions: "V;IND;FUT;NOM(2,PL)"	 for the lemma: "ჰქვი
Generate the inflected form for the lemma: "ჰქვია", according to the following morphological descriptions: "V;IND;FUT;NOM(2,SG)"	 for the lemma: "ჰქვი
Generate the inflected form for the lemma: "ჰქვია", according to the following morphological descriptions: "V;IND;FUT;NOM(3,PL)"	 for the lemma: "ჰქვი
Generate the inflected form for the lemma: "ჰქვია", according to the following morphological descriptions: "V;IND;FUT;NOM(3,SG)"	 for the lemma: "ჰქვი
Generate the inflected form for the lemma: "ჰქვია", according to the following morphological descriptions: "V;IND;PRF;NOM(2,PL)"	 for the lemma: "ჰქვი
Generate the inflected form for the lemma: "ჰქვია", according to the following morphological descriptions: "V;IND;PRF;NOM(2,SG)"	 for the lemma: "ჰქვი
Generate the inflected form for the lemma: "ჰქვია", according to the following morphological descriptions: "V;IND;PRF;NOM(3,PL)"	 for the lemma: "ჰქვი
Generate the inflected form for the lemma: "ჰქვია", according to the following morphological descriptions: "V;IND;PRF;NOM(3,SG)"	 for the lemma: "ჰქვი
Generate the inflected form for the lemma: "ჰქვია", according to the following morphological descriptions: "V;IND;PRS;NOM(1,PL)"	 for the lemma: "ჰქვი
Generate the inflected form for the lemma: "ჰქვია", according to the following morphological descriptions: "V;IND;PRS;NOM(1,SG)"	 for the lemma: "ჰქვი
Generate the inflected form for the lemma: "ჰქვია", according to the following morphological descriptions: "V;IND;PRS;NOM(2,SG)"	 for the lemma: "ჰქვი
Generate the inflected form for the lemma: "ჰქვია", according to the following morphological descriptions: "V;IND;PRS;NOM(3,PL)"	 for the lemma: "ჰქვი
Generate the inflected form for the lemma: "ჰქვია", according to the following morphological descriptions: "V;IND;PRS;NOM(3,SG)"	 for the lemma: "ჰქვი
Generate the inflected form for the lemma: "ჰქვია", according to the following morphological descriptions: "V;IND;PST;PFV;NOM(1,PL)"	 the inflected form for the le
Generate the inflected form for the lemma: "ჰქვია", according to the following morphological descriptions: "V;IND;PST;PFV;NOM(1,SG)"	 for the lemma: "ჰქვი
Generate the inflected form for the lemma: "ჰქვია", according to the following morphological descriptions: "V;IND;PST;PFV;NOM(2,PL)"	 the inflected form for the le
Generate the inflected form for the lemma: "ჰქვია", according to the following morphological descriptions: "V;IND;PST;PFV;NOM(3,PL)"	 the inflected form for the le
Generate the inflected form for the lemma: "ჰქვია", according to the following morphological descriptions: "V;IND;PST;PRF;NOM(2,SG)"	 for the lemma: "ჰქვი
Generate the inflected form for the lemma: "ჰქვია", according to the following morphological descriptions: "V;IND;PST;PRF;NOM(3,PL)"	 for the lemma: "ჰქვი
Generate the inflected form for the lemma: "ჰქვია", according to the following morphological descriptions: "V;IND;PST;PRF;NOM(3,SG)"	 for the lemma: "ჰქვი
Generate the inflected form for the lemma: "ჰქვია", according to the following morphological descriptions: "V;OPT;NOM(1,PL)"	 the inflected form for the le
Generate the inflected form for the lemma: "ჰქვია", according to the following morphological descriptions: "V;OPT;NOM(2,PL)"	 the inflected form for the le
Generate the inflected form for the lemma: "ჰქვია", according to the following morphological descriptions: "V;OPT;NOM(2,SG)"	 the inflected form for the le
Generate the inflected form for the lemma: "ჰქვია", according to the following morphological descriptions: "V;OPT;NOM(3,SG)"	 the inflected form for the le
