Generate the inflected form for the lemma: "Βισάλτης", according to the following morphological descriptions: "N;ACC(DU)"	βισάλτης" and "Βισ
Generate the inflected form for the lemma: "Βισάλτης", according to the following morphological descriptions: "N;ACC(PL)"	βισάλτης" and "Βισ
Generate the inflected form for the lemma: "Βισάλτης", according to the following morphological descriptions: "N;ACC(SG)"	βισάλτης" and "Βισ
Generate the inflected form for the lemma: "Βισάλτης", according to the following morphological descriptions: "N;DAT(DU)"	βισάλτης" and "Βισ
Generate the inflected form for the lemma: "Βισάλτης", according to the following morphological descriptions: "N;DAT(PL)"	βισάλτης" and "Βισ
Generate the inflected form for the lemma: "Βισάλτης", according to the following morphological descriptions: "N;DAT(SG)"	βισάλτης" and the foll
Generate the inflected form for the lemma: "Βισάλτης", according to the following morphological descriptions: "N;GEN(DU)"	 Βισάλτης" Βισάλ
Generate the inflected form for the lemma: "Βισάλτης", according to the following morphological descriptions: "N;GEN(PL)"	βισάλτης" (Βισάλ
Generate the inflected form for the lemma: "Βισάλτης", according to the following morphological descriptions: "N;GEN(SG)"	βισάλτης" (Βισάλ
Generate the inflected form for the lemma: "Βισάλτης", according to the following morphological descriptions: "N;NOM(DU)"	βισάλτης" and "Βισ
Generate the inflected form for the lemma: "Βισάλτης", according to the following morphological descriptions: "N;NOM(PL)"	βισάλτης" and "Βισ
Generate the inflected form for the lemma: "Βισάλτης", according to the following morphological descriptions: "N;NOM(SG)"	βισάλτης" and the foll
Generate the inflected form for the lemma: "Βισάλτης", according to the following morphological descriptions: "N;VOC(DU)"	βισάλτης" and "Βισ
Generate the inflected form for the lemma: "Βισάλτης", according to the following morphological descriptions: "N;VOC(PL)"	βισάλτης" and "Βισ
Generate the inflected form for the lemma: "Βισάλτης", according to the following morphological descriptions: "N;VOC(SG)"	βισάλτης" and the foll
Generate the inflected form for the lemma: "Μασσαλιώτης", according to the following morphological descriptions: "N;ACC(DU)"	αλιώτης" (αλιώτη
Generate the inflected form for the lemma: "Μασσαλιώτης", according to the following morphological descriptions: "N;ACC(PL)"	αλιώτης" and "Μασσ
Generate the inflected form for the lemma: "Μασσαλιώτης", according to the following morphological descriptions: "N;ACC(SG)"	αλιώτης" and "Μασσ
Generate the inflected form for the lemma: "Μασσαλιώτης", according to the following morphological descriptions: "N;DAT(DU)"	αλιώτης" and "Μασσ
Generate the inflected form for the lemma: "Μασσαλιώτης", according to the following morphological descriptions: "N;DAT(PL)"	αλιώτης" and "Μασσ
Generate the inflected form for the lemma: "Μασσαλιώτης", according to the following morphological descriptions: "N;DAT(SG)"	αναγνώστης" and "Μ
Generate the inflected form for the lemma: "Μασσαλιώτης", according to the following morphological descriptions: "N;GEN(DU)"	er Μασσαλιώτης" κ
Generate the inflected form for the lemma: "Μασσαλιώτης", according to the following morphological descriptions: "N;GEN(PL)"	er Μασσαλιώτης" Μ
Generate the inflected form for the lemma: "Μασσαλιώτης", according to the following morphological descriptions: "N;GEN(SG)"	αλιώτης" Μασσαλι
Generate the inflected form for the lemma: "Μασσαλιώτης", according to the following morphological descriptions: "N;NOM(DU)"	αλιώτης" and "Μασσ
Generate the inflected form for the lemma: "Μασσαλιώτης", according to the following morphological descriptions: "N;NOM(PL)"	αλιώτης" and "Μασσ
Generate the inflected form for the lemma: "Μασσαλιώτης", according to the following morphological descriptions: "N;NOM(SG)"	αλιώτης" and "Μασσ
Generate the inflected form for the lemma: "Μασσαλιώτης", according to the following morphological descriptions: "N;VOC(DU)"	αλιώτης" and "Μασσ
Generate the inflected form for the lemma: "Μασσαλιώτης", according to the following morphological descriptions: "N;VOC(PL)"	english translator "Μασσα
Generate the inflected form for the lemma: "Μασσαλιώτης", according to the following morphological descriptions: "N;VOC(SG)"	αλιώτης" and "Μασσ
Generate the inflected form for the lemma: "Μιθριακός", according to the following morphological descriptions: "ADJ;ACC(DU;MASC)"	ιθριακός" (ΜΙΘΡΙ
Generate the inflected form for the lemma: "Μιθριακός", according to the following morphological descriptions: "ADJ;ACC(DU;NEUT)"	ιθριακός".
Μιθρι
Generate the inflected form for the lemma: "Μιθριακός", according to the following morphological descriptions: "ADJ;ACC(PL;FEM)"	ιθριακός".
Μιθρι
Generate the inflected form for the lemma: "Μιθριακός", according to the following morphological descriptions: "ADJ;ACC(PL;MASC)"	ιθριακός".
Μιθρι
Generate the inflected form for the lemma: "Μιθριακός", according to the following morphological descriptions: "ADJ;ACC(PL;NEUT)"	ιθριακός".
Μιθρι
Generate the inflected form for the lemma: "Μιθριακός", according to the following morphological descriptions: "ADJ;ACC(SG;FEM)"	ιθριακός".
Μιθρι
Generate the inflected form for the lemma: "Μιθριακός", according to the following morphological descriptions: "ADJ;DAT(DU;FEM)"	ιθριακός" (ΜΙΘΡΙ
Generate the inflected form for the lemma: "Μιθριακός", according to the following morphological descriptions: "ADJ;DAT(DU;MASC)"	ιθριακός" (ΜΙΘΡΙ
Generate the inflected form for the lemma: "Μιθριακός", according to the following morphological descriptions: "ADJ;DAT(PL;MASC)"	ιθριακός" and "Μιθ
Generate the inflected form for the lemma: "Μιθριακός", according to the following morphological descriptions: "ADJ;DAT(SG;FEM)"	ιθριακός" and "Μιθ
Generate the inflected form for the lemma: "Μιθριακός", according to the following morphological descriptions: "ADJ;DAT(SG;MASC)"	ιθριακός" and "Μιθ
Generate the inflected form for the lemma: "Μιθριακός", according to the following morphological descriptions: "ADJ;DAT(SG;NEUT)"	ιθριακός" (ΜΙΘΡΙ
Generate the inflected form for the lemma: "Μιθριακός", according to the following morphological descriptions: "ADJ;GEN(DU;FEM)"	ιθριακός".
Generate th
Generate the inflected form for the lemma: "Μιθριακός", according to the following morphological descriptions: "ADJ;GEN(DU;MASC)"	ιθριακός".
Generate th
Generate the inflected form for the lemma: "Μιθριακός", according to the following morphological descriptions: "ADJ;GEN(DU;NEUT)"	ιθριακός".
Generate th
Generate the inflected form for the lemma: "Μιθριακός", according to the following morphological descriptions: "ADJ;GEN(PL;MASC)"	ιθριακός".
Generate th
Generate the inflected form for the lemma: "Μιθριακός", according to the following morphological descriptions: "ADJ;GEN(PL;NEUT)"	ιθριακός".
Generate th
Generate the inflected form for the lemma: "Μιθριακός", according to the following morphological descriptions: "ADJ;GEN(SG;FEM)"	ιθριακός".
Generate th
Generate the inflected form for the lemma: "Μιθριακός", according to the following morphological descriptions: "ADJ;GEN(SG;MASC)"	ιθριακός".
Generate th
Generate the inflected form for the lemma: "Μιθριακός", according to the following morphological descriptions: "ADJ;GEN(SG;NEUT)"	ιθριακός".
Generate th
Generate the inflected form for the lemma: "Μιθριακός", according to the following morphological descriptions: "ADJ;NOM(DU;FEM)"	ιθριακός" (ΜΙΘΡΙ
Generate the inflected form for the lemma: "Μιθριακός", according to the following morphological descriptions: "ADJ;NOM(DU;MASC)"	ιθριακός" (ΜΙΘΡΙ
Generate the inflected form for the lemma: "Μιθριακός", according to the following morphological descriptions: "ADJ;NOM(DU;NEUT)"	ιθριακός".
Μιθρι
Generate the inflected form for the lemma: "Μιθριακός", according to the following morphological descriptions: "ADJ;NOM(PL;FEM)"	ιθριακός" (ΜΙΘΡΙ
Generate the inflected form for the lemma: "Μιθριακός", according to the following morphological descriptions: "ADJ;NOM(PL;MASC)"	ιθριακός" (ΜΙΘΡΙ
Generate the inflected form for the lemma: "Μιθριακός", according to the following morphological descriptions: "ADJ;NOM(PL;NEUT)"	ιθριακός" (ΜΙΘΡΙ
Generate the inflected form for the lemma: "Μιθριακός", according to the following morphological descriptions: "ADJ;NOM(SG;FEM)"	ιθριακός" and "Μιθ
Generate the inflected form for the lemma: "Μιθριακός", according to the following morphological descriptions: "ADJ;VOC(DU;MASC)"	ιθριακός" (ΜΙΘΡΙ
Generate the inflected form for the lemma: "Μιθριακός", according to the following morphological descriptions: "ADJ;VOC(PL;FEM)"	ιθριακός" (ΜΙΘΡΙ
Generate the inflected form for the lemma: "Μιθριακός", according to the following morphological descriptions: "ADJ;VOC(PL;NEUT)"	ιθριακός" (ΜΙΘΡΙ
Generate the inflected form for the lemma: "Μιθριακός", according to the following morphological descriptions: "ADJ;VOC(SG;FEM)"	ιθριακός" and "Μιθ
Generate the inflected form for the lemma: "Μιθριακός", according to the following morphological descriptions: "ADJ;VOC(SG;MASC)"	ιθριακός" (ΜΙΘΡΙ
Generate the inflected form for the lemma: "Μιθριακός", according to the following morphological descriptions: "ADJ;VOC(SG;NEUT)"	ιθριακός".
Μιθρι
Generate the inflected form for the lemma: "αἴγιλος", according to the following morphological descriptions: "N;ACC(DU)"	αἰγιλος" and "αἰγ
Generate the inflected form for the lemma: "αἴγιλος", according to the following morphological descriptions: "N;ACC(PL)"	αἴγιλος" and "αἰγ
Generate the inflected form for the lemma: "αἴγιλος", according to the following morphological descriptions: "N;ACC(SG)"	αἰγιλος" and "αἰγ
Generate the inflected form for the lemma: "αἴγιλος", according to the following morphological descriptions: "N;DAT(DU)"	αἰγιλος" and "αἰγ
Generate the inflected form for the lemma: "αἴγιλος", according to the following morphological descriptions: "N;DAT(PL)"	αἰγιλος" and "αἰγ
Generate the inflected form for the lemma: "αἴγιλος", according to the following morphological descriptions: "N;DAT(SG)"	αἰγιλος" and "αἰγ
Generate the inflected form for the lemma: "αἴγιλος", according to the following morphological descriptions: "N;GEN(DU)"	αἰγιλος" (αἰγιλ
Generate the inflected form for the lemma: "αἴγιλος", according to the following morphological descriptions: "N;GEN(PL)"	αἰγιλος" and "αἰγ
Generate the inflected form for the lemma: "αἴγιλος", according to the following morphological descriptions: "N;GEN(SG)"	αἰγιλος" and "αἰγ
Generate the inflected form for the lemma: "αἴγιλος", according to the following morphological descriptions: "N;NOM(DU)"	αἰγιλος" and "αἰγ
Generate the inflected form for the lemma: "αἴγιλος", according to the following morphological descriptions: "N;NOM(PL)"	αἰγιλος" and "αἰγ
Generate the inflected form for the lemma: "αἴγιλος", according to the following morphological descriptions: "N;NOM(SG)"	αἰγιλος" and "αἰγ
Generate the inflected form for the lemma: "αἴγιλος", according to the following morphological descriptions: "N;VOC(DU)"	αἰγιλος" and "αἰγ
Generate the inflected form for the lemma: "αἴγιλος", according to the following morphological descriptions: "N;VOC(PL)"	αἰγιλος" and "αἰγ
Generate the inflected form for the lemma: "αἴγιλος", according to the following morphological descriptions: "N;VOC(SG)"	αἰγιλος" and "αἰγ
Generate the inflected form for the lemma: "αὔρα", according to the following morphological descriptions: "N;ACC(DU)"	αὔρα αὔρα αὔρα 
Generate the inflected form for the lemma: "αὔρα", according to the following morphological descriptions: "N;ACC(PL)"	αὔρα" and "αὔρα". Th
Generate the inflected form for the lemma: "αὔρα", according to the following morphological descriptions: "N;ACC(SG)"	αὔρα" and "αὔρα" as 
Generate the inflected form for the lemma: "αὔρα", according to the following morphological descriptions: "N;DAT(DU)"	αὔρα" and "αὔρα" as 
Generate the inflected form for the lemma: "αὔρα", according to the following morphological descriptions: "N;DAT(PL)"	αὔρα" and "αὔρα" as 
Generate the inflected form for the lemma: "αὔρα", according to the following morphological descriptions: "N;DAT(SG)"	αὔρα" and "αὔρα" as 
Generate the inflected form for the lemma: "αὔρα", according to the following morphological descriptions: "N;GEN(DU)"	αὔρα" is the form of the 
Generate the inflected form for the lemma: "αὔρα", according to the following morphological descriptions: "N;GEN(PL)"	αὔρα" and "αὔρα" as 
Generate the inflected form for the lemma: "αὔρα", according to the following morphological descriptions: "N;GEN(SG)"	αὔρα" and "αὔρα" as 
Generate the inflected form for the lemma: "αὔρα", according to the following morphological descriptions: "N;NOM(DU)"	αὔρα" and "αὔρα" as 
Generate the inflected form for the lemma: "αὔρα", according to the following morphological descriptions: "N;NOM(PL)"	αὔρα" and "αὔρα" as 
Generate the inflected form for the lemma: "αὔρα", according to the following morphological descriptions: "N;NOM(SG)"	αὔρα" and "αὔρα" as 
Generate the inflected form for the lemma: "αὔρα", according to the following morphological descriptions: "N;VOC(DU)"	αὔρα" and "αὔρα" as 
Generate the inflected form for the lemma: "αὔρα", according to the following morphological descriptions: "N;VOC(PL)"	αὔρα" and "αὔρα" as 
Generate the inflected form for the lemma: "αὔρα", according to the following morphological descriptions: "N;VOC(SG)"	αὔρα" and "αὔρα" as 
Generate the inflected form for the lemma: "βραχύτης", according to the following morphological descriptions: "N;ACC(DU)"	βραχύτης" in the follo
Generate the inflected form for the lemma: "βραχύτης", according to the following morphological descriptions: "N;ACC(PL)"	βραχύτης" in the follo
Generate the inflected form for the lemma: "βραχύτης", according to the following morphological descriptions: "N;ACC(SG)"	βραχύτης" and "βρα
Generate the inflected form for the lemma: "βραχύτης", according to the following morphological descriptions: "N;DAT(DU)"	βραχύτης" and "βρα
Generate the inflected form for the lemma: "βραχύτης", according to the following morphological descriptions: "N;DAT(PL)"	βραχύτης" and "βρα
Generate the inflected form for the lemma: "βραχύτης", according to the following morphological descriptions: "N;DAT(SG)"	βραχύτης" and the foll
Generate the inflected form for the lemma: "βραχύτης", according to the following morphological descriptions: "N;GEN(DU)"	βραχύτης" (βραχύ
Generate the inflected form for the lemma: "βραχύτης", according to the following morphological descriptions: "N;GEN(PL)"	βραχύτης" (βραχύ
Generate the inflected form for the lemma: "βραχύτης", according to the following morphological descriptions: "N;GEN(SG)"	βραχύτης" (βραχύ
Generate the inflected form for the lemma: "βραχύτης", according to the following morphological descriptions: "N;NOM(DU)"	βραχύτης" and "βρα
Generate the inflected form for the lemma: "βραχύτης", according to the following morphological descriptions: "N;NOM(PL)"	βραχύτης" as a substit
Generate the inflected form for the lemma: "βραχύτης", according to the following morphological descriptions: "N;NOM(SG)"	βραχύτης" as a substit
Generate the inflected form for the lemma: "βραχύτης", according to the following morphological descriptions: "N;VOC(DU)"	βραχύτης" and "βρα
Generate the inflected form for the lemma: "βραχύτης", according to the following morphological descriptions: "N;VOC(PL)"	της" and "βραχύτης"
Generate the inflected form for the lemma: "βραχύτης", according to the following morphological descriptions: "N;VOC(SG)"	βραχύτης" and "βρα
Generate the inflected form for the lemma: "γοεδνός", according to the following morphological descriptions: "ADJ;ACC(DU;FEM)"	γοεδνός" is the form of
Generate the inflected form for the lemma: "γοεδνός", according to the following morphological descriptions: "ADJ;ACC(DU;NEUT)"	γοεδνός" (γοεδνό
Generate the inflected form for the lemma: "γοεδνός", according to the following morphological descriptions: "ADJ;ACC(PL;FEM)"	γοεδνός" in the followi
Generate the inflected form for the lemma: "γοεδνός", according to the following morphological descriptions: "ADJ;ACC(PL;NEUT)"	γοεδνός" (γοεδνό
Generate the inflected form for the lemma: "γοεδνός", according to the following morphological descriptions: "ADJ;ACC(SG;FEM)"	γοεδνός" in the followi
Generate the inflected form for the lemma: "γοεδνός", according to the following morphological descriptions: "ADJ;ACC(SG;NEUT)"	γοεδνός" is the form of
Generate the inflected form for the lemma: "γοεδνός", according to the following morphological descriptions: "ADJ;DAT(DU;MASC)"	γοεδνός" is the form of
Generate the inflected form for the lemma: "γοεδνός", according to the following morphological descriptions: "ADJ;DAT(DU;NEUT)"	γοεδνός" (γοεδνό
Generate the inflected form for the lemma: "γοεδνός", according to the following morphological descriptions: "ADJ;DAT(PL;MASC)"	γοεδνός" is the form of
Generate the inflected form for the lemma: "γοεδνός", according to the following morphological descriptions: "ADJ;DAT(SG;FEM)"	γοεδνός" is the form of
Generate the inflected form for the lemma: "γοεδνός", according to the following morphological descriptions: "ADJ;DAT(SG;MASC)"	γοεδνός" is the followi
Generate the inflected form for the lemma: "γοεδνός", according to the following morphological descriptions: "ADJ;DAT(SG;NEUT)"	γοεδνός" is the form of
Generate the inflected form for the lemma: "γοεδνός", according to the following morphological descriptions: "ADJ;GEN(DU;MASC)"	γοεδνός" is the followi
Generate the inflected form for the lemma: "γοεδνός", according to the following morphological descriptions: "ADJ;GEN(DU;NEUT)"	γοεδνός" (γοεδνό
Generate the inflected form for the lemma: "γοεδνός", according to the following morphological descriptions: "ADJ;GEN(PL;FEM)"	γοεδνός" (γοεδνό
Generate the inflected form for the lemma: "γοεδνός", according to the following morphological descriptions: "ADJ;GEN(PL;MASC)"	γοεδνός" is the followi
Generate the inflected form for the lemma: "γοεδνός", according to the following morphological descriptions: "ADJ;GEN(SG;FEM)"	γοεδνός" (γοεδνό
Generate the inflected form for the lemma: "γοεδνός", according to the following morphological descriptions: "ADJ;GEN(SG;MASC)"	γοεδνός" is a substanti
Generate the inflected form for the lemma: "γοεδνός", according to the following morphological descriptions: "ADJ;GEN(SG;NEUT)"	γοεδνός".
Generate the 
Generate the inflected form for the lemma: "γοεδνός", according to the following morphological descriptions: "ADJ;NOM(DU;FEM)"	ος" (γοεδνός) (γοε
Generate the inflected form for the lemma: "γοεδνός", according to the following morphological descriptions: "ADJ;NOM(DU;NEUT)"	ος" (γοεδνός) (γοε
Generate the inflected form for the lemma: "γοεδνός", according to the following morphological descriptions: "ADJ;NOM(PL;FEM)"	γοεδνός" (γοεδνό
Generate the inflected form for the lemma: "γοεδνός", according to the following morphological descriptions: "ADJ;NOM(PL;NEUT)"	γοεδνός" (γοεδνό
Generate the inflected form for the lemma: "γοεδνός", according to the following morphological descriptions: "ADJ;NOM(SG;FEM)"	γοεδνός" in the followi
Generate the inflected form for the lemma: "γοεδνός", according to the following morphological descriptions: "ADJ;NOM(SG;MASC)"	γοεδνός" is the form of
Generate the inflected form for the lemma: "γοεδνός", according to the following morphological descriptions: "ADJ;VOC(DU;FEM)"	γοεδνός" is the form of
Generate the inflected form for the lemma: "γοεδνός", according to the following morphological descriptions: "ADJ;VOC(DU;NEUT)"	γοεδνός" is the suffix 
Generate the inflected form for the lemma: "γοεδνός", according to the following morphological descriptions: "ADJ;VOC(PL;FEM)"	γοεδνός" is the form of
Generate the inflected form for the lemma: "γοεδνός", according to the following morphological descriptions: "ADJ;VOC(PL;MASC)"	γοεδνός" is the followi
Generate the inflected form for the lemma: "γοεδνός", according to the following morphological descriptions: "ADJ;VOC(PL;NEUT)"	γοεδνός" is the suffix 
Generate the inflected form for the lemma: "γοεδνός", according to the following morphological descriptions: "ADJ;VOC(SG;FEM)"	γοεδνός" is the form of
Generate the inflected form for the lemma: "γοεδνός", according to the following morphological descriptions: "ADJ;VOC(SG;MASC)"	γοεδνός" is the followi
Generate the inflected form for the lemma: "γοεδνός", according to the following morphological descriptions: "ADJ;VOC(SG;NEUT)"	γοεδνός" is the form of
Generate the inflected form for the lemma: "διθυμία", according to the following morphological descriptions: "N;ACC(DU)"	ιθυμία" and "διθυμ
Generate the inflected form for the lemma: "διθυμία", according to the following morphological descriptions: "N;ACC(PL)"	ιθυμία" and "διθυμ
Generate the inflected form for the lemma: "διθυμία", according to the following morphological descriptions: "N;ACC(SG)"	ιθυμία" and the followin
Generate the inflected form for the lemma: "διθυμία", according to the following morphological descriptions: "N;DAT(DU)"	ιθυμία", according to th
Generate the inflected form for the lemma: "διθυμία", according to the following morphological descriptions: "N;DAT(PL)"	ιθυμία", according to th
Generate the inflected form for the lemma: "διθυμία", according to the following morphological descriptions: "N;DAT(SG)"	ιθυμία", according to th
Generate the inflected form for the lemma: "διθυμία", according to the following morphological descriptions: "N;GEN(DU)"	ιθυμία", according to th
Generate the inflected form for the lemma: "διθυμία", according to the following morphological descriptions: "N;GEN(PL)"	ιθυμία" (διθυμία)
Generate the inflected form for the lemma: "διθυμία", according to the following morphological descriptions: "N;GEN(SG)"	ιθυμία" (διθυμία)
Generate the inflected form for the lemma: "διθυμία", according to the following morphological descriptions: "N;NOM(DU)"	ιθυμία", according to th
Generate the inflected form for the lemma: "διθυμία", according to the following morphological descriptions: "N;NOM(PL)"	ιθυμία" and "διθυμ
Generate the inflected form for the lemma: "διθυμία", according to the following morphological descriptions: "N;NOM(SG)"	ιθυμία", according to th
Generate the inflected form for the lemma: "διθυμία", according to the following morphological descriptions: "N;VOC(DU)"	ιθυμία" and "διθυμ
Generate the inflected form for the lemma: "διθυμία", according to the following morphological descriptions: "N;VOC(PL)"	αναίτητος" and "δι
Generate the inflected form for the lemma: "διθυμία", according to the following morphological descriptions: "N;VOC(SG)"	ιθυμία" and the followin
Generate the inflected form for the lemma: "δορκάς", according to the following morphological descriptions: "N;ACC(DU)"	ορκάς" and "δορκάς"
Generate the inflected form for the lemma: "δορκάς", according to the following morphological descriptions: "N;ACC(PL)"	ορκάς" and the following 
Generate the inflected form for the lemma: "δορκάς", according to the following morphological descriptions: "N;ACC(SG)"	ορκάς" and "δορκάς"
Generate the inflected form for the lemma: "δορκάς", according to the following morphological descriptions: "N;DAT(DU)"	ορκάς" and the following 
Generate the inflected form for the lemma: "δορκάς", according to the following morphological descriptions: "N;DAT(PL)"	ορκάς" and the following 
Generate the inflected form for the lemma: "δορκάς", according to the following morphological descriptions: "N;DAT(SG)"	ορκάς" and the following 
Generate the inflected form for the lemma: "δορκάς", according to the following morphological descriptions: "N;GEN(DU)"	ορκάς" and the following 
Generate the inflected form for the lemma: "δορκάς", according to the following morphological descriptions: "N;GEN(PL)"	ορκάς" and the following 
Generate the inflected form for the lemma: "δορκάς", according to the following morphological descriptions: "N;GEN(SG)"	orkas", according to the follo
Generate the inflected form for the lemma: "δορκάς", according to the following morphological descriptions: "N;NOM(DU)"	ορκάς" and "δορκάς"
Generate the inflected form for the lemma: "δορκάς", according to the following morphological descriptions: "N;NOM(PL)"	ορκάς" and the following 
Generate the inflected form for the lemma: "δορκάς", according to the following morphological descriptions: "N;NOM(SG)"	ορκάς" and the following 
Generate the inflected form for the lemma: "δορκάς", according to the following morphological descriptions: "N;VOC(DU)"	ορκάς" and "δορκάς"
Generate the inflected form for the lemma: "δορκάς", according to the following morphological descriptions: "N;VOC(PL)"	ορκάς" and the following 
Generate the inflected form for the lemma: "δορκάς", according to the following morphological descriptions: "N;VOC(SG)"	ορκάς" and the following 
Generate the inflected form for the lemma: "θήρα", according to the following morphological descriptions: "N;ACC(DU)"	ηρα" and the following morp
Generate the inflected form for the lemma: "θήρα", according to the following morphological descriptions: "N;ACC(PL)"	ηρα" and the following morp
Generate the inflected form for the lemma: "θήρα", according to the following morphological descriptions: "N;ACC(SG)"	ηρα" and the following morp
Generate the inflected form for the lemma: "θήρα", according to the following morphological descriptions: "N;DAT(DU)"	ηρα" and the following morp
Generate the inflected form for the lemma: "θήρα", according to the following morphological descriptions: "N;DAT(PL)"	ηρα" and the following morp
Generate the inflected form for the lemma: "θήρα", according to the following morphological descriptions: "N;DAT(SG)"	ηρα", according to the foll
Generate the inflected form for the lemma: "θήρα", according to the following morphological descriptions: "N;GEN(DU)"	ηρα" and the following morp
Generate the inflected form for the lemma: "θήρα", according to the following morphological descriptions: "N;GEN(PL)"	ηρα" and the following morp
Generate the inflected form for the lemma: "θήρα", according to the following morphological descriptions: "N;GEN(SG)"	ηρα" and "θήρα" as a su
Generate the inflected form for the lemma: "θήρα", according to the following morphological descriptions: "N;NOM(DU)"	αναίρεση θήρα θή
Generate the inflected form for the lemma: "θήρα", according to the following morphological descriptions: "N;NOM(PL)"	ηρα" and the following morp
Generate the inflected form for the lemma: "θήρα", according to the following morphological descriptions: "N;NOM(SG)"	ηρα" and the following morp
Generate the inflected form for the lemma: "θήρα", according to the following morphological descriptions: "N;VOC(DU)"	ηρα" and "θήρα". The le
Generate the inflected form for the lemma: "θήρα", according to the following morphological descriptions: "N;VOC(PL)"	ηρα" and the following morp
Generate the inflected form for the lemma: "θήρα", according to the following morphological descriptions: "N;VOC(SG)"	ηρα" and the following morp
Generate the inflected form for the lemma: "θρεπτικός", according to the following morphological descriptions: "ADJ;ACC(DU;FEM)"	ικός" (θρεπτικός)
Generate the inflected form for the lemma: "θρεπτικός", according to the following morphological descriptions: "ADJ;ACC(DU;MASC)"	ικός" (θρεπτικός)
Generate the inflected form for the lemma: "θρεπτικός", according to the following morphological descriptions: "ADJ;ACC(DU;NEUT)"	ικός" (θρεπτικός)
Generate the inflected form for the lemma: "θρεπτικός", according to the following morphological descriptions: "ADJ;ACC(PL;MASC)"	ικός" (θρεπτικός)
Generate the inflected form for the lemma: "θρεπτικός", according to the following morphological descriptions: "ADJ;ACC(PL;NEUT)"	ικός" (θρεπτικός)
Generate the inflected form for the lemma: "θρεπτικός", according to the following morphological descriptions: "ADJ;ACC(SG;FEM)"	ικός" and "θρεπτικ
Generate the inflected form for the lemma: "θρεπτικός", according to the following morphological descriptions: "ADJ;ACC(SG;MASC)"	ικός" (θρεπτικός)
Generate the inflected form for the lemma: "θρεπτικός", according to the following morphological descriptions: "ADJ;ACC(SG;NEUT)"	ικός" (θρεπτικός)
Generate the inflected form for the lemma: "θρεπτικός", according to the following morphological descriptions: "ADJ;DAT(DU;FEM)"	ικός" (θρεπτικός)
Generate the inflected form for the lemma: "θρεπτικός", according to the following morphological descriptions: "ADJ;DAT(DU;NEUT)"	θρεπτικός" (θρεπ
Generate the inflected form for the lemma: "θρεπτικός", according to the following morphological descriptions: "ADJ;DAT(PL;FEM)"	ικός" (θρεπτικός)
Generate the inflected form for the lemma: "θρεπτικός", according to the following morphological descriptions: "ADJ;DAT(PL;NEUT)"	ικός" (θρεπτικός)
Generate the inflected form for the lemma: "θρεπτικός", according to the following morphological descriptions: "ADJ;DAT(SG;FEM)"	ικός" and "θρεπτικ
Generate the inflected form for the lemma: "θρεπτικός", according to the following morphological descriptions: "ADJ;DAT(SG;MASC)"	ικός" and "θρεπτικ
Generate the inflected form for the lemma: "θρεπτικός", according to the following morphological descriptions: "ADJ;GEN(DU;NEUT)"	ικός", according to the fo
Generate the inflected form for the lemma: "θρεπτικός", according to the following morphological descriptions: "ADJ;GEN(PL;MASC)"	ικός" (θρεπτικός)
Generate the inflected form for the lemma: "θρεπτικός", according to the following morphological descriptions: "ADJ;GEN(PL;NEUT)"	ικός" (θρεπτικός)
Generate the inflected form for the lemma: "θρεπτικός", according to the following morphological descriptions: "ADJ;GEN(SG;MASC)"	ικός" and "θρεπτικ
Generate the inflected form for the lemma: "θρεπτικός", according to the following morphological descriptions: "ADJ;GEN(SG;NEUT)"	ικός".
Θρεπτικός"
Generate the inflected form for the lemma: "θρεπτικός", according to the following morphological descriptions: "ADJ;NOM(DU;MASC)"	θρεπτικός" (θρεπ
Generate the inflected form for the lemma: "θρεπτικός", according to the following morphological descriptions: "ADJ;NOM(DU;NEUT)"	θρεπτικός" and "θρ
Generate the inflected form for the lemma: "θρεπτικός", according to the following morphological descriptions: "ADJ;NOM(PL;MASC)"	ικός" and "θρεπτικ
Generate the inflected form for the lemma: "θρεπτικός", according to the following morphological descriptions: "ADJ;NOM(SG;NEUT)"	ικός" (θρεπτικός)
Generate the inflected form for the lemma: "θρεπτικός", according to the following morphological descriptions: "ADJ;VOC(DU;FEM)"	ικός" (θρεπτικός)
Generate the inflected form for the lemma: "θρεπτικός", according to the following morphological descriptions: "ADJ;VOC(DU;MASC)"	ικός" and "θρεπτικ
Generate the inflected form for the lemma: "θρεπτικός", according to the following morphological descriptions: "ADJ;VOC(DU;NEUT)"	θρεπτικός" (θρεπ
Generate the inflected form for the lemma: "θρεπτικός", according to the following morphological descriptions: "ADJ;VOC(PL;FEM)"	ικός" (θρεπτικός)
Generate the inflected form for the lemma: "θρεπτικός", according to the following morphological descriptions: "ADJ;VOC(PL;MASC)"	ικός" and "θρεπτικ
Generate the inflected form for the lemma: "θρεπτικός", according to the following morphological descriptions: "ADJ;VOC(PL;NEUT)"	ικός" (θρεπτικός)
Generate the inflected form for the lemma: "θρεπτικός", according to the following morphological descriptions: "ADJ;VOC(SG;FEM)"	ικός" and "θρεπτικ
Generate the inflected form for the lemma: "θρεπτικός", according to the following morphological descriptions: "ADJ;VOC(SG;MASC)"	ικός" and "θρεπτικ
Generate the inflected form for the lemma: "θρεπτικός", according to the following morphological descriptions: "ADJ;VOC(SG;NEUT)"	ικός" (θρεπτικός)
Generate the inflected form for the lemma: "θυγάτηρ", according to the following morphological descriptions: "N;ACC(DU)"	οίκος και καλλιτ
Generate the inflected form for the lemma: "θυγάτηρ", according to the following morphological descriptions: "N;ACC(PL)"	ορθόδοξος θυγάτ
Generate the inflected form for the lemma: "θυγάτηρ", according to the following morphological descriptions: "N;ACC(SG)"	ατηρ θυγάτηρ θυγ
Generate the inflected form for the lemma: "θυγάτηρ", according to the following morphological descriptions: "N;DAT(DU)"	ορθόδοξος θυγάτ
Generate the inflected form for the lemma: "θυγάτηρ", according to the following morphological descriptions: "N;DAT(PL)"	ανακαίνεται με τ
Generate the inflected form for the lemma: "θυγάτηρ", according to the following morphological descriptions: "N;DAT(SG)"	ορθόδοξος θυγάτ
Generate the inflected form for the lemma: "θυγάτηρ", according to the following morphological descriptions: "N;GEN(DU)"	αναίτιος", according t
Generate the inflected form for the lemma: "θυγάτηρ", according to the following morphological descriptions: "N;GEN(PL)"	θυγάτηρ" (θυγάτη
Generate the inflected form for the lemma: "θυγάτηρ", according to the following morphological descriptions: "N;GEN(SG)"	οίκος και καλλιτ
Generate the inflected form for the lemma: "θυγάτηρ", according to the following morphological descriptions: "N;NOM(DU)"	αναίτιος θυγάτη
Generate the inflected form for the lemma: "θυγάτηρ", according to the following morphological descriptions: "N;NOM(PL)"	ανακαίνεται με τ
Generate the inflected form for the lemma: "θυγάτηρ", according to the following morphological descriptions: "N;NOM(SG)"	αναίρετος αναίρ
Generate the inflected form for the lemma: "θυγάτηρ", according to the following morphological descriptions: "N;VOC(DU)"	οίκος και καλλιτ
Generate the inflected form for the lemma: "θυγάτηρ", according to the following morphological descriptions: "N;VOC(PL)"	ανακαίνεται με τ
Generate the inflected form for the lemma: "θυγάτηρ", according to the following morphological descriptions: "N;VOC(SG)"	οίκος και καλλιτ
Generate the inflected form for the lemma: "καδμία", according to the following morphological descriptions: "N;ACC(DU)"	καδμία καδμία κα
Generate the inflected form for the lemma: "καδμία", according to the following morphological descriptions: "N;ACC(PL)"	καδμία" and the followin
Generate the inflected form for the lemma: "καδμία", according to the following morphological descriptions: "N;ACC(SG)"	καδμία καδμία κα
Generate the inflected form for the lemma: "καδμία", according to the following morphological descriptions: "N;DAT(DU)"	καδμία" and the followin
Generate the inflected form for the lemma: "καδμία", according to the following morphological descriptions: "N;DAT(PL)"	καδμία" and the followin
Generate the inflected form for the lemma: "καδμία", according to the following morphological descriptions: "N;DAT(SG)"	καδμία", according to th
Generate the inflected form for the lemma: "καδμία", according to the following morphological descriptions: "N;GEN(DU)"	καδμία" and the followin
Generate the inflected form for the lemma: "καδμία", according to the following morphological descriptions: "N;GEN(PL)"	καδμία" (καδμία) (
Generate the inflected form for the lemma: "καδμία", according to the following morphological descriptions: "N;GEN(SG)"	καδμία" (καδμία) (
Generate the inflected form for the lemma: "καδμία", according to the following morphological descriptions: "N;NOM(DU)"	καδμία", according to th
Generate the inflected form for the lemma: "καδμία", according to the following morphological descriptions: "N;NOM(PL)"	καδμία" and the followin
Generate the inflected form for the lemma: "καδμία", according to the following morphological descriptions: "N;NOM(SG)"	καδμία", according to th
Generate the inflected form for the lemma: "καδμία", according to the following morphological descriptions: "N;VOC(DU)"	καδμία" and "καδμί
Generate the inflected form for the lemma: "καδμία", according to the following morphological descriptions: "N;VOC(PL)"	καδμία" and the followin
Generate the inflected form for the lemma: "καδμία", according to the following morphological descriptions: "N;VOC(SG)"	καδμία" and the followin
Generate the inflected form for the lemma: "κενταύριον", according to the following morphological descriptions: "N;ACC(DU)"	κενταύριον" in the f
Generate the inflected form for the lemma: "κενταύριον", according to the following morphological descriptions: "N;ACC(PL)"	ενταύριον" and "κε
Generate the inflected form for the lemma: "κενταύριον", according to the following morphological descriptions: "N;ACC(SG)"	κενταύριον" in the f
Generate the inflected form for the lemma: "κενταύριον", according to the following morphological descriptions: "N;DAT(DU)"	ενταύριον" and "κε
Generate the inflected form for the lemma: "κενταύριον", according to the following morphological descriptions: "N;DAT(PL)"	ενταύριον" and "κε
Generate the inflected form for the lemma: "κενταύριον", according to the following morphological descriptions: "N;DAT(SG)"	ενταύριον" and "κε
Generate the inflected form for the lemma: "κενταύριον", according to the following morphological descriptions: "N;GEN(DU)"	ενταύριον" in the fol
Generate the inflected form for the lemma: "κενταύριον", according to the following morphological descriptions: "N;GEN(PL)"	κενταύριον" (κεν
Generate the inflected form for the lemma: "κενταύριον", according to the following morphological descriptions: "N;GEN(SG)"	κενταύριον" (κεν
Generate the inflected form for the lemma: "κενταύριον", according to the following morphological descriptions: "N;NOM(DU)"	κενταύριον" (κεν
Generate the inflected form for the lemma: "κενταύριον", according to the following morphological descriptions: "N;NOM(PL)"	ενταύριον" and the fo
Generate the inflected form for the lemma: "κενταύριον", according to the following morphological descriptions: "N;NOM(SG)"	κενταύριον" and the 
Generate the inflected form for the lemma: "κενταύριον", according to the following morphological descriptions: "N;VOC(DU)"	κενταύριον" in the f
Generate the inflected form for the lemma: "κενταύριον", according to the following morphological descriptions: "N;VOC(PL)"	κενταύριον" and "κ
Generate the inflected form for the lemma: "κενταύριον", according to the following morphological descriptions: "N;VOC(SG)"	κενταύριον" and "κ
Generate the inflected form for the lemma: "κενός", according to the following morphological descriptions: "ADJ;ACC(DU;FEM)"	κενός" is the form of the
Generate the inflected form for the lemma: "κενός", according to the following morphological descriptions: "ADJ;ACC(DU;MASC)"	ός" (κενός) (κενός
Generate the inflected form for the lemma: "κενός", according to the following morphological descriptions: "ADJ;ACC(DU;NEUT)"	κενός" is the form of the
Generate the inflected form for the lemma: "κενός", according to the following morphological descriptions: "ADJ;ACC(PL;FEM)"	ός" (κενός) (κενός
Generate the inflected form for the lemma: "κενός", according to the following morphological descriptions: "ADJ;ACC(PL;MASC)"	ός" and "κενός". The le
Generate the inflected form for the lemma: "κενός", according to the following morphological descriptions: "ADJ;ACC(PL;NEUT)"	ός" (κενός) (κενός
Generate the inflected form for the lemma: "κενός", according to the following morphological descriptions: "ADJ;ACC(SG;FEM)"	ός" (κενός) (κενός
Generate the inflected form for the lemma: "κενός", according to the following morphological descriptions: "ADJ;ACC(SG;MASC)"	κενός" is the following f
Generate the inflected form for the lemma: "κενός", according to the following morphological descriptions: "ADJ;ACC(SG;NEUT)"	ός" (κενός) (κενός
Generate the inflected form for the lemma: "κενός", according to the following morphological descriptions: "ADJ;DAT(DU;FEM)"	ός" (κενός) (κενός
Generate the inflected form for the lemma: "κενός", according to the following morphological descriptions: "ADJ;DAT(DU;MASC)"	ός" and "κενός". The le
Generate the inflected form for the lemma: "κενός", according to the following morphological descriptions: "ADJ;DAT(PL;FEM)"	ός" (κενός) (κενός
Generate the inflected form for the lemma: "κενός", according to the following morphological descriptions: "ADJ;DAT(PL;MASC)"	ός" in the following morphol
Generate the inflected form for the lemma: "κενός", according to the following morphological descriptions: "ADJ;DAT(PL;NEUT)"	κενός" Generate the infle
Generate the inflected form for the lemma: "κενός", according to the following morphological descriptions: "ADJ;DAT(SG;MASC)"	ός" in the following morphol
Generate the inflected form for the lemma: "κενός", according to the following morphological descriptions: "ADJ;DAT(SG;NEUT)"	ός" (κενός) (κενός
Generate the inflected form for the lemma: "κενός", according to the following morphological descriptions: "ADJ;GEN(DU;FEM)"	κενός" (κενός) (κε
Generate the inflected form for the lemma: "κενός", according to the following morphological descriptions: "ADJ;GEN(PL;FEM)"	ός" (κενός) (κενός
Generate the inflected form for the lemma: "κενός", according to the following morphological descriptions: "ADJ;GEN(PL;MASC)"	ός" (κενός) (κενός
Generate the inflected form for the lemma: "κενός", according to the following morphological descriptions: "ADJ;GEN(SG;NEUT)"	ός" (κενός) (κενός
Generate the inflected form for the lemma: "κενός", according to the following morphological descriptions: "ADJ;NOM(DU;FEM)"	κενός" (κενός) (κε
Generate the inflected form for the lemma: "κενός", according to the following morphological descriptions: "ADJ;NOM(DU;MASC)"	ος" and "κενός". The le
Generate the inflected form for the lemma: "κενός", according to the following morphological descriptions: "ADJ;NOM(PL;NEUT)"	κενός" in the following m
Generate the inflected form for the lemma: "κενός", according to the following morphological descriptions: "ADJ;NOM(SG;FEM)"	κενός" in the following m
Generate the inflected form for the lemma: "κενός", according to the following morphological descriptions: "ADJ;NOM(SG;MASC)"	κενός" in the following m
Generate the inflected form for the lemma: "κενός", according to the following morphological descriptions: "ADJ;NOM(SG;NEUT)"	ός" (κενός) (κενός
Generate the inflected form for the lemma: "κενός", according to the following morphological descriptions: "ADJ;VOC(DU;FEM)"	κενός" in the following m
Generate the inflected form for the lemma: "κενός", according to the following morphological descriptions: "ADJ;VOC(DU;MASC)"	κενός" in the following m
Generate the inflected form for the lemma: "κενός", according to the following morphological descriptions: "ADJ;VOC(DU;NEUT)"	κενός" in the following m
Generate the inflected form for the lemma: "κενός", according to the following morphological descriptions: "ADJ;VOC(PL;MASC)"	κενός" in the following m
Generate the inflected form for the lemma: "κενός", according to the following morphological descriptions: "ADJ;VOC(PL;NEUT)"	κενός" Generate the infle
Generate the inflected form for the lemma: "κενός", according to the following morphological descriptions: "ADJ;VOC(SG;FEM)"	κενός" in the following m
Generate the inflected form for the lemma: "κενός", according to the following morphological descriptions: "ADJ;VOC(SG;MASC)"	κενός" in the following m
Generate the inflected form for the lemma: "κωλόβαθρον", according to the following morphological descriptions: "N;ACC(DU)"	κωλόβαθρον" and "κ
Generate the inflected form for the lemma: "κωλόβαθρον", according to the following morphological descriptions: "N;ACC(PL)"	κωλόβαθρον" and "κ
Generate the inflected form for the lemma: "κωλόβαθρον", according to the following morphological descriptions: "N;ACC(SG)"	κωλόβαθρον" and "κ
Generate the inflected form for the lemma: "κωλόβαθρον", according to the following morphological descriptions: "N;DAT(DU)"	βαθρον" and "κωλόβ
Generate the inflected form for the lemma: "κωλόβαθρον", according to the following morphological descriptions: "N;DAT(PL)"	βαθρον" and "κωλόβ
Generate the inflected form for the lemma: "κωλόβαθρον", according to the following morphological descriptions: "N;DAT(SG)"	κωλόβαθρον" and the 
Generate the inflected form for the lemma: "κωλόβαθρον", according to the following morphological descriptions: "N;GEN(DU)"	κωλόβαθρον" (κωλ
Generate the inflected form for the lemma: "κωλόβαθρον", according to the following morphological descriptions: "N;GEN(PL)"	κωλόβαθρον" (κωλ
Generate the inflected form for the lemma: "κωλόβαθρον", according to the following morphological descriptions: "N;GEN(SG)"	κωλόβαθρον" and "κ
Generate the inflected form for the lemma: "κωλόβαθρον", according to the following morphological descriptions: "N;NOM(DU)"	κωλόβαθρον" and the 
Generate the inflected form for the lemma: "κωλόβαθρον", according to the following morphological descriptions: "N;NOM(PL)"	βαθρον" and "κωλόβ
Generate the inflected form for the lemma: "κωλόβαθρον", according to the following morphological descriptions: "N;NOM(SG)"	βαθρον" and "κωλόβ
Generate the inflected form for the lemma: "κωλόβαθρον", according to the following morphological descriptions: "N;VOC(DU)"	βαθρον" and "κωλόβ
Generate the inflected form for the lemma: "κωλόβαθρον", according to the following morphological descriptions: "N;VOC(PL)"	κωλόβαθρον" and "κ
Generate the inflected form for the lemma: "κωλόβαθρον", according to the following morphological descriptions: "N;VOC(SG)"	κωλόβαθρον" and "κ
Generate the inflected form for the lemma: "λειμώνιον", according to the following morphological descriptions: "N;ACC(DU)"	λειμώνιον" and the fo
Generate the inflected form for the lemma: "λειμώνιον", according to the following morphological descriptions: "N;ACC(PL)"	λειμώνιον" and the fo
Generate the inflected form for the lemma: "λειμώνιον", according to the following morphological descriptions: "N;ACC(SG)"	λειμώνιον" and the fo
Generate the inflected form for the lemma: "λειμώνιον", according to the following morphological descriptions: "N;DAT(DU)"	λειμώνιον" and the fo
Generate the inflected form for the lemma: "λειμώνιον", according to the following morphological descriptions: "N;DAT(PL)"	λειμώνιον" and the fo
Generate the inflected form for the lemma: "λειμώνιον", according to the following morphological descriptions: "N;DAT(SG)"	λειμώνιον" and the fo
Generate the inflected form for the lemma: "λειμώνιον", according to the following morphological descriptions: "N;GEN(DU)"	λειμώνιον" (λειμ
Generate the inflected form for the lemma: "λειμώνιον", according to the following morphological descriptions: "N;GEN(PL)"	λειμώνιον" (λειμ
Generate the inflected form for the lemma: "λειμώνιον", according to the following morphological descriptions: "N;GEN(SG)"	λειμώνιον" and the fo
Generate the inflected form for the lemma: "λειμώνιον", according to the following morphological descriptions: "N;NOM(DU)"	λειμώνιον" and the fo
Generate the inflected form for the lemma: "λειμώνιον", according to the following morphological descriptions: "N;NOM(PL)"	λειμώνιον" and the fo
Generate the inflected form for the lemma: "λειμώνιον", according to the following morphological descriptions: "N;NOM(SG)"	λειμώνιον", according
Generate the inflected form for the lemma: "λειμώνιον", according to the following morphological descriptions: "N;VOC(DU)"	λειμώνιον" and the fo
Generate the inflected form for the lemma: "λειμώνιον", according to the following morphological descriptions: "N;VOC(PL)"	λειμώνιον" and the fo
Generate the inflected form for the lemma: "λειμώνιον", according to the following morphological descriptions: "N;VOC(SG)"	λειμώνιον" and the fo
Generate the inflected form for the lemma: "μελῳδία", according to the following morphological descriptions: "N;ACC(DU)"	ῷ μελῳδία" and "με
Generate the inflected form for the lemma: "μελῳδία", according to the following morphological descriptions: "N;ACC(PL)"	ῷ μελῳδία" and "με
Generate the inflected form for the lemma: "μελῳδία", according to the following morphological descriptions: "N;ACC(SG)"	ῷ ῷ ῷ ῷ ῷ ῷ ῷ 
Generate the inflected form for the lemma: "μελῳδία", according to the following morphological descriptions: "N;DAT(DU)"	ῷ ῷ ῷ ῷ ῷ ῷ ῷ 
Generate the inflected form for the lemma: "μελῳδία", according to the following morphological descriptions: "N;DAT(PL)"	ῷ ῷ ῷ ῷ ῷ ῷ ῷ 
Generate the inflected form for the lemma: "μελῳδία", according to the following morphological descriptions: "N;DAT(SG)"	ῷ μελῳδία" and the f
Generate the inflected form for the lemma: "μελῳδία", according to the following morphological descriptions: "N;GEN(DU)"	ῷ ῷ ῷ ῷ ῷ ῷ ῷ 
Generate the inflected form for the lemma: "μελῳδία", according to the following morphological descriptions: "N;GEN(PL)"	ῷ ῷ ῷ ῷ ῷ ῷ ῷ 
Generate the inflected form for the lemma: "μελῳδία", according to the following morphological descriptions: "N;GEN(SG)"	ῷ ῷ ῷ ῷ ῷ ῷ ῷ 
Generate the inflected form for the lemma: "μελῳδία", according to the following morphological descriptions: "N;NOM(DU)"	ῷ ῷ ῷ ῷ ῷ ῷ ῷ 
Generate the inflected form for the lemma: "μελῳδία", according to the following morphological descriptions: "N;NOM(PL)"	ῷ ῷ ῷ ῷ ῷ ῷ ῷ 
Generate the inflected form for the lemma: "μελῳδία", according to the following morphological descriptions: "N;NOM(SG)"	ῷ μελῳδία" and "με
Generate the inflected form for the lemma: "μελῳδία", according to the following morphological descriptions: "N;VOC(DU)"	ῷ ῷ ῷ ῷ ῷ ῷ ῷ 
Generate the inflected form for the lemma: "μελῳδία", according to the following morphological descriptions: "N;VOC(PL)"	ῷ ῷ ῷ ῷ ῷ ῷ ῷ 
Generate the inflected form for the lemma: "μελῳδία", according to the following morphological descriptions: "N;VOC(SG)"	ῷ ῷ ῷ ῷ ῷ ῷ ῷ 
Generate the inflected form for the lemma: "οἶνος", according to the following morphological descriptions: "N;ACC(DU)"	οὶνος" and the following
Generate the inflected form for the lemma: "οἶνος", according to the following morphological descriptions: "N;ACC(PL)"	οἰνος" and "οἶνος"
Generate the inflected form for the lemma: "οἶνος", according to the following morphological descriptions: "N;ACC(SG)"	οὶνος" and "οὗνος"
Generate the inflected form for the lemma: "οἶνος", according to the following morphological descriptions: "N;DAT(DU)"	οῦνος", according to the
Generate the inflected form for the lemma: "οἶνος", according to the following morphological descriptions: "N;DAT(PL)"	οὶνος" and "οὗνος"
Generate the inflected form for the lemma: "οἶνος", according to the following morphological descriptions: "N;DAT(SG)"	οὶνος" and the following
Generate the inflected form for the lemma: "οἶνος", according to the following morphological descriptions: "N;GEN(DU)"	οὶνος" and "οὗνος"
Generate the inflected form for the lemma: "οἶνος", according to the following morphological descriptions: "N;GEN(PL)"	οἰνος" and "οἶνος"
Generate the inflected form for the lemma: "οἶνος", according to the following morphological descriptions: "N;GEN(SG)"	οἰνος" and "οἶνος"
Generate the inflected form for the lemma: "οἶνος", according to the following morphological descriptions: "N;NOM(DU)"	οίνος", according to the 
Generate the inflected form for the lemma: "οἶνος", according to the following morphological descriptions: "N;NOM(PL)"	οἰνος" and "οἰνος"
Generate the inflected form for the lemma: "οἶνος", according to the following morphological descriptions: "N;NOM(SG)"	οίνος", according to the 
Generate the inflected form for the lemma: "οἶνος", according to the following morphological descriptions: "N;VOC(DU)"	οῦνος", according to the
Generate the inflected form for the lemma: "οἶνος", according to the following morphological descriptions: "N;VOC(PL)"	οῦνος" and "οῦνος"
Generate the inflected form for the lemma: "οἶνος", according to the following morphological descriptions: "N;VOC(SG)"	οὶνος" and "οὗνος"
Generate the inflected form for the lemma: "παλίμψηστος", according to the following morphological descriptions: "ADJ;ACC(DU;FEM)"	αλίμψηστος" (αλί
Generate the inflected form for the lemma: "παλίμψηστος", according to the following morphological descriptions: "ADJ;ACC(DU;NEUT)"	αλίμψηστος" (αλί
Generate the inflected form for the lemma: "παλίμψηστος", according to the following morphological descriptions: "ADJ;ACC(PL;MASC)"	αλίμψηστος" and "α
Generate the inflected form for the lemma: "παλίμψηστος", according to the following morphological descriptions: "ADJ;ACC(SG;FEM)"	αλίμψηστος" in the f
Generate the inflected form for the lemma: "παλίμψηστος", according to the following morphological descriptions: "ADJ;ACC(SG;MASC)"	αλίμψηστος" in the f
Generate the inflected form for the lemma: "παλίμψηστος", according to the following morphological descriptions: "ADJ;ACC(SG;NEUT)"	αλίμψηστος" (αλί
Generate the inflected form for the lemma: "παλίμψηστος", according to the following morphological descriptions: "ADJ;DAT(DU;FEM)"	αλίμψηστος" (αλί
Generate the inflected form for the lemma: "παλίμψηστος", according to the following morphological descriptions: "ADJ;DAT(DU;MASC)"	αλίμψηστος" and "α
Generate the inflected form for the lemma: "παλίμψηστος", according to the following morphological descriptions: "ADJ;DAT(DU;NEUT)"	ος" (ος είναι ο ος
Generate the inflected form for the lemma: "παλίμψηστος", according to the following morphological descriptions: "ADJ;DAT(PL;MASC)"	αλίμψηστος" and "α
Generate the inflected form for the lemma: "παλίμψηστος", according to the following morphological descriptions: "ADJ;DAT(PL;NEUT)"	αλίμψηστος" (αλί
Generate the inflected form for the lemma: "παλίμψηστος", according to the following morphological descriptions: "ADJ;DAT(SG;MASC)"	ος" and "ος" and "ος".
G
Generate the inflected form for the lemma: "παλίμψηστος", according to the following morphological descriptions: "ADJ;GEN(DU;FEM)"	ος" (αναφορά εισα
Generate the inflected form for the lemma: "παλίμψηστος", according to the following morphological descriptions: "ADJ;GEN(DU;MASC)"	αλίμψηστος" (αλί
Generate the inflected form for the lemma: "παλίμψηστος", according to the following morphological descriptions: "ADJ;GEN(DU;NEUT)"	αλίμψηστος" (αλί
Generate the inflected form for the lemma: "παλίμψηστος", according to the following morphological descriptions: "ADJ;GEN(PL;FEM)"	ος" (αναφορά παλί
Generate the inflected form for the lemma: "παλίμψηστος", according to the following morphological descriptions: "ADJ;GEN(PL;MASC)"	αλίμψηστος" (αλί
Generate the inflected form for the lemma: "παλίμψηστος", according to the following morphological descriptions: "ADJ;GEN(PL;NEUT)"	ος" (αναφορά εισα
Generate the inflected form for the lemma: "παλίμψηστος", according to the following morphological descriptions: "ADJ;GEN(SG;FEM)"	ος" (αναφορά παλί
Generate the inflected form for the lemma: "παλίμψηστος", according to the following morphological descriptions: "ADJ;GEN(SG;MASC)"	αλίμψηστος" is the f
Generate the inflected form for the lemma: "παλίμψηστος", according to the following morphological descriptions: "ADJ;GEN(SG;NEUT)"	ος" (ος είναι ο ος
Generate the inflected form for the lemma: "παλίμψηστος", according to the following morphological descriptions: "ADJ;NOM(DU;NEUT)"	ος" (ος είναι ο ος
Generate the inflected form for the lemma: "παλίμψηστος", according to the following morphological descriptions: "ADJ;NOM(PL;FEM)"	αλίμψηστος" and "α
Generate the inflected form for the lemma: "παλίμψηστος", according to the following morphological descriptions: "ADJ;NOM(PL;MASC)"	αλίμψηστος" and "α
Generate the inflected form for the lemma: "παλίμψηστος", according to the following morphological descriptions: "ADJ;NOM(PL;NEUT)"	ος" (ος είναι ο ος
Generate the inflected form for the lemma: "παλίμψηστος", according to the following morphological descriptions: "ADJ;VOC(DU;FEM)"	αλίμψηστος" (αλί
Generate the inflected form for the lemma: "παλίμψηστος", according to the following morphological descriptions: "ADJ;VOC(DU;MASC)"	αλίμψηστος" and "π
Generate the inflected form for the lemma: "παλίμψηστος", according to the following morphological descriptions: "ADJ;VOC(DU;NEUT)"	ος" (ος είναι ο ος
Generate the inflected form for the lemma: "παλίμψηστος", according to the following morphological descriptions: "ADJ;VOC(PL;MASC)"	ος" and "ος".
Generate the
Generate the inflected form for the lemma: "παλίμψηστος", according to the following morphological descriptions: "ADJ;VOC(PL;NEUT)"	ος" (ος είναι ο ος
Generate the inflected form for the lemma: "παλίμψηστος", according to the following morphological descriptions: "ADJ;VOC(SG;FEM)"	αλίμψηστος" (αλί
Generate the inflected form for the lemma: "παλίμψηστος", according to the following morphological descriptions: "ADJ;VOC(SG;MASC)"	ος" (αναφορά παλί
Generate the inflected form for the lemma: "παλίμψηστος", according to the following morphological descriptions: "ADJ;VOC(SG;NEUT)"	αλίμψηστος" and "π
Generate the inflected form for the lemma: "παραλυτικός", according to the following morphological descriptions: "ADJ;ACC(DU;FEM)"	αραλυτικός" (αρα
Generate the inflected form for the lemma: "παραλυτικός", according to the following morphological descriptions: "ADJ;ACC(DU;MASC)"	λυτικός" (αναφορ
Generate the inflected form for the lemma: "παραλυτικός", according to the following morphological descriptions: "ADJ;ACC(DU;NEUT)"	ος" και "ος" και "ο
Generate the inflected form for the lemma: "παραλυτικός", according to the following morphological descriptions: "ADJ;ACC(PL;FEM)"	αραλυτικός" (αρα
Generate the inflected form for the lemma: "παραλυτικός", according to the following morphological descriptions: "ADJ;ACC(PL;MASC)"	λυτικός" and "αλυτ
Generate the inflected form for the lemma: "παραλυτικός", according to the following morphological descriptions: "ADJ;ACC(PL;NEUT)"	αραλυτικός". Generat
Generate the inflected form for the lemma: "παραλυτικός", according to the following morphological descriptions: "ADJ;ACC(SG;FEM)"	λυτικός" (από το 
Generate the inflected form for the lemma: "παραλυτικός", according to the following morphological descriptions: "ADJ;ACC(SG;MASC)"	λυτικός" in the followi
Generate the inflected form for the lemma: "παραλυτικός", according to the following morphological descriptions: "ADJ;ACC(SG;NEUT)"	λυτικός" (εκδόσε
Generate the inflected form for the lemma: "παραλυτικός", according to the following morphological descriptions: "ADJ;DAT(DU;FEM)"	λυτικός" (εκτός α
Generate the inflected form for the lemma: "παραλυτικός", according to the following morphological descriptions: "ADJ;DAT(DU;MASC)"	αραλυτικός" Generate
Generate the inflected form for the lemma: "παραλυτικός", according to the following morphological descriptions: "ADJ;DAT(DU;NEUT)"	λυτικός" (εκφράζ
Generate the inflected form for the lemma: "παραλυτικός", according to the following morphological descriptions: "ADJ;DAT(PL;FEM)"	αραλυτικός" Generate
Generate the inflected form for the lemma: "παραλυτικός", according to the following morphological descriptions: "ADJ;DAT(PL;MASC)"	αραλυτικός" Generate
Generate the inflected form for the lemma: "παραλυτικός", according to the following morphological descriptions: "ADJ;DAT(PL;NEUT)"	ος" και "ος" και "ο
Generate the inflected form for the lemma: "παραλυτικός", according to the following morphological descriptions: "ADJ;DAT(SG;FEM)"	λυτικός" in the followi
Generate the inflected form for the lemma: "παραλυτικός", according to the following morphological descriptions: "ADJ;DAT(SG;MASC)"	αραλυτικός" is a sem
Generate the inflected form for the lemma: "παραλυτικός", according to the following morphological descriptions: "ADJ;GEN(DU;FEM)"	λυτικός" (εκτός α
Generate the inflected form for the lemma: "παραλυτικός", according to the following morphological descriptions: "ADJ;GEN(PL;MASC)"	ικός" (από το εικ
Generate the inflected form for the lemma: "παραλυτικός", according to the following morphological descriptions: "ADJ;GEN(PL;NEUT)"	ικός" (αναφορά πα
Generate the inflected form for the lemma: "παραλυτικός", according to the following morphological descriptions: "ADJ;GEN(SG;FEM)"	λυτικός" (αναφορ
Generate the inflected form for the lemma: "παραλυτικός", according to the following morphological descriptions: "ADJ;GEN(SG;MASC)"	ικός" and "αναλυτι
Generate the inflected form for the lemma: "παραλυτικός", according to the following morphological descriptions: "ADJ;GEN(SG;NEUT)"	ικός" (αναφορά πα
Generate the inflected form for the lemma: "παραλυτικός", according to the following morphological descriptions: "ADJ;NOM(DU;FEM)"	αραλυτικός" Generate
Generate the inflected form for the lemma: "παραλυτικός", according to the following morphological descriptions: "ADJ;NOM(DU;MASC)"	λυτικός" and "αλυτ
Generate the inflected form for the lemma: "παραλυτικός", according to the following morphological descriptions: "ADJ;NOM(DU;NEUT)"	λυτικός" (εκφράζ
Generate the inflected form for the lemma: "παραλυτικός", according to the following morphological descriptions: "ADJ;NOM(PL;FEM)"	αραλυτικός" Generate
Generate the inflected form for the lemma: "παραλυτικός", according to the following morphological descriptions: "ADJ;NOM(SG;FEM)"	λυτικός" and "αναλ
Generate the inflected form for the lemma: "παραλυτικός", according to the following morphological descriptions: "ADJ;VOC(PL;FEM)"	λυτικός" (από το 
Generate the inflected form for the lemma: "παραλυτικός", according to the following morphological descriptions: "ADJ;VOC(PL;MASC)"	αραλυτικός" Generate
Generate the inflected form for the lemma: "παραλυτικός", according to the following morphological descriptions: "ADJ;VOC(PL;NEUT)"	αραλυτικός" Generate
Generate the inflected form for the lemma: "παραλυτικός", according to the following morphological descriptions: "ADJ;VOC(SG;FEM)"	λυτικός" in the followi
Generate the inflected form for the lemma: "παραλυτικός", according to the following morphological descriptions: "ADJ;VOC(SG;MASC)"	αραλυτικός" is a sem
Generate the inflected form for the lemma: "ποτήριον", according to the following morphological descriptions: "N;ACC(DU)"	οτήριον" and "ποτή
Generate the inflected form for the lemma: "ποτήριον", according to the following morphological descriptions: "N;ACC(PL)"	οτήριον" and "ποτή
Generate the inflected form for the lemma: "ποτήριον", according to the following morphological descriptions: "N;ACC(SG)"	οτήριον" and "ποτή
Generate the inflected form for the lemma: "ποτήριον", according to the following morphological descriptions: "N;DAT(DU)"	οτήριον" and "ποτή
Generate the inflected form for the lemma: "ποτήριον", according to the following morphological descriptions: "N;DAT(PL)"	οτήριον" and "ποτή
Generate the inflected form for the lemma: "ποτήριον", according to the following morphological descriptions: "N;DAT(SG)"	οτήριον" and "ποτή
Generate the inflected form for the lemma: "ποτήριον", according to the following morphological descriptions: "N;GEN(DU)"	οτήριον" and "ποτή
Generate the inflected form for the lemma: "ποτήριον", according to the following morphological descriptions: "N;GEN(PL)"	οτήριον" and "ποτή
Generate the inflected form for the lemma: "ποτήριον", according to the following morphological descriptions: "N;GEN(SG)"	οτήριον" and "ποτή
Generate the inflected form for the lemma: "ποτήριον", according to the following morphological descriptions: "N;NOM(DU)"	οριοριοριοριορι
Generate the inflected form for the lemma: "ποτήριον", according to the following morphological descriptions: "N;NOM(PL)"	ορος ποτήριον" (ε
Generate the inflected form for the lemma: "ποτήριον", according to the following morphological descriptions: "N;NOM(SG)"	ορος ποτήριον" (ο
Generate the inflected form for the lemma: "ποτήριον", according to the following morphological descriptions: "N;VOC(DU)"	οτήριον" and "ποτή
Generate the inflected form for the lemma: "ποτήριον", according to the following morphological descriptions: "N;VOC(PL)"	οτήριον" and "ποτή
Generate the inflected form for the lemma: "ποτήριον", according to the following morphological descriptions: "N;VOC(SG)"	οτήριον" and "ποτή
Generate the inflected form for the lemma: "πτέρνη", according to the following morphological descriptions: "N;ACC(DU)"	η η η η η η η η η η 
Generate the inflected form for the lemma: "πτέρνη", according to the following morphological descriptions: "N;ACC(PL)"	η και η καλή και 
Generate the inflected form for the lemma: "πτέρνη", according to the following morphological descriptions: "N;ACC(SG)"	η η η η η η η η η η 
Generate the inflected form for the lemma: "πτέρνη", according to the following morphological descriptions: "N;DAT(DU)"	η η η η η η η η η η 
Generate the inflected form for the lemma: "πτέρνη", according to the following morphological descriptions: "N;DAT(PL)"	η και η καλή και 
Generate the inflected form for the lemma: "πτέρνη", according to the following morphological descriptions: "N;DAT(SG)"	η η η η η η η η η η 
Generate the inflected form for the lemma: "πτέρνη", according to the following morphological descriptions: "N;GEN(DU)"	η η η η η η η η η η 
Generate the inflected form for the lemma: "πτέρνη", according to the following morphological descriptions: "N;GEN(PL)"	η η η η η η η η η η 
Generate the inflected form for the lemma: "πτέρνη", according to the following morphological descriptions: "N;GEN(SG)"	η η η η η η η η η η 
Generate the inflected form for the lemma: "πτέρνη", according to the following morphological descriptions: "N;NOM(DU)"	η η η η η η η η η η 
Generate the inflected form for the lemma: "πτέρνη", according to the following morphological descriptions: "N;NOM(PL)"	η η η η η η η η η η 
Generate the inflected form for the lemma: "πτέρνη", according to the following morphological descriptions: "N;NOM(SG)"	η η η η η η η η η η 
Generate the inflected form for the lemma: "πτέρνη", according to the following morphological descriptions: "N;VOC(DU)"	η η η η η η η η η η 
Generate the inflected form for the lemma: "πτέρνη", according to the following morphological descriptions: "N;VOC(PL)"	η η η η η η η η η η 
Generate the inflected form for the lemma: "πτέρνη", according to the following morphological descriptions: "N;VOC(SG)"	η η η η η η η η η η 
Generate the inflected form for the lemma: "πῆγμα", according to the following morphological descriptions: "N;ACC(DU)"	γμα (πῆγμα)" and "π
Generate the inflected form for the lemma: "πῆγμα", according to the following morphological descriptions: "N;ACC(PL)"	γμα (πῆγμα)" and "π
Generate the inflected form for the lemma: "πῆγμα", according to the following morphological descriptions: "N;ACC(SG)"	γμα (πῆγμα)" and "π
Generate the inflected form for the lemma: "πῆγμα", according to the following morphological descriptions: "N;DAT(DU)"	γμα (γματίων) πῆ
Generate the inflected form for the lemma: "πῆγμα", according to the following morphological descriptions: "N;DAT(PL)"	γμα (πῆγμα)" and "π
Generate the inflected form for the lemma: "πῆγμα", according to the following morphological descriptions: "N;DAT(SG)"	αγμα", according to the fo
Generate the inflected form for the lemma: "πῆγμα", according to the following morphological descriptions: "N;GEN(DU)"	γμα (πῆγμα)" and "π
Generate the inflected form for the lemma: "πῆγμα", according to the following morphological descriptions: "N;GEN(PL)"	γμα (πῆγμα)" (πῆγ
Generate the inflected form for the lemma: "πῆγμα", according to the following morphological descriptions: "N;GEN(SG)"	γμα (πῆγμα)" (πῆγ
Generate the inflected form for the lemma: "πῆγμα", according to the following morphological descriptions: "N;NOM(DU)"	αγμα", according to the fo
Generate the inflected form for the lemma: "πῆγμα", according to the following morphological descriptions: "N;NOM(PL)"	αγμα", according to the fo
Generate the inflected form for the lemma: "πῆγμα", according to the following morphological descriptions: "N;NOM(SG)"	αγμα", according to the fo
Generate the inflected form for the lemma: "πῆγμα", according to the following morphological descriptions: "N;VOC(DU)"	γμα (πῆγμα)" and "π
Generate the inflected form for the lemma: "πῆγμα", according to the following morphological descriptions: "N;VOC(PL)"	γμα (πῆγμα)" and "π
Generate the inflected form for the lemma: "πῆγμα", according to the following morphological descriptions: "N;VOC(SG)"	γμα (πῆγμα)" and "π
Generate the inflected form for the lemma: "σίραιον", according to the following morphological descriptions: "N;ACC(DU)"	ιραίον σίραιον σ
Generate the inflected form for the lemma: "σίραιον", according to the following morphological descriptions: "N;ACC(PL)"	ιραίον" and "σίραι
Generate the inflected form for the lemma: "σίραιον", according to the following morphological descriptions: "N;ACC(SG)"	ιραίον σίραιον σ
Generate the inflected form for the lemma: "σίραιον", according to the following morphological descriptions: "N;DAT(DU)"	ιραίον σίραιον σ
Generate the inflected form for the lemma: "σίραιον", according to the following morphological descriptions: "N;DAT(PL)"	ιραίον σίραιον σ
Generate the inflected form for the lemma: "σίραιον", according to the following morphological descriptions: "N;DAT(SG)"	ιραίον σίραιον σ
Generate the inflected form for the lemma: "σίραιον", according to the following morphological descriptions: "N;GEN(DU)"	ον", according to the follow
Generate the inflected form for the lemma: "σίραιον", according to the following morphological descriptions: "N;GEN(PL)"	ιραίον" and "σίραι
Generate the inflected form for the lemma: "σίραιον", according to the following morphological descriptions: "N;GEN(SG)"	ιραίον" and "σίραι
Generate the inflected form for the lemma: "σίραιον", according to the following morphological descriptions: "N;NOM(DU)"	ον και εν και εν 
Generate the inflected form for the lemma: "σίραιον", according to the following morphological descriptions: "N;NOM(PL)"	ιραίον" and "σίραι
Generate the inflected form for the lemma: "σίραιον", according to the following morphological descriptions: "N;NOM(SG)"	ιραίον" and the followin
Generate the inflected form for the lemma: "σίραιον", according to the following morphological descriptions: "N;VOC(DU)"	ιραίον σίραιον σ
Generate the inflected form for the lemma: "σίραιον", according to the following morphological descriptions: "N;VOC(PL)"	ιραίον" and "σίραι
Generate the inflected form for the lemma: "σίραιον", according to the following morphological descriptions: "N;VOC(SG)"	ιραίον" and "σίραι
Generate the inflected form for the lemma: "σκέπη", according to the following morphological descriptions: "N;ACC(DU)"	η κέρατος και κέ
Generate the inflected form for the lemma: "σκέπη", according to the following morphological descriptions: "N;ACC(PL)"	η σκέπη σκέπη σκ
Generate the inflected form for the lemma: "σκέπη", according to the following morphological descriptions: "N;ACC(SG)"	η κέρατος και κέ
Generate the inflected form for the lemma: "σκέπη", according to the following morphological descriptions: "N;DAT(DU)"	η κέρατος και κέ
Generate the inflected form for the lemma: "σκέπη", according to the following morphological descriptions: "N;DAT(PL)"	κέπη (σκέπη) (σκέ
Generate the inflected form for the lemma: "σκέπη", according to the following morphological descriptions: "N;DAT(SG)"	η κέρατος και κέ
Generate the inflected form for the lemma: "σκέπη", according to the following morphological descriptions: "N;GEN(DU)"	η η η η η η η η η η 
Generate the inflected form for the lemma: "σκέπη", according to the following morphological descriptions: "N;GEN(PL)"	η η η η η η η η η η 
Generate the inflected form for the lemma: "σκέπη", according to the following morphological descriptions: "N;GEN(SG)"	η η η η η η η η η η 
Generate the inflected form for the lemma: "σκέπη", according to the following morphological descriptions: "N;NOM(DU)"	η και η καλή και 
Generate the inflected form for the lemma: "σκέπη", according to the following morphological descriptions: "N;NOM(PL)"	η η η η η η η η η η 
Generate the inflected form for the lemma: "σκέπη", according to the following morphological descriptions: "N;NOM(SG)"	 κέπη κέπη κέπη κ
Generate the inflected form for the lemma: "σκέπη", according to the following morphological descriptions: "N;VOC(DU)"	κέπη (σκέπη) (σκέ
Generate the inflected form for the lemma: "σκέπη", according to the following morphological descriptions: "N;VOC(PL)"	η κέπη κέπη κέπη 
Generate the inflected form for the lemma: "σκέπη", according to the following morphological descriptions: "N;VOC(SG)"	κέπη (σκέπη) (σκέ
Generate the inflected form for the lemma: "σχόλιον", according to the following morphological descriptions: "N;ACC(DU)"	λίον" and "σχόλιον"
Generate the inflected form for the lemma: "σχόλιον", according to the following morphological descriptions: "N;ACC(PL)"	λίον" in the following mor
Generate the inflected form for the lemma: "σχόλιον", according to the following morphological descriptions: "N;ACC(SG)"	λίον" and "σχόλιον"
Generate the inflected form for the lemma: "σχόλιον", according to the following morphological descriptions: "N;DAT(DU)"	λίον" and "σχόλιον"
Generate the inflected form for the lemma: "σχόλιον", according to the following morphological descriptions: "N;DAT(PL)"	λίον" in the following mor
Generate the inflected form for the lemma: "σχόλιον", according to the following morphological descriptions: "N;DAT(SG)"	λίον" and "σχόλιον"
Generate the inflected form for the lemma: "σχόλιον", according to the following morphological descriptions: "N;GEN(DU)"	λίον" and "σχόλιον"
Generate the inflected form for the lemma: "σχόλιον", according to the following morphological descriptions: "N;GEN(PL)"	λίον" and "σχόλιον"
Generate the inflected form for the lemma: "σχόλιον", according to the following morphological descriptions: "N;GEN(SG)"	λίον" and "σχόλιον"
Generate the inflected form for the lemma: "σχόλιον", according to the following morphological descriptions: "N;NOM(DU)"	λίον" and "καταγγε
Generate the inflected form for the lemma: "σχόλιον", according to the following morphological descriptions: "N;NOM(PL)"	λίον" and "σχόλιον"
Generate the inflected form for the lemma: "σχόλιον", according to the following morphological descriptions: "N;NOM(SG)"	λίον" and the following mo
Generate the inflected form for the lemma: "σχόλιον", according to the following morphological descriptions: "N;VOC(DU)"	λίον" and "σχόλιον"
Generate the inflected form for the lemma: "σχόλιον", according to the following morphological descriptions: "N;VOC(PL)"	λίον" and "σχόλιον"
Generate the inflected form for the lemma: "σχόλιον", according to the following morphological descriptions: "N;VOC(SG)"	λίον" and "σχόλιον"
Generate the inflected form for the lemma: "τακτικός", according to the following morphological descriptions: "ADJ;ACC(DU;FEM)"	κτικός" Generate the inf
Generate the inflected form for the lemma: "τακτικός", according to the following morphological descriptions: "ADJ;ACC(DU;NEUT)"	ικός" (αναφορά στ
Generate the inflected form for the lemma: "τακτικός", according to the following morphological descriptions: "ADJ;ACC(PL;FEM)"	κτικός" Generate the inf
Generate the inflected form for the lemma: "τακτικός", according to the following morphological descriptions: "ADJ;ACC(SG;FEM)"	κτικός" Generate the inf
Generate the inflected form for the lemma: "τακτικός", according to the following morphological descriptions: "ADJ;ACC(SG;MASC)"	ος" (εκτός από το 
Generate the inflected form for the lemma: "τακτικός", according to the following morphological descriptions: "ADJ;ACC(SG;NEUT)"	κτικός" Generate the inf
Generate the inflected form for the lemma: "τακτικός", according to the following morphological descriptions: "ADJ;DAT(DU;FEM)"	κτικός" ή "κτικός
Generate the inflected form for the lemma: "τακτικός", according to the following morphological descriptions: "ADJ;DAT(DU;MASC)"	ικός" and "αναλογι
Generate the inflected form for the lemma: "τακτικός", according to the following morphological descriptions: "ADJ;DAT(DU;NEUT)"	ικός" (αναφορά στ
Generate the inflected form for the lemma: "τακτικός", according to the following morphological descriptions: "ADJ;DAT(PL;FEM)"	κτικός" Generate the inf
Generate the inflected form for the lemma: "τακτικός", according to the following morphological descriptions: "ADJ;DAT(PL;MASC)"	ικός" and "ικός". The 
Generate the inflected form for the lemma: "τακτικός", according to the following morphological descriptions: "ADJ;DAT(PL;NEUT)"	ικός" (ικός) and "ικ
Generate the inflected form for the lemma: "τακτικός", according to the following morphological descriptions: "ADJ;DAT(SG;FEM)"	ος" and "ενδοτικός"
Generate the inflected form for the lemma: "τακτικός", according to the following morphological descriptions: "ADJ;DAT(SG;MASC)"	κτικός" Generate the inf
Generate the inflected form for the lemma: "τακτικός", according to the following morphological descriptions: "ADJ;GEN(DU;FEM)"	ικός" (εκτός από 
Generate the inflected form for the lemma: "τακτικός", according to the following morphological descriptions: "ADJ;GEN(PL;MASC)"	κτικός" Generate the inf
Generate the inflected form for the lemma: "τακτικός", according to the following morphological descriptions: "ADJ;GEN(PL;NEUT)"	κτικός" Generate the inf
Generate the inflected form for the lemma: "τακτικός", according to the following morphological descriptions: "ADJ;GEN(SG;FEM)"	ος" (αναφορά παρα
Generate the inflected form for the lemma: "τακτικός", according to the following morphological descriptions: "ADJ;GEN(SG;MASC)"	ικός" (ικός) and "ικ
Generate the inflected form for the lemma: "τακτικός", according to the following morphological descriptions: "ADJ;GEN(SG;NEUT)"	κτικός".
Generate the in
Generate the inflected form for the lemma: "τακτικός", according to the following morphological descriptions: "ADJ;NOM(DU;FEM)"	ικός" and "αναλογι
Generate the inflected form for the lemma: "τακτικός", according to the following morphological descriptions: "ADJ;NOM(DU;NEUT)"	ικός" and "αναγνωσ
Generate the inflected form for the lemma: "τακτικός", according to the following morphological descriptions: "ADJ;NOM(PL;NEUT)"	ικός" (ικός) (ικός
Generate the inflected form for the lemma: "τακτικός", according to the following morphological descriptions: "ADJ;NOM(SG;NEUT)"	ικός" and "ικός".
Gene
Generate the inflected form for the lemma: "τακτικός", according to the following morphological descriptions: "ADJ;VOC(DU;FEM)"	ικός" and "αναγνωσ
Generate the inflected form for the lemma: "τακτικός", according to the following morphological descriptions: "ADJ;VOC(DU;MASC)"	ικός" and "αναλογι
Generate the inflected form for the lemma: "τακτικός", according to the following morphological descriptions: "ADJ;VOC(DU;NEUT)"	ικός" (εκτός από 
Generate the inflected form for the lemma: "τακτικός", according to the following morphological descriptions: "ADJ;VOC(PL;FEM)"	κτικός" Generate the inf
Generate the inflected form for the lemma: "τακτικός", according to the following morphological descriptions: "ADJ;VOC(PL;MASC)"	ικός" and "ικός".
Gene
Generate the inflected form for the lemma: "τακτικός", according to the following morphological descriptions: "ADJ;VOC(PL;NEUT)"	ικός" (ικός) and "ικ
Generate the inflected form for the lemma: "τακτικός", according to the following morphological descriptions: "ADJ;VOC(SG;FEM)"	ος" (από το εισαγ
Generate the inflected form for the lemma: "τακτικός", according to the following morphological descriptions: "ADJ;VOC(SG;MASC)"	κτικός" Generate the inf
Generate the inflected form for the lemma: "τακτικός", according to the following morphological descriptions: "ADJ;VOC(SG;NEUT)"	ικός" and "ικός".
Gene
Generate the inflected form for the lemma: "ταπεινός", according to the following morphological descriptions: "ADJ;ACC(DU;FEM)"	ος" (ος είναι ο ορ
Generate the inflected form for the lemma: "ταπεινός", according to the following morphological descriptions: "ADJ;ACC(DU;MASC)"	ος" (ος είναι ο ορ
Generate the inflected form for the lemma: "ταπεινός", according to the following morphological descriptions: "ADJ;ACC(PL;MASC)"	ος" (ος είναι ο ορ
Generate the inflected form for the lemma: "ταπεινός", according to the following morphological descriptions: "ADJ;ACC(PL;NEUT)"	ος" (ος είναι ο ορ
Generate the inflected form for the lemma: "ταπεινός", according to the following morphological descriptions: "ADJ;ACC(SG;MASC)"	ος" (ος είναι ο ορ
Generate the inflected form for the lemma: "ταπεινός", according to the following morphological descriptions: "ADJ;DAT(DU;FEM)"	ος" (ος είναι ο ος
Generate the inflected form for the lemma: "ταπεινός", according to the following morphological descriptions: "ADJ;DAT(DU;NEUT)"	ος", according to the follow
Generate the inflected form for the lemma: "ταπεινός", according to the following morphological descriptions: "ADJ;DAT(PL;FEM)"	ος" (ος είναι ο ος
Generate the inflected form for the lemma: "ταπεινός", according to the following morphological descriptions: "ADJ;DAT(PL;MASC)"	απεινός" (απεινό
Generate the inflected form for the lemma: "ταπεινός", according to the following morphological descriptions: "ADJ;DAT(SG;MASC)"	ος" (ταπεινός) (τα
Generate the inflected form for the lemma: "ταπεινός", according to the following morphological descriptions: "ADJ;DAT(SG;NEUT)"	ος" (ταπεινός) (τα
Generate the inflected form for the lemma: "ταπεινός", according to the following morphological descriptions: "ADJ;GEN(DU;FEM)"	απεινός" (απεινό
Generate the inflected form for the lemma: "ταπεινός", according to the following morphological descriptions: "ADJ;GEN(DU;MASC)"	ος" (αποστολή) Gener
Generate the inflected form for the lemma: "ταπεινός", according to the following morphological descriptions: "ADJ;GEN(PL;FEM)"	ος" (ος είναι ο ος
Generate the inflected form for the lemma: "ταπεινός", according to the following morphological descriptions: "ADJ;GEN(SG;MASC)"	ος" (ταπεινός) (τα
Generate the inflected form for the lemma: "ταπεινός", according to the following morphological descriptions: "ADJ;GEN(SG;NEUT)"	ος" (ος είναι ο ος
Generate the inflected form for the lemma: "ταπεινός", according to the following morphological descriptions: "ADJ;NOM(DU;FEM)"	ος" (ος είναι ο ορ
Generate the inflected form for the lemma: "ταπεινός", according to the following morphological descriptions: "ADJ;NOM(DU;MASC)"	απεινός" (απεινό
Generate the inflected form for the lemma: "ταπεινός", according to the following morphological descriptions: "ADJ;NOM(DU;NEUT)"	απεινός" ή "ταπει
Generate the inflected form for the lemma: "ταπεινός", according to the following morphological descriptions: "ADJ;NOM(PL;FEM)"	απεινός" (απεινό
Generate the inflected form for the lemma: "ταπεινός", according to the following morphological descriptions: "ADJ;NOM(PL;MASC)"	απεινός" (απεινό
Generate the inflected form for the lemma: "ταπεινός", according to the following morphological descriptions: "ADJ;NOM(PL;NEUT)"	απεινός" (απεινό
Generate the inflected form for the lemma: "ταπεινός", according to the following morphological descriptions: "ADJ;NOM(SG;FEM)"	ος" (ος είναι ο ος
Generate the inflected form for the lemma: "ταπεινός", according to the following morphological descriptions: "ADJ;NOM(SG;MASC)"	απεινός" (απεινό
Generate the inflected form for the lemma: "ταπεινός", according to the following morphological descriptions: "ADJ;NOM(SG;NEUT)"	απεινός" (απεινό
Generate the inflected form for the lemma: "ταπεινός", according to the following morphological descriptions: "ADJ;VOC(DU;FEM)"	απεινός" (απεινό
Generate the inflected form for the lemma: "ταπεινός", according to the following morphological descriptions: "ADJ;VOC(DU;NEUT)"	ινός" and "ταπεινό
Generate the inflected form for the lemma: "ταπεινός", according to the following morphological descriptions: "ADJ;VOC(PL;FEM)"	ος" (ταπεινός) (τα
Generate the inflected form for the lemma: "ταπεινός", according to the following morphological descriptions: "ADJ;VOC(PL;MASC)"	απεινός" (απεινό
Generate the inflected form for the lemma: "ταπεινός", according to the following morphological descriptions: "ADJ;VOC(PL;NEUT)"	απεινός" (απεινό
Generate the inflected form for the lemma: "ταπεινός", according to the following morphological descriptions: "ADJ;VOC(SG;FEM)"	απεινός" in the followi
Generate the inflected form for the lemma: "ταπεινός", according to the following morphological descriptions: "ADJ;VOC(SG;MASC)"	ος" (ταπεινός) (τα
Generate the inflected form for the lemma: "ταπεινός", according to the following morphological descriptions: "ADJ;VOC(SG;NEUT)"	ος" (ταπεινός) (τα
Generate the inflected form for the lemma: "ἀμέλεια", according to the following morphological descriptions: "N;ACC(DU)"	α α α α α α α α α α 
Generate the inflected form for the lemma: "ἀμέλεια", according to the following morphological descriptions: "N;ACC(PL)"	αμέλεια ἀμέλεια
Generate the inflected form for the lemma: "ἀμέλεια", according to the following morphological descriptions: "N;ACC(SG)"	αμέλεια ἀμέλεια
Generate the inflected form for the lemma: "ἀμέλεια", according to the following morphological descriptions: "N;DAT(DU)"	οικονομική βάση 
Generate the inflected form for the lemma: "ἀμέλεια", according to the following morphological descriptions: "N;DAT(PL)"	αμέλεια ἀμέλεια
Generate the inflected form for the lemma: "ἀμέλεια", according to the following morphological descriptions: "N;DAT(SG)"	αμέλεια ἀμέλεια
Generate the inflected form for the lemma: "ἀμέλεια", according to the following morphological descriptions: "N;GEN(DU)"	 ἀμέλεια ἀμέλει
Generate the inflected form for the lemma: "ἀμέλεια", according to the following morphological descriptions: "N;GEN(PL)"	αμέλεια
Generate the in
Generate the inflected form for the lemma: "ἀμέλεια", according to the following morphological descriptions: "N;GEN(SG)"	αμέλεια" and the follow
Generate the inflected form for the lemma: "ἀμέλεια", according to the following morphological descriptions: "N;NOM(DU)"	αμέλεια
Generate the in
Generate the inflected form for the lemma: "ἀμέλεια", according to the following morphological descriptions: "N;NOM(PL)"	αμέλεια (ἀμέλει
Generate the inflected form for the lemma: "ἀμέλεια", according to the following morphological descriptions: "N;NOM(SG)"	αμέλεια" and "ἀμέλ
Generate the inflected form for the lemma: "ἀμέλεια", according to the following morphological descriptions: "N;VOC(DU)"	αμέλεια" and "αμέλ
Generate the inflected form for the lemma: "ἀμέλεια", according to the following morphological descriptions: "N;VOC(PL)"	αμέλεια" and "αμέλ
Generate the inflected form for the lemma: "ἀμέλεια", according to the following morphological descriptions: "N;VOC(SG)"	αμέλεια" and "ἀμέλ
Generate the inflected form for the lemma: "ἀμβλυωπία", according to the following morphological descriptions: "N;ACC(DU)"	αμβλυωπία
Generate th
Generate the inflected form for the lemma: "ἀμβλυωπία", according to the following morphological descriptions: "N;ACC(PL)"	αμβλυωπία
Generate th
Generate the inflected form for the lemma: "ἀμβλυωπία", according to the following morphological descriptions: "N;ACC(SG)"	αμβλυωπία (ἀμβλ
Generate the inflected form for the lemma: "ἀμβλυωπία", according to the following morphological descriptions: "N;DAT(DU)"	αμβλυωπία
Generate th
Generate the inflected form for the lemma: "ἀμβλυωπία", according to the following morphological descriptions: "N;DAT(PL)"	αμβλυωπία
Generate th
Generate the inflected form for the lemma: "ἀμβλυωπία", according to the following morphological descriptions: "N;DAT(SG)"	αμβλυωπία" and "αμ
Generate the inflected form for the lemma: "ἀμβλυωπία", according to the following morphological descriptions: "N;GEN(DU)"	orgia - Αμβλυωπία
Α
Generate the inflected form for the lemma: "ἀμβλυωπία", according to the following morphological descriptions: "N;GEN(PL)"	orgia", according to the follo
Generate the inflected form for the lemma: "ἀμβλυωπία", according to the following morphological descriptions: "N;GEN(SG)"	orgia", according to the follo
Generate the inflected form for the lemma: "ἀμβλυωπία", according to the following morphological descriptions: "N;NOM(DU)"	 ἀμβλυωπία ἀμβλ
Generate the inflected form for the lemma: "ἀμβλυωπία", according to the following morphological descriptions: "N;NOM(PL)"	orgia (ἀμβλυωπία)" (
Generate the inflected form for the lemma: "ἀμβλυωπία", according to the following morphological descriptions: "N;NOM(SG)"	αμβλυωπία" and "ἀμ
Generate the inflected form for the lemma: "ἀμβλυωπία", according to the following morphological descriptions: "N;VOC(DU)"	αμβλυωπία
Generate th
Generate the inflected form for the lemma: "ἀμβλυωπία", according to the following morphological descriptions: "N;VOC(PL)"	αμβλυωπία" and "αμ
Generate the inflected form for the lemma: "ἀμβλυωπία", according to the following morphological descriptions: "N;VOC(SG)"	αμβλυωπία" and "αμ
Generate the inflected form for the lemma: "ἀναστροφή", according to the following morphological descriptions: "N;ACC(DU)"	ουνιουνιουνιουν
Generate the inflected form for the lemma: "ἀναστροφή", according to the following morphological descriptions: "N;ACC(PL)"	ουλουλουλουλουλ
Generate the inflected form for the lemma: "ἀναστροφή", according to the following morphological descriptions: "N;ACC(SG)"	ουνιουνιουνιουν
Generate the inflected form for the lemma: "ἀναστροφή", according to the following morphological descriptions: "N;DAT(DU)"	λλανδική ἀναστρ
Generate the inflected form for the lemma: "ἀναστροφή", according to the following morphological descriptions: "N;DAT(PL)"	οριακή ἀναστροφ
Generate the inflected form for the lemma: "ἀναστροφή", according to the following morphological descriptions: "N;DAT(SG)"	ουνιουνιουνιουν
Generate the inflected form for the lemma: "ἀναστροφή", according to the following morphological descriptions: "N;GEN(DU)"	ουλουλουλουλουλ
Generate the inflected form for the lemma: "ἀναστροφή", according to the following morphological descriptions: "N;GEN(PL)"	ουνιουνιουνιουν
Generate the inflected form for the lemma: "ἀναστροφή", according to the following morphological descriptions: "N;GEN(SG)"	ουλουλουλουλουλ
Generate the inflected form for the lemma: "ἀναστροφή", according to the following morphological descriptions: "N;NOM(DU)"	αναστροφή
Generate th
Generate the inflected form for the lemma: "ἀναστροφή", according to the following morphological descriptions: "N;NOM(PL)"	ομήλιομήλιομήλι
Generate the inflected form for the lemma: "ἀναστροφή", according to the following morphological descriptions: "N;NOM(SG)"	ουλουλουλουλουλ
Generate the inflected form for the lemma: "ἀναστροφή", according to the following morphological descriptions: "N;VOC(DU)"	ουνιουνιουνιουν
Generate the inflected form for the lemma: "ἀναστροφή", according to the following morphological descriptions: "N;VOC(PL)"	ορική αναστροφή

Generate the inflected form for the lemma: "ἀναστροφή", according to the following morphological descriptions: "N;VOC(SG)"	ουνιουνιουνιουν
Generate the inflected form for the lemma: "ἀντιστοιχία", according to the following morphological descriptions: "N;ACC(DU)"	οικονομία ἀντισ
Generate the inflected form for the lemma: "ἀντιστοιχία", according to the following morphological descriptions: "N;ACC(PL)"	οικονομία" and "αν
Generate the inflected form for the lemma: "ἀντιστοιχία", according to the following morphological descriptions: "N;ACC(SG)"	οικονομία" and "αν
Generate the inflected form for the lemma: "ἀντιστοιχία", according to the following morphological descriptions: "N;DAT(DU)"	οικονομική και κ
Generate the inflected form for the lemma: "ἀντιστοιχία", according to the following morphological descriptions: "N;DAT(PL)"	οικονομική αντι
Generate the inflected form for the lemma: "ἀντιστοιχία", according to the following morphological descriptions: "N;DAT(SG)"	οικονομική και κ
Generate the inflected form for the lemma: "ἀντιστοιχία", according to the following morphological descriptions: "N;GEN(DU)"	οικονομική διαδ
Generate the inflected form for the lemma: "ἀντιστοιχία", according to the following morphological descriptions: "N;GEN(PL)"	οικονομική αντι
Generate the inflected form for the lemma: "ἀντιστοιχία", according to the following morphological descriptions: "N;GEN(SG)"	οικονομική διαδ
Generate the inflected form for the lemma: "ἀντιστοιχία", according to the following morphological descriptions: "N;NOM(DU)"	οικονομία και κα
Generate the inflected form for the lemma: "ἀντιστοιχία", according to the following morphological descriptions: "N;NOM(PL)"	οικονομική και κ
Generate the inflected form for the lemma: "ἀντιστοιχία", according to the following morphological descriptions: "N;NOM(SG)"	οικονομία" and "αν
Generate the inflected form for the lemma: "ἀντιστοιχία", according to the following morphological descriptions: "N;VOC(DU)"	οικονομική και κ
Generate the inflected form for the lemma: "ἀντιστοιχία", according to the following morphological descriptions: "N;VOC(PL)"	οικονομική αντι
Generate the inflected form for the lemma: "ἀντιστοιχία", according to the following morphological descriptions: "N;VOC(SG)"	οικονομική και κ
Generate the inflected form for the lemma: "ἀξίνη", according to the following morphological descriptions: "N;ACC(DU)"	η αξίνη
Generate the inf
Generate the inflected form for the lemma: "ἀξίνη", according to the following morphological descriptions: "N;ACC(PL)"	ini (ἀξίνη) - ἀξίν
Generate the inflected form for the lemma: "ἀξίνη", according to the following morphological descriptions: "N;ACC(SG)"	ini (ἀξίνη) - ἀξίν
Generate the inflected form for the lemma: "ἀξίνη", according to the following morphological descriptions: "N;DAT(DU)"	η αξίνη
Generate the inf
Generate the inflected form for the lemma: "ἀξίνη", according to the following morphological descriptions: "N;DAT(PL)"	η αξίνη
Generate the inf
Generate the inflected form for the lemma: "ἀξίνη", according to the following morphological descriptions: "N;DAT(SG)"	inisis (ἀξίνη) - ἀξί
Generate the inflected form for the lemma: "ἀξίνη", according to the following morphological descriptions: "N;GEN(DU)"	 ἀξίνη ἀξίνη ἀξ
Generate the inflected form for the lemma: "ἀξίνη", according to the following morphological descriptions: "N;GEN(PL)"	inisis (ἀξίνη) - ἀξί
Generate the inflected form for the lemma: "ἀξίνη", according to the following morphological descriptions: "N;GEN(SG)"	 ἀξίνη ἀξίνη ἀξ
Generate the inflected form for the lemma: "ἀξίνη", according to the following morphological descriptions: "N;NOM(DU)"	η η η η η η η η η η 
Generate the inflected form for the lemma: "ἀξίνη", according to the following morphological descriptions: "N;NOM(PL)"	inisis (1992) (1992) (1992) (1
Generate the inflected form for the lemma: "ἀξίνη", according to the following morphological descriptions: "N;NOM(SG)"	ini (SG)) (SG) (SG) (SG) (SG) 
Generate the inflected form for the lemma: "ἀξίνη", according to the following morphological descriptions: "N;VOC(DU)"	inisis (ἀξίνη) - ἀξί
Generate the inflected form for the lemma: "ἀξίνη", according to the following morphological descriptions: "N;VOC(PL)"	inisis (1992) - ἀξίνη (1
Generate the inflected form for the lemma: "ἀξίνη", according to the following morphological descriptions: "N;VOC(SG)"	ini (SG)) (ἀξίνη) (ἀξ
Generate the inflected form for the lemma: "ἀρχισυνάγωγος", according to the following morphological descriptions: "N;ACC(DU)"	ος και καθένας μ
Generate the inflected form for the lemma: "ἀρχισυνάγωγος", according to the following morphological descriptions: "N;ACC(PL)"	ος ος ος ος ος ος 
Generate the inflected form for the lemma: "ἀρχισυνάγωγος", according to the following morphological descriptions: "N;ACC(SG)"	ος και καθένας α
Generate the inflected form for the lemma: "ἀρχισυνάγωγος", according to the following morphological descriptions: "N;DAT(DU)"	ος και καθένας α
Generate the inflected form for the lemma: "ἀρχισυνάγωγος", according to the following morphological descriptions: "N;DAT(PL)"	ος και ος και ος 
Generate the inflected form for the lemma: "ἀρχισυνάγωγος", according to the following morphological descriptions: "N;DAT(SG)"	ος και ἀρχισυνά
Generate the inflected form for the lemma: "ἀρχισυνάγωγος", according to the following morphological descriptions: "N;GEN(DU)"	ος και καθενός κ
Generate the inflected form for the lemma: "ἀρχισυνάγωγος", according to the following morphological descriptions: "N;GEN(PL)"	ονομασία της κατ
Generate the inflected form for the lemma: "ἀρχισυνάγωγος", according to the following morphological descriptions: "N;GEN(SG)"	ος και καθενός".
G
Generate the inflected form for the lemma: "ἀρχισυνάγωγος", according to the following morphological descriptions: "N;NOM(DU)"	ομιλία και καταγ
Generate the inflected form for the lemma: "ἀρχισυνάγωγος", according to the following morphological descriptions: "N;NOM(PL)"	ομοίως" ("ομοίως")
Generate the inflected form for the lemma: "ἀρχισυνάγωγος", according to the following morphological descriptions: "N;NOM(SG)"	ομομομομομομομο
Generate the inflected form for the lemma: "ἀρχισυνάγωγος", according to the following morphological descriptions: "N;VOC(DU)"	ος και καθένας μ
Generate the inflected form for the lemma: "ἀρχισυνάγωγος", according to the following morphological descriptions: "N;VOC(PL)"	ισυνάγωγος" (VOC(PL)
Generate the inflected form for the lemma: "ἀρχισυνάγωγος", according to the following morphological descriptions: "N;VOC(SG)"	ος και καθορίζου
Generate the inflected form for the lemma: "ἄφωνος", according to the following morphological descriptions: "ADJ;ACC(PL;FEM)"	ος" (ἄφωνος) (ἄφω
Generate the inflected form for the lemma: "ἄφωνος", according to the following morphological descriptions: "ADJ;ACC(PL;MASC)"	ος" (ἄφωνος) (ἄφω
Generate the inflected form for the lemma: "ἄφωνος", according to the following morphological descriptions: "ADJ;ACC(PL;NEUT)"	ος" (ἄφωνος) (ἄφω
Generate the inflected form for the lemma: "ἄφωνος", according to the following morphological descriptions: "ADJ;ACC(SG;FEM)"	ος" and "ἄφωνος". The
Generate the inflected form for the lemma: "ἄφωνος", according to the following morphological descriptions: "ADJ;ACC(SG;NEUT)"	ος" (ἄφωνος) (ἄφω
Generate the inflected form for the lemma: "ἄφωνος", according to the following morphological descriptions: "ADJ;DAT(DU;FEM)"	ος" (ἄφωνος) (ἄφω
Generate the inflected form for the lemma: "ἄφωνος", according to the following morphological descriptions: "ADJ;DAT(DU;MASC)"	ος" (ἄφωνος) (ἄφω
Generate the inflected form for the lemma: "ἄφωνος", according to the following morphological descriptions: "ADJ;DAT(DU;NEUT)"	ος" (ἄφωνος) (ἄφω
Generate the inflected form for the lemma: "ἄφωνος", according to the following morphological descriptions: "ADJ;DAT(PL;FEM)"	ος" and "ἄφωνος". The
Generate the inflected form for the lemma: "ἄφωνος", according to the following morphological descriptions: "ADJ;DAT(PL;MASC)"	ος" (ἄφωνος) (ἄφω
Generate the inflected form for the lemma: "ἄφωνος", according to the following morphological descriptions: "ADJ;DAT(PL;NEUT)"	ος" (ἄφωνος) (ἄφω
Generate the inflected form for the lemma: "ἄφωνος", according to the following morphological descriptions: "ADJ;DAT(SG;FEM)"	ος" and "ἄφωνος". The
Generate the inflected form for the lemma: "ἄφωνος", according to the following morphological descriptions: "ADJ;DAT(SG;MASC)"	ος" (ἄφωνος) (ἄφω
Generate the inflected form for the lemma: "ἄφωνος", according to the following morphological descriptions: "ADJ;DAT(SG;NEUT)"	ος" (ἄφωνος) (ἄφω
Generate the inflected form for the lemma: "ἄφωνος", according to the following morphological descriptions: "ADJ;GEN(DU;FEM)"	ος" (ἄφωνος) (ἄφω
Generate the inflected form for the lemma: "ἄφωνος", according to the following morphological descriptions: "ADJ;GEN(PL;FEM)"	ος" (ἄφωνος) (ἄφω
Generate the inflected form for the lemma: "ἄφωνος", according to the following morphological descriptions: "ADJ;GEN(PL;MASC)"	ος" (ἄφωνος) (1999)
G
Generate the inflected form for the lemma: "ἄφωνος", according to the following morphological descriptions: "ADJ;GEN(PL;NEUT)"	ος" (ἄφωνος) (ἄφω
Generate the inflected form for the lemma: "ἄφωνος", according to the following morphological descriptions: "ADJ;GEN(SG;FEM)"	ος" and "ἄφωνος". The
Generate the inflected form for the lemma: "ἄφωνος", according to the following morphological descriptions: "ADJ;GEN(SG;MASC)"	ος" and "ἄφωνος". The
Generate the inflected form for the lemma: "ἄφωνος", according to the following morphological descriptions: "ADJ;NOM(DU;MASC)"	ος" (ἄφωνος) (ἄφω
Generate the inflected form for the lemma: "ἄφωνος", according to the following morphological descriptions: "ADJ;NOM(PL;FEM)"	ος" and "ἄφωνος". The
Generate the inflected form for the lemma: "ἄφωνος", according to the following morphological descriptions: "ADJ;NOM(PL;MASC)"	ος" (ἄφωνος) (ἄφω
Generate the inflected form for the lemma: "ἄφωνος", according to the following morphological descriptions: "ADJ;NOM(PL;NEUT)"	ος" (ἄφωνος) (ἄφω
Generate the inflected form for the lemma: "ἄφωνος", according to the following morphological descriptions: "ADJ;NOM(SG;FEM)"	ος" and "ἄφωνος". The
Generate the inflected form for the lemma: "ἄφωνος", according to the following morphological descriptions: "ADJ;NOM(SG;MASC)"	ος" and "ἄφωνος". The
Generate the inflected form for the lemma: "ἄφωνος", according to the following morphological descriptions: "ADJ;VOC(DU;FEM)"	ος" (ἄφωνος) (ἄφω
Generate the inflected form for the lemma: "ἄφωνος", according to the following morphological descriptions: "ADJ;VOC(DU;MASC)"	ος" (ἄφωνος) (ἄφω
Generate the inflected form for the lemma: "ἄφωνος", according to the following morphological descriptions: "ADJ;VOC(DU;NEUT)"	ος" (ἄφωνος) (ἄφω
Generate the inflected form for the lemma: "ἄφωνος", according to the following morphological descriptions: "ADJ;VOC(PL;MASC)"	ος" (ἄφωνος) (ἄφω
Generate the inflected form for the lemma: "ἄφωνος", according to the following morphological descriptions: "ADJ;VOC(PL;NEUT)"	ος" (ἄφωνος) (ἄφω
Generate the inflected form for the lemma: "ἄφωνος", according to the following morphological descriptions: "ADJ;VOC(SG;MASC)"	ος" (ἄφωνος) (ἄφω
Generate the inflected form for the lemma: "ἄφωνος", according to the following morphological descriptions: "ADJ;VOC(SG;NEUT)"	ος" (ἄφωνος) (ἄφω
Generate the inflected form for the lemma: "Ἀβδηρίτης", according to the following morphological descriptions: "N;ACC(DU)"	eriteriteriteriteriteriteriter
Generate the inflected form for the lemma: "Ἀβδηρίτης", according to the following morphological descriptions: "N;ACC(PL)"	eriteriteriteriteriteriteriter
Generate the inflected form for the lemma: "Ἀβδηρίτης", according to the following morphological descriptions: "N;ACC(SG)"	eriteriteriteriteriteriteriter
Generate the inflected form for the lemma: "Ἀβδηρίτης", according to the following morphological descriptions: "N;DAT(DU)"	 Ἀβδηρίτης" (1999) -
Generate the inflected form for the lemma: "Ἀβδηρίτης", according to the following morphological descriptions: "N;DAT(PL)"	eriteriteriteriteriteriteriter
Generate the inflected form for the lemma: "Ἀβδηρίτης", according to the following morphological descriptions: "N;DAT(SG)"	er (Ἀβδηρίτης)" and 
Generate the inflected form for the lemma: "Ἀβδηρίτης", according to the following morphological descriptions: "N;GEN(DU)"	er (Ἀβδηρίτης) Ἀβ
Generate the inflected form for the lemma: "Ἀβδηρίτης", according to the following morphological descriptions: "N;GEN(PL)"	er (1992) (1992) (1992) (1992)
Generate the inflected form for the lemma: "Ἀβδηρίτης", according to the following morphological descriptions: "N;GEN(SG)"	er (Ἀβδηρίτης)" (Ἀ
Generate the inflected form for the lemma: "Ἀβδηρίτης", according to the following morphological descriptions: "N;NOM(DU)"	er (Ἀβδηρίτης) Ἀβ
Generate the inflected form for the lemma: "Ἀβδηρίτης", according to the following morphological descriptions: "N;NOM(PL)"	eriteriteriteriteriteriteriter
Generate the inflected form for the lemma: "Ἀβδηρίτης", according to the following morphological descriptions: "N;NOM(SG)"	er (Ἀβδηρίτης)" (Ἀ
Generate the inflected form for the lemma: "Ἀβδηρίτης", according to the following morphological descriptions: "N;VOC(DU)"	er (Ἀβδηρίτης) Ἀβ
Generate the inflected form for the lemma: "Ἀβδηρίτης", according to the following morphological descriptions: "N;VOC(PL)"	eriteriteriteriteriteriteriter
Generate the inflected form for the lemma: "Ἀβδηρίτης", according to the following morphological descriptions: "N;VOC(SG)"	eriteriteriteriteriteriteriter
Generate the inflected form for the lemma: "Ἀσεάτης", according to the following morphological descriptions: "N;ACC(DU)"	ος οἰ Ἀσεάτης" (
Generate the inflected form for the lemma: "Ἀσεάτης", according to the following morphological descriptions: "N;ACC(PL)"	ος Ἀσεάτης" and "Ἀ
Generate the inflected form for the lemma: "Ἀσεάτης", according to the following morphological descriptions: "N;ACC(SG)"	ος Ἀσεάτης" and "Ἀ
Generate the inflected form for the lemma: "Ἀσεάτης", according to the following morphological descriptions: "N;DAT(DU)"	ος ασεάτης (Ἀσεά
Generate the inflected form for the lemma: "Ἀσεάτης", according to the following morphological descriptions: "N;DAT(PL)"	ος Ἀσεάτης" and "Ἀ
Generate the inflected form for the lemma: "Ἀσεάτης", according to the following morphological descriptions: "N;DAT(SG)"	ος οἰκονομάτων 
Generate the inflected form for the lemma: "Ἀσεάτης", according to the following morphological descriptions: "N;GEN(PL)"	er (1992) (1992) (1992) (1992)
Generate the inflected form for the lemma: "Ἀσεάτης", according to the following morphological descriptions: "N;GEN(SG)"	er Ἀσεάτης" Generate t
Generate the inflected form for the lemma: "Ἀσεάτης", according to the following morphological descriptions: "N;NOM(DU)"	 Ἀσεάτης" (Ἀσεάτ
Generate the inflected form for the lemma: "Ἀσεάτης", according to the following morphological descriptions: "N;NOM(PL)"	eates", according to the follo
Generate the inflected form for the lemma: "Ἀσεάτης", according to the following morphological descriptions: "N;NOM(SG)"	ονομασία και ονο
Generate the inflected form for the lemma: "Ἀσεάτης", according to the following morphological descriptions: "N;VOC(DU)"	 Ἀσεάτης" (Ἀσεάτ
Generate the inflected form for the lemma: "Ἀσεάτης", according to the following morphological descriptions: "N;VOC(PL)"	er (1) (1) (1) (1) (1) (1) (1)
Generate the inflected form for the lemma: "Ἀσεάτης", according to the following morphological descriptions: "N;VOC(SG)"	ος ασεάτης (Ἀσεά
Generate the inflected form for the lemma: "ἐμπρακτικός", according to the following morphological descriptions: "ADJ;ACC(DU;FEM)"	ουλουλουλουλουλ
Generate the inflected form for the lemma: "ἐμπρακτικός", according to the following morphological descriptions: "ADJ;ACC(DU;MASC)"	ουλουλουλουλουλ
Generate the inflected form for the lemma: "ἐμπρακτικός", according to the following morphological descriptions: "ADJ;ACC(DU;NEUT)"	ουλουλουλουλουλ
Generate the inflected form for the lemma: "ἐμπρακτικός", according to the following morphological descriptions: "ADJ;ACC(PL;FEM)"	ουλουλουλουλουλ
Generate the inflected form for the lemma: "ἐμπρακτικός", according to the following morphological descriptions: "ADJ;ACC(PL;MASC)"	ουλουλουλουλουλ
Generate the inflected form for the lemma: "ἐμπρακτικός", according to the following morphological descriptions: "ADJ;ACC(PL;NEUT)"	ουλουλουλουλουλ
Generate the inflected form for the lemma: "ἐμπρακτικός", according to the following morphological descriptions: "ADJ;ACC(SG;FEM)"	ουλουλουλουλουλ
Generate the inflected form for the lemma: "ἐμπρακτικός", according to the following morphological descriptions: "ADJ;ACC(SG;MASC)"	ουλουλουλουλουλ
Generate the inflected form for the lemma: "ἐμπρακτικός", according to the following morphological descriptions: "ADJ;DAT(DU;MASC)"	οριστικός" and "εμ
Generate the inflected form for the lemma: "ἐμπρακτικός", according to the following morphological descriptions: "ADJ;DAT(DU;NEUT)"	ος" (ἐμπρακτικός
Generate the inflected form for the lemma: "ἐμπρακτικός", according to the following morphological descriptions: "ADJ;DAT(SG;FEM)"	οριστικός" and "εμ
Generate the inflected form for the lemma: "ἐμπρακτικός", according to the following morphological descriptions: "ADJ;DAT(SG;MASC)"	ουλουλουλουλουλ
Generate the inflected form for the lemma: "ἐμπρακτικός", according to the following morphological descriptions: "ADJ;DAT(SG;NEUT)"	οριστικός".
Generate 
Generate the inflected form for the lemma: "ἐμπρακτικός", according to the following morphological descriptions: "ADJ;GEN(DU;FEM)"	οριστικός".
Generate 
Generate the inflected form for the lemma: "ἐμπρακτικός", according to the following morphological descriptions: "ADJ;GEN(DU;MASC)"	ουλουλουλουλουλ
Generate the inflected form for the lemma: "ἐμπρακτικός", according to the following morphological descriptions: "ADJ;GEN(DU;NEUT)"	ουλουλουλουλουλ
Generate the inflected form for the lemma: "ἐμπρακτικός", according to the following morphological descriptions: "ADJ;GEN(PL;FEM)"	οριστικός".
Generate 
Generate the inflected form for the lemma: "ἐμπρακτικός", according to the following morphological descriptions: "ADJ;GEN(PL;MASC)"	οριστικός".
Generate 
Generate the inflected form for the lemma: "ἐμπρακτικός", according to the following morphological descriptions: "ADJ;GEN(SG;MASC)"	ουλουλουλουλουλ
Generate the inflected form for the lemma: "ἐμπρακτικός", according to the following morphological descriptions: "ADJ;GEN(SG;NEUT)"	οριστικός".
Generate 
Generate the inflected form for the lemma: "ἐμπρακτικός", according to the following morphological descriptions: "ADJ;NOM(DU;FEM)"	ος" (ἐμπρακτικός
Generate the inflected form for the lemma: "ἐμπρακτικός", according to the following morphological descriptions: "ADJ;NOM(DU;MASC)"	οριστικός" and "εμ
Generate the inflected form for the lemma: "ἐμπρακτικός", according to the following morphological descriptions: "ADJ;NOM(PL;FEM)"	οριστικός" and "εμ
Generate the inflected form for the lemma: "ἐμπρακτικός", according to the following morphological descriptions: "ADJ;NOM(PL;MASC)"	οριστικός" and "εμ
Generate the inflected form for the lemma: "ἐμπρακτικός", according to the following morphological descriptions: "ADJ;NOM(PL;NEUT)"	ος" (ἐμπρακτικός
Generate the inflected form for the lemma: "ἐμπρακτικός", according to the following morphological descriptions: "ADJ;NOM(SG;FEM)"	οριστικός" and "εμ
Generate the inflected form for the lemma: "ἐμπρακτικός", according to the following morphological descriptions: "ADJ;VOC(DU;FEM)"	οριστικός" and "εμ
Generate the inflected form for the lemma: "ἐμπρακτικός", according to the following morphological descriptions: "ADJ;VOC(DU;MASC)"	οριστικός" and "εμ
Generate the inflected form for the lemma: "ἐμπρακτικός", according to the following morphological descriptions: "ADJ;VOC(DU;NEUT)"	οριστικός" and "εμ
Generate the inflected form for the lemma: "ἐμπρακτικός", according to the following morphological descriptions: "ADJ;VOC(PL;MASC)"	οριστικός" and "εμ
Generate the inflected form for the lemma: "ἐμπρακτικός", according to the following morphological descriptions: "ADJ;VOC(PL;NEUT)"	εμπρακτικός" Genera
Generate the inflected form for the lemma: "ἐμπρακτικός", according to the following morphological descriptions: "ADJ;VOC(SG;MASC)"	ουλουλουλουλουλ
Generate the inflected form for the lemma: "ἐμπρακτικός", according to the following morphological descriptions: "ADJ;VOC(SG;NEUT)"	οριστικός" and "εμ
Generate the inflected form for the lemma: "ἐξομολογητικός", according to the following morphological descriptions: "ADJ;ACC(DU;MASC)"	ομολογητικός".
Gen
Generate the inflected form for the lemma: "ἐξομολογητικός", according to the following morphological descriptions: "ADJ;ACC(DU;NEUT)"	ομολογητικός".
Gen
Generate the inflected form for the lemma: "ἐξομολογητικός", according to the following morphological descriptions: "ADJ;ACC(PL;MASC)"	ομολογητικός".
Gen
Generate the inflected form for the lemma: "ἐξομολογητικός", according to the following morphological descriptions: "ADJ;ACC(PL;NEUT)"	ομολογητικός".
Gen
Generate the inflected form for the lemma: "ἐξομολογητικός", according to the following morphological descriptions: "ADJ;ACC(SG;FEM)"	ομολογητικός".
Gen
Generate the inflected form for the lemma: "ἐξομολογητικός", according to the following morphological descriptions: "ADJ;ACC(SG;MASC)"	ομολογητικός".
Gen
Generate the inflected form for the lemma: "ἐξομολογητικός", according to the following morphological descriptions: "ADJ;DAT(DU;MASC)"	ομολογητικός".
Gen
Generate the inflected form for the lemma: "ἐξομολογητικός", according to the following morphological descriptions: "ADJ;DAT(DU;NEUT)"	ομολογητικός".
Gen
Generate the inflected form for the lemma: "ἐξομολογητικός", according to the following morphological descriptions: "ADJ;DAT(PL;FEM)"	ομολογητικός".
Gen
Generate the inflected form for the lemma: "ἐξομολογητικός", according to the following morphological descriptions: "ADJ;DAT(PL;MASC)"	ομολογητικός".
Gen
Generate the inflected form for the lemma: "ἐξομολογητικός", according to the following morphological descriptions: "ADJ;DAT(PL;NEUT)"	ομολογητικός".
Gen
Generate the inflected form for the lemma: "ἐξομολογητικός", according to the following morphological descriptions: "ADJ;DAT(SG;FEM)"	ομολογητικός".
Gen
Generate the inflected form for the lemma: "ἐξομολογητικός", according to the following morphological descriptions: "ADJ;DAT(SG;MASC)"	ομολογητικός".
Gen
Generate the inflected form for the lemma: "ἐξομολογητικός", according to the following morphological descriptions: "ADJ;DAT(SG;NEUT)"	ομολογητικός".
Gen
Generate the inflected form for the lemma: "ἐξομολογητικός", according to the following morphological descriptions: "ADJ;GEN(DU;MASC)"	ομολογητικός".
Gen
Generate the inflected form for the lemma: "ἐξομολογητικός", according to the following morphological descriptions: "ADJ;GEN(DU;NEUT)"	ομολογητικός".
Gen
Generate the inflected form for the lemma: "ἐξομολογητικός", according to the following morphological descriptions: "ADJ;GEN(PL;MASC)"	ομολογητικός".
Gen
Generate the inflected form for the lemma: "ἐξομολογητικός", according to the following morphological descriptions: "ADJ;GEN(PL;NEUT)"	ομολογητικός".
Gen
Generate the inflected form for the lemma: "ἐξομολογητικός", according to the following morphological descriptions: "ADJ;GEN(SG;FEM)"	ομολογητικός".
Gen
Generate the inflected form for the lemma: "ἐξομολογητικός", according to the following morphological descriptions: "ADJ;GEN(SG;MASC)"	ομολογητικός".
Gen
Generate the inflected form for the lemma: "ἐξομολογητικός", according to the following morphological descriptions: "ADJ;NOM(DU;FEM)"	ομολογητικός".
Gen
Generate the inflected form for the lemma: "ἐξομολογητικός", according to the following morphological descriptions: "ADJ;NOM(DU;MASC)"	ομολογητικός" (and
Generate the inflected form for the lemma: "ἐξομολογητικός", according to the following morphological descriptions: "ADJ;NOM(DU;NEUT)"	ομολογητικός".
Gen
Generate the inflected form for the lemma: "ἐξομολογητικός", according to the following morphological descriptions: "ADJ;NOM(PL;FEM)"	ομολογητικός".
Gen
Generate the inflected form for the lemma: "ἐξομολογητικός", according to the following morphological descriptions: "ADJ;NOM(PL;NEUT)"	ομολογητικός".
Gen
Generate the inflected form for the lemma: "ἐξομολογητικός", according to the following morphological descriptions: "ADJ;NOM(SG;NEUT)"	ομολογητικός".
Gen
Generate the inflected form for the lemma: "ἐξομολογητικός", according to the following morphological descriptions: "ADJ;VOC(DU;FEM)"	ομολογητικός" (and
Generate the inflected form for the lemma: "ἐξομολογητικός", according to the following morphological descriptions: "ADJ;VOC(DU;MASC)"	ομολογητικός" (and
Generate the inflected form for the lemma: "ἐξομολογητικός", according to the following morphological descriptions: "ADJ;VOC(PL;FEM)"	ομολογητικός" and 
Generate the inflected form for the lemma: "ἐξομολογητικός", according to the following morphological descriptions: "ADJ;VOC(PL;MASC)"	ομολογητικός" and 
Generate the inflected form for the lemma: "ἐξομολογητικός", according to the following morphological descriptions: "ADJ;VOC(SG;FEM)"	ομολογητικός".
Gen
Generate the inflected form for the lemma: "ἐξομολογητικός", according to the following morphological descriptions: "ADJ;VOC(SG;MASC)"	ομολογητικός".
Gen
Generate the inflected form for the lemma: "ἐξομολογητικός", according to the following morphological descriptions: "ADJ;VOC(SG;NEUT)"	ομολογητικός" and 
Generate the inflected form for the lemma: "Ἑλληνικός", according to the following morphological descriptions: "ADJ;ACC(DU;FEM)"	λληνικός".
Generate th
Generate the inflected form for the lemma: "Ἑλληνικός", according to the following morphological descriptions: "ADJ;ACC(DU;NEUT)"	λληνικός".
Generate th
Generate the inflected form for the lemma: "Ἑλληνικός", according to the following morphological descriptions: "ADJ;ACC(PL;FEM)"	λληνικός".
Generate th
Generate the inflected form for the lemma: "Ἑλληνικός", according to the following morphological descriptions: "ADJ;ACC(PL;MASC)"	λληνικός".
Generate th
Generate the inflected form for the lemma: "Ἑλληνικός", according to the following morphological descriptions: "ADJ;ACC(SG;MASC)"	λληνικός".
Generate th
Generate the inflected form for the lemma: "Ἑλληνικός", according to the following morphological descriptions: "ADJ;ACC(SG;NEUT)"	λληνικός".
Generate th
Generate the inflected form for the lemma: "Ἑλληνικός", according to the following morphological descriptions: "ADJ;DAT(DU;FEM)"	λληνικός".
Generate th
Generate the inflected form for the lemma: "Ἑλληνικός", according to the following morphological descriptions: "ADJ;DAT(DU;MASC)"	λληνικός".
Generate th
Generate the inflected form for the lemma: "Ἑλληνικός", according to the following morphological descriptions: "ADJ;DAT(DU;NEUT)"	λληνικός".
Generate th
Generate the inflected form for the lemma: "Ἑλληνικός", according to the following morphological descriptions: "ADJ;DAT(PL;FEM)"	λληνικός".
"Ἑλλη
Generate the inflected form for the lemma: "Ἑλληνικός", according to the following morphological descriptions: "ADJ;DAT(SG;NEUT)"	λληνικός".
Generate th
Generate the inflected form for the lemma: "Ἑλληνικός", according to the following morphological descriptions: "ADJ;GEN(DU;FEM)"	λληνικός".
Generate th
Generate the inflected form for the lemma: "Ἑλληνικός", according to the following morphological descriptions: "ADJ;GEN(DU;MASC)"	λληνικός".
The followi
Generate the inflected form for the lemma: "Ἑλληνικός", according to the following morphological descriptions: "ADJ;GEN(DU;NEUT)"	λληνικός".
The lemma "
Generate the inflected form for the lemma: "Ἑλληνικός", according to the following morphological descriptions: "ADJ;GEN(PL;FEM)"	λληνικός".
Generate th
Generate the inflected form for the lemma: "Ἑλληνικός", according to the following morphological descriptions: "ADJ;GEN(PL;MASC)"	λληνικός".
The followi
Generate the inflected form for the lemma: "Ἑλληνικός", according to the following morphological descriptions: "ADJ;GEN(PL;NEUT)"	λληνικός".
The followi
Generate the inflected form for the lemma: "Ἑλληνικός", according to the following morphological descriptions: "ADJ;GEN(SG;MASC)"	λληνικός".
The followi
Generate the inflected form for the lemma: "Ἑλληνικός", according to the following morphological descriptions: "ADJ;GEN(SG;NEUT)"	λληνικός".
The lemma "
Generate the inflected form for the lemma: "Ἑλληνικός", according to the following morphological descriptions: "ADJ;NOM(DU;FEM)"	λληνικός".
Generate th
Generate the inflected form for the lemma: "Ἑλληνικός", according to the following morphological descriptions: "ADJ;NOM(DU;MASC)"	λληνικός" (and "Ἑλ
Generate the inflected form for the lemma: "Ἑλληνικός", according to the following morphological descriptions: "ADJ;NOM(DU;NEUT)"	λληνικός" (and "Ἑλ
Generate the inflected form for the lemma: "Ἑλληνικός", according to the following morphological descriptions: "ADJ;NOM(PL;FEM)"	λληνικός" (and "Ἑλ
Generate the inflected form for the lemma: "Ἑλληνικός", according to the following morphological descriptions: "ADJ;NOM(PL;MASC)"	λληνικός".
Generate th
Generate the inflected form for the lemma: "Ἑλληνικός", according to the following morphological descriptions: "ADJ;NOM(PL;NEUT)"	λληνικός" (and "Ἑλ
Generate the inflected form for the lemma: "Ἑλληνικός", according to the following morphological descriptions: "ADJ;NOM(SG;FEM)"	λληνικός".
Generate th
Generate the inflected form for the lemma: "Ἑλληνικός", according to the following morphological descriptions: "ADJ;NOM(SG;MASC)"	λληνικός".
Generate th
Generate the inflected form for the lemma: "Ἑλληνικός", according to the following morphological descriptions: "ADJ;NOM(SG;NEUT)"	λληνικός".
Generate th
Generate the inflected form for the lemma: "Ἑλληνικός", according to the following morphological descriptions: "ADJ;VOC(DU;FEM)"	λληνικός".
Ἑλλην
Generate the inflected form for the lemma: "Ἑλληνικός", according to the following morphological descriptions: "ADJ;VOC(DU;MASC)"	λληνικός" (1).
Generat
Generate the inflected form for the lemma: "Ἑλληνικός", according to the following morphological descriptions: "ADJ;VOC(DU;NEUT)"	λληνικός" (and "Ἑλ
Generate the inflected form for the lemma: "Ἑλληνικός", according to the following morphological descriptions: "ADJ;VOC(PL;NEUT)"	λληνικός" (and "Ἑλ
Generate the inflected form for the lemma: "Ἑλληνικός", according to the following morphological descriptions: "ADJ;VOC(SG;FEM)"	λληνικός".
Generate th
Generate the inflected form for the lemma: "Ἔλυμος", according to the following morphological descriptions: "N;ACC(DU)"	ος ος ος ος ος ος 
Generate the inflected form for the lemma: "Ἔλυμος", according to the following morphological descriptions: "N;ACC(PL)"	ος ος ος ος ος ος 
Generate the inflected form for the lemma: "Ἔλυμος", according to the following morphological descriptions: "N;ACC(SG)"	ος ος ος ος ος ος 
Generate the inflected form for the lemma: "Ἔλυμος", according to the following morphological descriptions: "N;DAT(DU)"	ος ος ος ος ος ος 
Generate the inflected form for the lemma: "Ἔλυμος", according to the following morphological descriptions: "N;DAT(PL)"	ος ος ος ος ος ος 
Generate the inflected form for the lemma: "Ἔλυμος", according to the following morphological descriptions: "N;DAT(SG)"	ος ος ος ος ος ος 
Generate the inflected form for the lemma: "Ἔλυμος", according to the following morphological descriptions: "N;GEN(DU)"	 Ἑλυμος" (GEN(DU)) Gene
Generate the inflected form for the lemma: "Ἔλυμος", according to the following morphological descriptions: "N;GEN(PL)"	ος ος ος ος ος ος 
Generate the inflected form for the lemma: "Ἔλυμος", according to the following morphological descriptions: "N;GEN(SG)"	ος" and "ος".
Generate the
Generate the inflected form for the lemma: "Ἔλυμος", according to the following morphological descriptions: "N;NOM(DU)"	ος ος ος ος ος ος 
Generate the inflected form for the lemma: "Ἔλυμος", according to the following morphological descriptions: "N;NOM(PL)"	ος ος ος ος ος ος 
Generate the inflected form for the lemma: "Ἔλυμος", according to the following morphological descriptions: "N;NOM(SG)"	ος ος ος ος ος ος 
Generate the inflected form for the lemma: "Ἔλυμος", according to the following morphological descriptions: "N;VOC(DU)"	ος ος ος ος ος ος 
Generate the inflected form for the lemma: "Ἔλυμος", according to the following morphological descriptions: "N;VOC(PL)"	ος και ἔλυμος κα
Generate the inflected form for the lemma: "Ἔλυμος", according to the following morphological descriptions: "N;VOC(SG)"	ος ος ος ος ος ος 
Generate the inflected form for the lemma: "ἡστικός", according to the following morphological descriptions: "ADJ;ACC(DU;MASC)"	ος" (ἡστικός) (ἡσ
Generate the inflected form for the lemma: "ἡστικός", according to the following morphological descriptions: "ADJ;ACC(PL;FEM)"	ος" (ἡστικός) (ἡσ
Generate the inflected form for the lemma: "ἡστικός", according to the following morphological descriptions: "ADJ;ACC(PL;NEUT)"	ος" (ἡστικός) (ἡσ
Generate the inflected form for the lemma: "ἡστικός", according to the following morphological descriptions: "ADJ;ACC(SG;FEM)"	ος" (ἡστικός) (ἡσ
Generate the inflected form for the lemma: "ἡστικός", according to the following morphological descriptions: "ADJ;ACC(SG;MASC)"	ος" (ἡστικός) (ἡσ
Generate the inflected form for the lemma: "ἡστικός", according to the following morphological descriptions: "ADJ;ACC(SG;NEUT)"	ος" (ἡστικός) (ἡσ
Generate the inflected form for the lemma: "ἡστικός", according to the following morphological descriptions: "ADJ;DAT(DU;FEM)"	ικός" (ἡστικός) (
Generate the inflected form for the lemma: "ἡστικός", according to the following morphological descriptions: "ADJ;DAT(DU;MASC)"	ικός" and "καθαρός"
Generate the inflected form for the lemma: "ἡστικός", according to the following morphological descriptions: "ADJ;DAT(DU;NEUT)"	ος" (ἡστικός) (ἡσ
Generate the inflected form for the lemma: "ἡστικός", according to the following morphological descriptions: "ADJ;DAT(PL;FEM)"	ικός" and "καλλικό
Generate the inflected form for the lemma: "ἡστικός", according to the following morphological descriptions: "ADJ;DAT(PL;MASC)"	ικός" and "καθαρός"
Generate the inflected form for the lemma: "ἡστικός", according to the following morphological descriptions: "ADJ;DAT(PL;NEUT)"	ος" (ἡστικός) (ἡσ
Generate the inflected form for the lemma: "ἡστικός", according to the following morphological descriptions: "ADJ;DAT(SG;FEM)"	ικός" and "καθαρός"
Generate the inflected form for the lemma: "ἡστικός", according to the following morphological descriptions: "ADJ;DAT(SG;NEUT)"	ικός". The following morph
Generate the inflected form for the lemma: "ἡστικός", according to the following morphological descriptions: "ADJ;GEN(DU;MASC)"	ος" (ἡστικός) (ἡσ
Generate the inflected form for the lemma: "ἡστικός", according to the following morphological descriptions: "ADJ;GEN(DU;NEUT)"	ος", according to the follow
Generate the inflected form for the lemma: "ἡστικός", according to the following morphological descriptions: "ADJ;GEN(PL;FEM)"	ος" (ἡστικός) (ἡσ
Generate the inflected form for the lemma: "ἡστικός", according to the following morphological descriptions: "ADJ;GEN(PL;NEUT)"	ος" (ἡστικός) (ἡσ
Generate the inflected form for the lemma: "ἡστικός", according to the following morphological descriptions: "ADJ;GEN(SG;MASC)"	ος" (ἡστικός) (ἡσ
Generate the inflected form for the lemma: "ἡστικός", according to the following morphological descriptions: "ADJ;NOM(DU;FEM)"	ικός" (ἡστικός) (
Generate the inflected form for the lemma: "ἡστικός", according to the following morphological descriptions: "ADJ;NOM(DU;MASC)"	ος" (ἡστικός) (ἡσ
Generate the inflected form for the lemma: "ἡστικός", according to the following morphological descriptions: "ADJ;NOM(DU;NEUT)"	ος" (ἡστικός) (ἡσ
Generate the inflected form for the lemma: "ἡστικός", according to the following morphological descriptions: "ADJ;NOM(PL;FEM)"	ικός" and "καθαρός"
Generate the inflected form for the lemma: "ἡστικός", according to the following morphological descriptions: "ADJ;NOM(PL;MASC)"	ος" and "ος".
Generate the
Generate the inflected form for the lemma: "ἡστικός", according to the following morphological descriptions: "ADJ;NOM(PL;NEUT)"	ος" (ἡστικός) (ἡσ
Generate the inflected form for the lemma: "ἡστικός", according to the following morphological descriptions: "ADJ;NOM(SG;FEM)"	ικός" and "καθαρός"
Generate the inflected form for the lemma: "ἡστικός", according to the following morphological descriptions: "ADJ;NOM(SG;NEUT)"	ικός" and "καθαρός"
Generate the inflected form for the lemma: "ἡστικός", according to the following morphological descriptions: "ADJ;VOC(DU;MASC)"	ος" (ἡστικός) (ἡσ
Generate the inflected form for the lemma: "ἡστικός", according to the following morphological descriptions: "ADJ;VOC(DU;NEUT)"	ος" (ἡστικός) (ἡσ
Generate the inflected form for the lemma: "ἡστικός", according to the following morphological descriptions: "ADJ;VOC(PL;MASC)"	ος" (ἡστικός) (ἡσ
Generate the inflected form for the lemma: "ἡστικός", according to the following morphological descriptions: "ADJ;VOC(PL;NEUT)"	ος" (ἡστικός) (ἡσ
Generate the inflected form for the lemma: "ἡστικός", according to the following morphological descriptions: "ADJ;VOC(SG;MASC)"	ος" (ἡστικός) (ἡσ
Generate the inflected form for the lemma: "ἡστικός", according to the following morphological descriptions: "ADJ;VOC(SG;NEUT)"	ος" (ἡστικός) (ἡσ
Generate the inflected form for the lemma: "Ἠπειρώτης", according to the following morphological descriptions: "N;ACC(DU)"	ονομαστής" (Ἠπει
Generate the inflected form for the lemma: "Ἠπειρώτης", according to the following morphological descriptions: "N;ACC(PL)"	ος Ἠπειρώτης" and 
Generate the inflected form for the lemma: "Ἠπειρώτης", according to the following morphological descriptions: "N;ACC(SG)"	ος Ἠπειρώτης" (Ἠ
Generate the inflected form for the lemma: "Ἠπειρώτης", according to the following morphological descriptions: "N;DAT(DU)"	ος Παναγιώτης (188
Generate the inflected form for the lemma: "Ἠπειρώτης", according to the following morphological descriptions: "N;DAT(PL)"	ος Πειρώτης" and "Π
Generate the inflected form for the lemma: "Ἠπειρώτης", according to the following morphological descriptions: "N;DAT(SG)"	ος Ἠπειρώτης" (Ἠ
Generate the inflected form for the lemma: "Ἠπειρώτης", according to the following morphological descriptions: "N;GEN(DU)"	erotis", according to the foll
Generate the inflected form for the lemma: "Ἠπειρώτης", according to the following morphological descriptions: "N;GEN(PL)"	erotis", according to the foll
Generate the inflected form for the lemma: "Ἠπειρώτης", according to the following morphological descriptions: "N;GEN(SG)"	erotis", according to the foll
Generate the inflected form for the lemma: "Ἠπειρώτης", according to the following morphological descriptions: "N;NOM(DU)"	ονομαστής" (Ἠπει
Generate the inflected form for the lemma: "Ἠπειρώτης", according to the following morphological descriptions: "N;NOM(PL)"	 Ἠπειρώτης" (1909) G
Generate the inflected form for the lemma: "Ἠπειρώτης", according to the following morphological descriptions: "N;NOM(SG)"	ονομαστής" and "εν
Generate the inflected form for the lemma: "Ἠπειρώτης", according to the following morphological descriptions: "N;VOC(DU)"	ος Πειρώτης (Ἠπε
Generate the inflected form for the lemma: "Ἠπειρώτης", according to the following morphological descriptions: "N;VOC(PL)"	erotis", according to the foll
Generate the inflected form for the lemma: "Ἠπειρώτης", according to the following morphological descriptions: "N;VOC(SG)"	erotis", according to the foll
Generate the inflected form for the lemma: "ὀνοματοποιία", according to the following morphological descriptions: "N;ACC(DU)"	 νοματοποιία
Genera
Generate the inflected form for the lemma: "ὀνοματοποιία", according to the following morphological descriptions: "N;ACC(PL)"	ophoria", according to the fol
Generate the inflected form for the lemma: "ὀνοματοποιία", according to the following morphological descriptions: "N;ACC(SG)"	;ACC(SG)"; and according to th
Generate the inflected form for the lemma: "ὀνοματοποιία", according to the following morphological descriptions: "N;DAT(DU)"	 και καλλιεργεια
Generate the inflected form for the lemma: "ὀνοματοποιία", according to the following morphological descriptions: "N;DAT(PL)"	ophoria", according to the fol
Generate the inflected form for the lemma: "ὀνοματοποιία", according to the following morphological descriptions: "N;DAT(SG)"	ophoria", according to the fol
Generate the inflected form for the lemma: "ὀνοματοποιία", according to the following morphological descriptions: "N;GEN(DU)"	 ἀνοματοποιία ἀ
Generate the inflected form for the lemma: "ὀνοματοποιία", according to the following morphological descriptions: "N;GEN(PL)"	opia", according to the follow
Generate the inflected form for the lemma: "ὀνοματοποιία", according to the following morphological descriptions: "N;GEN(SG)"	opia", according to the follow
Generate the inflected form for the lemma: "ὀνοματοποιία", according to the following morphological descriptions: "N;NOM(DU)"	οματοποιία
Generate 
Generate the inflected form for the lemma: "ὀνοματοποιία", according to the following morphological descriptions: "N;NOM(PL)"	omatopoiia", according to the 
Generate the inflected form for the lemma: "ὀνοματοποιία", according to the following morphological descriptions: "N;NOM(SG)"	 ὀνοματοποιία ὀ
Generate the inflected form for the lemma: "ὀνοματοποιία", according to the following morphological descriptions: "N;VOC(DU)"	 και καλλιεργεια
Generate the inflected form for the lemma: "ὀνοματοποιία", according to the following morphological descriptions: "N;VOC(PL)"	opia", according to the follow
Generate the inflected form for the lemma: "ὀνοματοποιία", according to the following morphological descriptions: "N;VOC(SG)"	optimization of the lemma: "
Generate the inflected form for the lemma: "ὀστοῦν", according to the following morphological descriptions: "N;ACC(DU)"	ῶν ἀπὸ ἀπὸ ἀπ
Generate the inflected form for the lemma: "ὀστοῦν", according to the following morphological descriptions: "N;ACC(PL)"	ῶν ὀστοῦν ὀστο
Generate the inflected form for the lemma: "ὀστοῦν", according to the following morphological descriptions: "N;ACC(SG)"	ῶν ἀπὸ ἀπὸ ἀπ
Generate the inflected form for the lemma: "ὀστοῦν", according to the following morphological descriptions: "N;DAT(DU)"	ὀστοὖν".
Generate the 
Generate the inflected form for the lemma: "ὀστοῦν", according to the following morphological descriptions: "N;DAT(PL)"	ῶν ὀστοῦν ὀστο
Generate the inflected form for the lemma: "ὀστοῦν", according to the following morphological descriptions: "N;DAT(SG)"	ὀστοὖν" and the follow
Generate the inflected form for the lemma: "ὀστοῦν", according to the following morphological descriptions: "N;GEN(DU)"	ῶν ἀπὸ ἀπὸ ἀπ
Generate the inflected form for the lemma: "ὀστοῦν", according to the following morphological descriptions: "N;GEN(PL)"	ῶν ὀστοῦν ὀστο
Generate the inflected form for the lemma: "ὀστοῦν", according to the following morphological descriptions: "N;GEN(SG)"	ῶν ὀστοῦν ὀστο
Generate the inflected form for the lemma: "ὀστοῦν", according to the following morphological descriptions: "N;NOM(DU)"	ῶν ὀστοῦν ὀστο
Generate the inflected form for the lemma: "ὀστοῦν", according to the following morphological descriptions: "N;NOM(PL)"	ῶν ὀστοῦν ὀστο
Generate the inflected form for the lemma: "ὀστοῦν", according to the following morphological descriptions: "N;NOM(SG)"	ῶν ὀστοῦν ὀστο
Generate the inflected form for the lemma: "ὀστοῦν", according to the following morphological descriptions: "N;VOC(DU)"	ῶν ὀστοῦν ὀστο
Generate the inflected form for the lemma: "ὀστοῦν", according to the following morphological descriptions: "N;VOC(PL)"	ῶν ὀστοῦν ὀστο
Generate the inflected form for the lemma: "ὀστοῦν", according to the following morphological descriptions: "N;VOC(SG)"	ῶν ὀστοῦν ὀστο
Generate the inflected form for the lemma: "ὁμόγραφος", according to the following morphological descriptions: "ADJ;ACC(DU;FEM)"	λογισμός και κατ
Generate the inflected form for the lemma: "ὁμόγραφος", according to the following morphological descriptions: "ADJ;ACC(DU;NEUT)"	λογισμός και κατ
Generate the inflected form for the lemma: "ὁμόγραφος", according to the following morphological descriptions: "ADJ;ACC(PL;MASC)"	λογισμός και κατ
Generate the inflected form for the lemma: "ὁμόγραφος", according to the following morphological descriptions: "ADJ;ACC(PL;NEUT)"	λογισμός και κατ
Generate the inflected form for the lemma: "ὁμόγραφος", according to the following morphological descriptions: "ADJ;ACC(SG;MASC)"	λογισμός και κατ
Generate the inflected form for the lemma: "ὁμόγραφος", according to the following morphological descriptions: "ADJ;ACC(SG;NEUT)"	ομόγραφος".
Generate 
Generate the inflected form for the lemma: "ὁμόγραφος", according to the following morphological descriptions: "ADJ;DAT(DU;FEM)"	λογισμός και κατ
Generate the inflected form for the lemma: "ὁμόγραφος", according to the following morphological descriptions: "ADJ;DAT(DU;MASC)"	λογισμός και κατ
Generate the inflected form for the lemma: "ὁμόγραφος", according to the following morphological descriptions: "ADJ;DAT(DU;NEUT)"	λογισμός και δια
Generate the inflected form for the lemma: "ὁμόγραφος", according to the following morphological descriptions: "ADJ;DAT(PL;FEM)"	λογισμός και κατ
Generate the inflected form for the lemma: "ὁμόγραφος", according to the following morphological descriptions: "ADJ;DAT(PL;MASC)"	λογισμός και κατ
Generate the inflected form for the lemma: "ὁμόγραφος", according to the following morphological descriptions: "ADJ;DAT(PL;NEUT)"	λογισμός και κατ
Generate the inflected form for the lemma: "ὁμόγραφος", according to the following morphological descriptions: "ADJ;DAT(SG;FEM)"	λογισμός και κατ
Generate the inflected form for the lemma: "ὁμόγραφος", according to the following morphological descriptions: "ADJ;DAT(SG;MASC)"	λογισμός της γρα
Generate the inflected form for the lemma: "ὁμόγραφος", according to the following morphological descriptions: "ADJ;GEN(DU;MASC)"	λογισμός και κατ
Generate the inflected form for the lemma: "ὁμόγραφος", according to the following morphological descriptions: "ADJ;GEN(DU;NEUT)"	λογισμός της κατ
Generate the inflected form for the lemma: "ὁμόγραφος", according to the following morphological descriptions: "ADJ;GEN(PL;FEM)"	λογισμός και κατ
Generate the inflected form for the lemma: "ὁμόγραφος", according to the following morphological descriptions: "ADJ;GEN(PL;NEUT)"	λογισμός της κατ
Generate the inflected form for the lemma: "ὁμόγραφος", according to the following morphological descriptions: "ADJ;GEN(SG;FEM)"	λογισμός της κατ
Generate the inflected form for the lemma: "ὁμόγραφος", according to the following morphological descriptions: "ADJ;GEN(SG;NEUT)"	ομόγραφος".
Generate 
Generate the inflected form for the lemma: "ὁμόγραφος", according to the following morphological descriptions: "ADJ;NOM(DU;FEM)"	λογισμός και κατ
Generate the inflected form for the lemma: "ὁμόγραφος", according to the following morphological descriptions: "ADJ;NOM(DU;MASC)"	λογισμός και κατ
Generate the inflected form for the lemma: "ὁμόγραφος", according to the following morphological descriptions: "ADJ;NOM(DU;NEUT)"	λογισμός και δια
Generate the inflected form for the lemma: "ὁμόγραφος", according to the following morphological descriptions: "ADJ;NOM(PL;MASC)"	λογισμός και κατ
Generate the inflected form for the lemma: "ὁμόγραφος", according to the following morphological descriptions: "ADJ;NOM(SG;NEUT)"	λογισμός και κατ
Generate the inflected form for the lemma: "ὁμόγραφος", according to the following morphological descriptions: "ADJ;VOC(DU;FEM)"	λογισμός της κατ
Generate the inflected form for the lemma: "ὁμόγραφος", according to the following morphological descriptions: "ADJ;VOC(DU;MASC)"	λογισμός της γρα
Generate the inflected form for the lemma: "ὁμόγραφος", according to the following morphological descriptions: "ADJ;VOC(DU;NEUT)"	λογισμός και κατ
Generate the inflected form for the lemma: "ὁμόγραφος", according to the following morphological descriptions: "ADJ;VOC(PL;FEM)"	λογισμός της γρα
Generate the inflected form for the lemma: "ὁμόγραφος", according to the following morphological descriptions: "ADJ;VOC(PL;MASC)"	λογισμός της γρα
Generate the inflected form for the lemma: "ὁμόγραφος", according to the following morphological descriptions: "ADJ;VOC(PL;NEUT)"	λογισμός και κατ
Generate the inflected form for the lemma: "ὁμόγραφος", according to the following morphological descriptions: "ADJ;VOC(SG;FEM)"	λογισμός του δια
Generate the inflected form for the lemma: "ὁμόγραφος", according to the following morphological descriptions: "ADJ;VOC(SG;MASC)"	λογισμός του δια
Generate the inflected form for the lemma: "ὅμιλος", according to the following morphological descriptions: "N;ACC(DU)"	ομιλος" and "ομίλο
Generate the inflected form for the lemma: "ὅμιλος", according to the following morphological descriptions: "N;ACC(PL)"	ομιλος" and "ὅμιλο
Generate the inflected form for the lemma: "ὅμιλος", according to the following morphological descriptions: "N;ACC(SG)"	ομιλος" and "ὅμιλο
Generate the inflected form for the lemma: "ὅμιλος", according to the following morphological descriptions: "N;DAT(DU)"	ομιλος" and "ομιλο
Generate the inflected form for the lemma: "ὅμιλος", according to the following morphological descriptions: "N;DAT(PL)"	ομιλος" and "ὅμιλο
Generate the inflected form for the lemma: "ὅμιλος", according to the following morphological descriptions: "N;DAT(SG)"	ομιλος" and "ὅμιλο
Generate the inflected form for the lemma: "ὅμιλος", according to the following morphological descriptions: "N;GEN(DU)"	ομιλος" and "ὅμιλο
Generate the inflected form for the lemma: "ὅμιλος", according to the following morphological descriptions: "N;GEN(PL)"	ομιλος" and "ὅμιλο
Generate the inflected form for the lemma: "ὅμιλος", according to the following morphological descriptions: "N;GEN(SG)"	ομιλος" and "ὅμιλο
Generate the inflected form for the lemma: "ὅμιλος", according to the following morphological descriptions: "N;NOM(DU)"	ομιλος" and "ομιλο
Generate the inflected form for the lemma: "ὅμιλος", according to the following morphological descriptions: "N;NOM(PL)"	omilos", according to the foll
Generate the inflected form for the lemma: "ὅμιλος", according to the following morphological descriptions: "N;NOM(SG)"	ομιλος" and "ομιλο
Generate the inflected form for the lemma: "ὅμιλος", according to the following morphological descriptions: "N;VOC(DU)"	ομιλος" and "ομιλο
Generate the inflected form for the lemma: "ὅμιλος", according to the following morphological descriptions: "N;VOC(PL)"	ομιλος" and "ομιλο
Generate the inflected form for the lemma: "ὅμιλος", according to the following morphological descriptions: "N;VOC(SG)"	ομιλος" and "ὅμιλο
Generate the inflected form for the lemma: "ῥάδιξ", according to the following morphological descriptions: "N;ACC(DU)"	οικοικοικοικοικ
Generate the inflected form for the lemma: "ῥάδιξ", according to the following morphological descriptions: "N;ACC(PL)"	οικοικοικοικοικ
Generate the inflected form for the lemma: "ῥάδιξ", according to the following morphological descriptions: "N;ACC(SG)"	οικοικοικοικοικ
Generate the inflected form for the lemma: "ῥάδιξ", according to the following morphological descriptions: "N;DAT(DU)"	οιοιοιοιοιοιοιο
Generate the inflected form for the lemma: "ῥάδιξ", according to the following morphological descriptions: "N;DAT(PL)"	οάδιξ" and "οάδιξ".

Generate the inflected form for the lemma: "ῥάδιξ", according to the following morphological descriptions: "N;DAT(SG)"	οιοιοιοιοιοιοιο
Generate the inflected form for the lemma: "ῥάδιξ", according to the following morphological descriptions: "N;GEN(DU)"	αδιξ" and "ῥάδιξ".
G
Generate the inflected form for the lemma: "ῥάδιξ", according to the following morphological descriptions: "N;GEN(PL)"	αδιξ" and "αδιξ".
Gene
Generate the inflected form for the lemma: "ῥάδιξ", according to the following morphological descriptions: "N;GEN(SG)"	οάδιξ" and "ῥάδιξ".
Generate the inflected form for the lemma: "ῥάδιξ", according to the following morphological descriptions: "N;NOM(DU)"	οιοιοιοιοιοιοιο
Generate the inflected form for the lemma: "ῥάδιξ", according to the following morphological descriptions: "N;NOM(PL)"	οιοιοιοιοιοιοιο
Generate the inflected form for the lemma: "ῥάδιξ", according to the following morphological descriptions: "N;NOM(SG)"	οιοιοιοιοιοιοιο
Generate the inflected form for the lemma: "ῥάδιξ", according to the following morphological descriptions: "N;VOC(DU)"	ονομάδιξ" and "ῥάδ
Generate the inflected form for the lemma: "ῥάδιξ", according to the following morphological descriptions: "N;VOC(PL)"	οικοικοικοικοικ
Generate the inflected form for the lemma: "ῥάδιξ", according to the following morphological descriptions: "N;VOC(SG)"	οικοικοικοικοικ
Generate the inflected form for the lemma: "ῥητίνη", according to the following morphological descriptions: "N;ACC(DU)"	ητίνη (ῥητίνη) - 
Generate the inflected form for the lemma: "ῥητίνη", according to the following morphological descriptions: "N;ACC(PL)"	ητίνη (ῥητίνη) - 
Generate the inflected form for the lemma: "ῥητίνη", according to the following morphological descriptions: "N;ACC(SG)"	ητίνη" in the Greek langu
Generate the inflected form for the lemma: "ῥητίνη", according to the following morphological descriptions: "N;DAT(DU)"	ητίνη
Generate the inflec
Generate the inflected form for the lemma: "ῥητίνη", according to the following morphological descriptions: "N;DAT(PL)"	ητίνη
Generate the inflec
Generate the inflected form for the lemma: "ῥητίνη", according to the following morphological descriptions: "N;DAT(SG)"	ητίνη" in the Greek langu
Generate the inflected form for the lemma: "ῥητίνη", according to the following morphological descriptions: "N;GEN(DU)"	ητίνη" is a separate form
Generate the inflected form for the lemma: "ῥητίνη", according to the following morphological descriptions: "N;GEN(PL)"	ητίνη" (GEN(PL)) and "η
Generate the inflected form for the lemma: "ῥητίνη", according to the following morphological descriptions: "N;GEN(SG)"	ητίνη" (GEN(SG)) for the 
Generate the inflected form for the lemma: "ῥητίνη", according to the following morphological descriptions: "N;NOM(DU)"	ητίνη" is a Greek languag
Generate the inflected form for the lemma: "ῥητίνη", according to the following morphological descriptions: "N;NOM(PL)"	ητίνη" in the Greek langu
Generate the inflected form for the lemma: "ῥητίνη", according to the following morphological descriptions: "N;NOM(SG)"	ητίνη" in the Greek langu
Generate the inflected form for the lemma: "ῥητίνη", according to the following morphological descriptions: "N;VOC(DU)"	ητίνη" in the Greek langu
Generate the inflected form for the lemma: "ῥητίνη", according to the following morphological descriptions: "N;VOC(PL)"	ητίνη" in the following m
Generate the inflected form for the lemma: "ῥητίνη", according to the following morphological descriptions: "N;VOC(SG)"	ητίνη" is a Greek lemma w
