Generate the inflected form for: აბსტრაქტული ADJ;DAT(PL)	აბსტრაქტულ	აბსტრაქტულებს
Generate the inflected form for: აბსტრაქტული ADJ;DAT(PL;LGSPEC2)	აბსტრაქტულ	აბსტრაქტულთა
Generate the inflected form for: აბსტრაქტული ADJ;DAT(SG)	აბსტრაქტულ	აბსტრაქტულს
Generate the inflected form for: აბსტრაქტული ADJ;ERG(PL)	აბსტრაქტულ	აბსტრაქტულებმა
Generate the inflected form for: აბსტრაქტული ADJ;ERG(PL;LGSPEC2)	აბსტრაქტულ	აბსტრაქტულთა
Generate the inflected form for: აბსტრაქტული ADJ;ERG(SG)	აბსტრაქტულ	აბსტრაქტულმა
Generate the inflected form for: აბსტრაქტული ADJ;FRML(PL)	აბსტრაქტულ	აბსტრაქტულებად
Generate the inflected form for: აბსტრაქტული ADJ;FRML(SG)	აბსტრაქტულ	აბსტრაქტულად
Generate the inflected form for: აბსტრაქტული ADJ;GEN(PL)	აბსტრაქტულ	აბსტრაქტულების
Generate the inflected form for: აბსტრაქტული ADJ;GEN(PL;LGSPEC2)	აბსტრაქტულ	აბსტრაქტულთა
Generate the inflected form for: აბსტრაქტული ADJ;GEN(SG)	აბსტრაქტულ	აბსტრაქტულის
Generate the inflected form for: აბსტრაქტული ADJ;INS(PL)	აბსტრაქტულ	აბსტრაქტულებით
Generate the inflected form for: აბსტრაქტული ADJ;INS(SG)	აბსტრაქტულ	აბსტრაქტულით
Generate the inflected form for: აბსტრაქტული ADJ;NOM(PL)	აბსტრაქტულ	აბსტრაქტულები
Generate the inflected form for: აბსტრაქტული ADJ;NOM(PL;LGSPEC2)	აბსტრაქტულ	აბსტრაქტულნი
Generate the inflected form for: აბსტრაქტული ADJ;NOM(SG)	აბსტრაქტულ	აბსტრაქტული
Generate the inflected form for: აბსტრაქტული ADJ;VOC(PL)	აბსტრაქტულ	აბსტრაქტულებო
Generate the inflected form for: აბსტრაქტული ADJ;VOC(PL;LGSPEC2)	აბსტრაქტულ	აბსტრაქტულნო
Generate the inflected form for: აბსტრაქტული ADJ;VOC(SG)	აბსტრაქტულ	აბსტრაქტულო
Generate the inflected form for: აგენტი N;DAT(PL)	აგენტებს	აგენტებს
Generate the inflected form for: აგენტი N;DAT(PL;LGSPEC2)	აგენტთა	აგენტთა
Generate the inflected form for: აგენტი N;DAT(SG)	აგენტს	აგენტს
Generate the inflected form for: აგენტი N;ERG(PL)	აგენტებმა	აგენტებმა
Generate the inflected form for: აგენტი N;ERG(PL;LGSPEC2)	აგენტთა	აგენტთა
Generate the inflected form for: აგენტი N;ERG(SG)	აგენტმა	აგენტმა
Generate the inflected form for: აგენტი N;FRML(PL)	აგენტებად	აგენტებად
Generate the inflected form for: აგენტი N;FRML(SG)	აგენტად	აგენტად
Generate the inflected form for: აგენტი N;GEN(PL)	აგენტების	აგენტების
Generate the inflected form for: აგენტი N;GEN(PL;LGSPEC2)	აგენტთა	აგენტთა
Generate the inflected form for: აგენტი N;GEN(SG)	აგენტის	აგენტის
Generate the inflected form for: აგენტი N;INS(PL)	აგენტებით	აგენტებით
Generate the inflected form for: აგენტი N;INS(SG)	აგენტით	აგენტით
Generate the inflected form for: აგენტი N;NOM(PL)	აგენტები	აგენტები
Generate the inflected form for: აგენტი N;NOM(PL;LGSPEC2)	აგენტნი	აგენტნი
Generate the inflected form for: აგენტი N;NOM(SG)	აგენტი	აგენტი
Generate the inflected form for: აგენტი N;VOC(PL)	აგენტებო	აგენტებო
Generate the inflected form for: აგენტი N;VOC(PL;LGSPEC2)	აგენტნო	აგენტნო
Generate the inflected form for: აგენტი N;VOC(SG)	აგენტო	აგენტო
Generate the inflected form for: ათეთრებს V;IMP;NOM(2,PL);ACC(1,SG)	გაგათეთროთ	გამათეთრეთ
Generate the inflected form for: ათეთრებს V;IND;FUT;NOM(3,PL);ACC(2,PL)	გაგათეთრებ	გაგათეთრებენ
Generate the inflected form for: ათეთრებს V;IND;IPFV;NOM(2,PL);ACC(1,SG)	გამათეთრებ	მათეთრებდით
Generate the inflected form for: ათეთრებს V;IND;IPFV;NOM(2,SG);ACC(1,PL)	გვათეთრებდ	გვათეთრებდი
Generate the inflected form for: ათეთრებს V;IND;IPFV;NOM(2,SG);ACC(3,PL)	ათეთრებდი	ათეთრებდი
Generate the inflected form for: ათეთრებს V;IND;PRS;NOM(1,PL);ACC(2,SG)	გათეთრებთ	გათეთრებთ
Generate the inflected form for: ათეთრებს V;IND;PRS;NOM(2,SG);ACC(1,SG)	გამათეთრებ	მათეთრებ
Generate the inflected form for: ათეთრებს V;IND;PRS;NOM(3,PL);ACC(1,PL)	გვათეთრებს	გვათეთრებენ
Generate the inflected form for: ათეთრებს V;IND;PRS;NOM(3,PL);ACC(2,PL)	გათეთრებთ	გათეთრებენ
Generate the inflected form for: ათეთრებს V;IND;PRS;NOM(3,PL);ACC(3,SG)	ათეთრებენ	ათეთრებენ
Generate the inflected form for: ათეთრებს V;IND;PRS;NOM(3,SG);ACC(2,PL)	გათეთრებთ	გათეთრებთ
Generate the inflected form for: ათეთრებს V;IND;PST;PFV;NOM(3,SG);ACC(2,SG)	გაგათეთრე	გაგათეთრა
Generate the inflected form for: ათეთრებს V;IND;PST;PRF;NOM(1,PL);ACC(2,SG)	გაგეთეთრებ	გაგვეთეთრებინე
Generate the inflected form for: ათეთრებს V;IND;PST;PRF;NOM(1,PL);ACC(3,SG)	გაგვეთეთრე	გაგვეთეთრებინა
Generate the inflected form for: ათეთრებს V;IND;PST;PRF;NOM(1,SG);ACC(2,SG)	გაგეთეთრებ	გამეთეთრებინე
Generate the inflected form for: ათეთრებს V;IND;PST;PRF;NOM(2,PL);ACC(3,PL)	გაგეთეთრებ	გაგეთეთრებინათ
Generate the inflected form for: ათეთრებს V;IND;PST;PRF;NOM(3,PL);ACC(2,PL)	გაგეთეთრებ	გაეთეთრებინეთ
Generate the inflected form for: ათეთრებს V;IND;PST;PRF;NOM(3,PL);ACC(3,SG)	გაეთეთრები	გაეთეთრებინათ
Generate the inflected form for: ათეთრებს V;OPT;NOM(3,PL);ACC(1,PL)	გაგვათეთრო	გაგვათეთრონ
Generate the inflected form for: ათეთრებს V;OPT;NOM(3,PL);ACC(2,PL)	გაგათეთროთ	გაგათეთროთ
Generate the inflected form for: ათეთრებს V;SBJV;FUT;NOM(2,PL);ACC(1,PL)	გაგვათეთრე	გაგვათეთრებდეთ
Generate the inflected form for: ათეთრებს V;SBJV;FUT;NOM(2,SG);ACC(3,PL)	გაათეთრებდ	გაათეთრებდე
Generate the inflected form for: ათეთრებს V;SBJV;FUT;NOM(3,PL);ACC(2,SG)	გაგათეთრებ	გაგათეთრებდნენ
Generate the inflected form for: ათეთრებს V;SBJV;PRF;NOM(3,PL);ACC(3,PL)	გაეთეთროთ	გაეთეთრებინოთ
Generate the inflected form for: ათეთრებს V;SBJV;PRS;NOM(2,SG);ACC(1,PL)	გვათეთრებდ	გვათეთრებდე
Generate the inflected form for: აკვამარინი N;DAT(PL)	აკვამარინე	აკვამარინებს
Generate the inflected form for: აკვამარინი N;DAT(PL;LGSPEC2)	აკვამარინთ	აკვამარინთა
Generate the inflected form for: აკვამარინი N;DAT(SG)	აკვამარინს	აკვამარინს
Generate the inflected form for: აკვამარინი N;ERG(PL)	აკვამარინე	აკვამარინებმა
Generate the inflected form for: აკვამარინი N;ERG(PL;LGSPEC2)	აკვამარინთ	აკვამარინთა
Generate the inflected form for: აკვამარინი N;ERG(SG)	აკვამარინმ	აკვამარინმა
Generate the inflected form for: აკვამარინი N;FRML(PL)	აკვამარინე	აკვამარინებად
Generate the inflected form for: აკვამარინი N;FRML(SG)	აკვამარინა	აკვამარინად
Generate the inflected form for: აკვამარინი N;GEN(PL)	აკვამარინე	აკვამარინების
Generate the inflected form for: აკვამარინი N;GEN(PL;LGSPEC2)	აკვამარინთ	აკვამარინთა
Generate the inflected form for: აკვამარინი N;GEN(SG)	აკვამარინი	აკვამარინის
Generate the inflected form for: აკვამარინი N;INS(PL)	აკვამარინე	აკვამარინებით
Generate the inflected form for: აკვამარინი N;INS(SG)	აკვამარინი	აკვამარინით
Generate the inflected form for: აკვამარინი N;NOM(PL)	აკვამარინე	აკვამარინები
Generate the inflected form for: აკვამარინი N;NOM(PL;LGSPEC2)	აკვამარინნ	აკვამარინნი
Generate the inflected form for: აკვამარინი N;NOM(SG)	აკვამარინი	აკვამარინი
Generate the inflected form for: აკვამარინი N;VOC(PL)	აკვამარინე	აკვამარინებო
Generate the inflected form for: აკვამარინი N;VOC(PL;LGSPEC2)	აკვამარინნ	აკვამარინნო
Generate the inflected form for: აკვამარინი N;VOC(SG)	აკვამარინო	აკვამარინო
Generate the inflected form for: ართმევს V;COND;NOM(2,PL);ACC(3,PL)	გაართმევდი	მიართმევდით
Generate the inflected form for: ართმევს V;COND;NOM(2,SG);ACC(1,SG)	გამომართმე	მიმართმევდი
Generate the inflected form for: ართმევს V;COND;NOM(3,PL);ACC(3,PL)	გაართმევდნ	მიართმევდნენ
Generate the inflected form for: ართმევს V;IMP;NOM(3,PL);ACC(1,PL)	გაგვართმინ	მიგვართვან
Generate the inflected form for: ართმევს V;IMP;NOM(3,SG);ACC(1,SG)	მომართმინო	მიმართვას
Generate the inflected form for: ართმევს V;IND;FUT;NOM(1,PL);ACC(3,SG)	გაგვართმევ	მივართმევთ
Generate the inflected form for: ართმევს V;IND;FUT;NOM(2,SG);ACC(1,SG)	გამომართმე	მიმართმევ
Generate the inflected form for: ართმევს V;IND;FUT;NOM(3,PL);ACC(3,PL)	გაართმევენ	მიართმევენ
Generate the inflected form for: ართმევს V;IND;FUT;NOM(3,SG);ACC(1,SG)	მომართმევ	მიმართმევს
Generate the inflected form for: ართმევს V;IND;IPFV;NOM(1,PL);ACC(3,SG)	ვართმევდით	ვართმევდით
Generate the inflected form for: ართმევს V;IND;PRF;NOM(1,SG);ACC(2,PL)	გაგერთმინა	მიმირთმევიხართ
Generate the inflected form for: ართმევს V;IND;PRF;NOM(3,PL);ACC(3,PL)	გაერთმინათ	მიურთმევიათ
Generate the inflected form for: ართმევს V;IND;PRF;NOM(3,PL);ACC(3,SG)	გაერთმინათ	მიურთმევიათ
Generate the inflected form for: ართმევს V;IND;PRS;NOM(2,SG);ACC(3,PL)	ართმევ	ართმევ
Generate the inflected form for: ართმევს V;IND;PRS;NOM(3,PL);ACC(3,SG)	ართმევენ	ართმევენ
Generate the inflected form for: ართმევს V;IND;PRS;NOM(3,SG);ACC(1,SG)	მართმევ	მართმევს
Generate the inflected form for: ართმევს V;IND;PST;PFV;NOM(2,PL);ACC(1,SG)	გამოგართმე	მიმართვით
Generate the inflected form for: ართმევს V;IND;PST;PFV;NOM(3,SG);ACC(3,SG)	გაართმე	მიართვა
Generate the inflected form for: ართმევს V;OPT;NOM(2,PL);ACC(3,PL)	გაართმოთ	მიართვათ
Generate the inflected form for: ართმევს V;OPT;NOM(3,PL);ACC(2,PL)	გაგართმონ	მიგართვათ
Generate the inflected form for: ართმევს V;SBJV;PRF;NOM(1,SG);ACC(3,PL)	გამომერთმე	მიმერთვას
Generate the inflected form for: ართმევს V;SBJV;PRF;NOM(2,SG);ACC(3,SG)	გაგერთმევო	მიგერთვას
Generate the inflected form for: ართმევს V;SBJV;PRF;NOM(3,PL);ACC(2,SG)	გადაგერთმე	მიერთვათ
Generate the inflected form for: ართმევს V;SBJV;PRS;NOM(2,PL);ACC(1,PL)	გვართმევდე	გვართმევდეთ
Generate the inflected form for: ართმევს V;SBJV;PRS;NOM(2,SG);ACC(1,PL)	გვართმევდე	გვართმევდე
Generate the inflected form for: ართმევს V;SBJV;PRS;NOM(3,SG);ACC(3,SG)	ართმევდეს	ართმევდეს
Generate the inflected form for: ასისტენტი N;DAT(PL)	ასისტენტებ	ასისტენტებს
Generate the inflected form for: ასისტენტი N;DAT(PL;LGSPEC2)	ასისტენტთა	ასისტენტთა
Generate the inflected form for: ასისტენტი N;DAT(SG)	ასისტენტს	ასისტენტს
Generate the inflected form for: ასისტენტი N;ERG(PL)	ასისტენტებ	ასისტენტებმა
Generate the inflected form for: ასისტენტი N;ERG(PL;LGSPEC2)	ასისტენტთა	ასისტენტთა
Generate the inflected form for: ასისტენტი N;ERG(SG)	ასისტენტმა	ასისტენტმა
Generate the inflected form for: ასისტენტი N;FRML(PL)	ასისტენტებ	ასისტენტებად
Generate the inflected form for: ასისტენტი N;FRML(SG)	ასისტენტად	ასისტენტად
Generate the inflected form for: ასისტენტი N;GEN(PL)	ასისტენტებ	ასისტენტების
Generate the inflected form for: ასისტენტი N;GEN(PL;LGSPEC2)	ასისტენტთა	ასისტენტთა
Generate the inflected form for: ასისტენტი N;GEN(SG)	ასისტენტის	ასისტენტის
Generate the inflected form for: ასისტენტი N;INS(PL)	ასისტენტებ	ასისტენტებით
Generate the inflected form for: ასისტენტი N;INS(SG)	ასისტენტით	ასისტენტით
Generate the inflected form for: ასისტენტი N;NOM(PL)	ასისტენტებ	ასისტენტები
Generate the inflected form for: ასისტენტი N;NOM(PL;LGSPEC2)	ასისტენტნი	ასისტენტნი
Generate the inflected form for: ასისტენტი N;NOM(SG)	ასისტენტი	ასისტენტი
Generate the inflected form for: ასისტენტი N;VOC(PL)	ასისტენტებ	ასისტენტებო
Generate the inflected form for: ასისტენტი N;VOC(PL;LGSPEC2)	ასისტენტნო	ასისტენტნო
Generate the inflected form for: ასისტენტი N;VOC(SG)	ასისტენტო	ასისტენტო
Generate the inflected form for: ატიპური ADJ;DAT(PL)	ატიპურებს	ატიპურებს
Generate the inflected form for: ატიპური ADJ;DAT(PL;LGSPEC2)	ატიპურთა	ატიპურთა
Generate the inflected form for: ატიპური ADJ;DAT(SG)	ატიპურს	ატიპურს
Generate the inflected form for: ატიპური ADJ;ERG(PL)	ატიპურებმა	ატიპურებმა
Generate the inflected form for: ატიპური ADJ;ERG(PL;LGSPEC2)	ატიპურთა	ატიპურთა
Generate the inflected form for: ატიპური ADJ;ERG(SG)	ატიპურმა	ატიპურმა
Generate the inflected form for: ატიპური ADJ;FRML(PL)	ატიპურებად	ატიპურებად
Generate the inflected form for: ატიპური ADJ;FRML(SG)	ატიპურად	ატიპურად
Generate the inflected form for: ატიპური ADJ;GEN(PL)	ატიპურების	ატიპურების
Generate the inflected form for: ატიპური ADJ;GEN(PL;LGSPEC2)	ატიპურთა	ატიპურთა
Generate the inflected form for: ატიპური ADJ;GEN(SG)	ატიპურის	ატიპურის
Generate the inflected form for: ატიპური ADJ;INS(PL)	ატიპურებით	ატიპურებით
Generate the inflected form for: ატიპური ADJ;INS(SG)	ატიპურით	ატიპურით
Generate the inflected form for: ატიპური ADJ;NOM(PL)	ატიპურები	ატიპურები
Generate the inflected form for: ატიპური ADJ;NOM(PL;LGSPEC2)	ატიპურნი	ატიპურნი
Generate the inflected form for: ატიპური ADJ;NOM(SG)	ატიპური	ატიპური
Generate the inflected form for: ატიპური ADJ;VOC(PL)	ატიპურებო	ატიპურებო
Generate the inflected form for: ატიპური ADJ;VOC(PL;LGSPEC2)	ატიპურნო	ატიპურნო
Generate the inflected form for: ატიპური ADJ;VOC(SG)	ატიპურო	ატიპურო
Generate the inflected form for: ბიოლოგი N;DAT(PL)	ბიოლოგებს	ბიოლოგებს
Generate the inflected form for: ბიოლოგი N;DAT(PL;LGSPEC2)	ბიოლოგთა	ბიოლოგთა
Generate the inflected form for: ბიოლოგი N;DAT(SG)	ბიოლოგს	ბიოლოგს
Generate the inflected form for: ბიოლოგი N;ERG(PL)	ბიოლოგებმა	ბიოლოგებმა
Generate the inflected form for: ბიოლოგი N;ERG(PL;LGSPEC2)	ბიოლოგთა	ბიოლოგთა
Generate the inflected form for: ბიოლოგი N;ERG(SG)	ბიოლოგმა	ბიოლოგმა
Generate the inflected form for: ბიოლოგი N;FRML(PL)	ბიოლოგებად	ბიოლოგებად
Generate the inflected form for: ბიოლოგი N;FRML(SG)	ბიოლოგად	ბიოლოგად
Generate the inflected form for: ბიოლოგი N;GEN(PL)	ბიოლოგების	ბიოლოგების
Generate the inflected form for: ბიოლოგი N;GEN(PL;LGSPEC2)	ბიოლოგთა	ბიოლოგთა
Generate the inflected form for: ბიოლოგი N;GEN(SG)	ბიოლოგის	ბიოლოგის
Generate the inflected form for: ბიოლოგი N;INS(PL)	ბიოლოგებით	ბიოლოგებით
Generate the inflected form for: ბიოლოგი N;INS(SG)	ბიოლოგით	ბიოლოგით
Generate the inflected form for: ბიოლოგი N;NOM(PL)	ბიოლოგები	ბიოლოგები
Generate the inflected form for: ბიოლოგი N;NOM(PL;LGSPEC2)	ბიოლოგნი	ბიოლოგნი
Generate the inflected form for: ბიოლოგი N;NOM(SG)	ბიოლოგი	ბიოლოგი
Generate the inflected form for: ბიოლოგი N;VOC(PL)	ბიოლოგებო	ბიოლოგებო
Generate the inflected form for: ბიოლოგი N;VOC(PL;LGSPEC2)	ბიოლოგნო	ბიოლოგნო
Generate the inflected form for: ბიოლოგი N;VOC(SG)	ბიოლოგო	ბიოლოგო
Generate the inflected form for: გარანტი N;DAT(PL)	გარანტებს	გარანტებს
Generate the inflected form for: გარანტი N;DAT(PL;LGSPEC2)	გარანტთა	გარანტთა
Generate the inflected form for: გარანტი N;DAT(SG)	გარანტს	გარანტს
Generate the inflected form for: გარანტი N;ERG(PL)	გარანტებმა	გარანტებმა
Generate the inflected form for: გარანტი N;ERG(PL;LGSPEC2)	გარანტთა	გარანტთა
Generate the inflected form for: გარანტი N;ERG(SG)	გარანტმა	გარანტმა
Generate the inflected form for: გარანტი N;FRML(PL)	გარანტებად	გარანტებად
Generate the inflected form for: გარანტი N;FRML(SG)	გარანტად	გარანტად
Generate the inflected form for: გარანტი N;GEN(PL)	გარანტების	გარანტების
Generate the inflected form for: გარანტი N;GEN(PL;LGSPEC2)	გარანტთა	გარანტთა
Generate the inflected form for: გარანტი N;GEN(SG)	გარანტის	გარანტის
Generate the inflected form for: გარანტი N;INS(PL)	გარანტებით	გარანტებით
Generate the inflected form for: გარანტი N;INS(SG)	გარანტით	გარანტით
Generate the inflected form for: გარანტი N;NOM(PL)	გარანტები	გარანტები
Generate the inflected form for: გარანტი N;NOM(PL;LGSPEC2)	გარანტნი	გარანტნი
Generate the inflected form for: გარანტი N;NOM(SG)	გარანტი	გარანტი
Generate the inflected form for: გარანტი N;VOC(PL)	გარანტებო	გარანტებო
Generate the inflected form for: გარანტი N;VOC(PL;LGSPEC2)	გარანტნო	გარანტნო
Generate the inflected form for: გარანტი N;VOC(SG)	გარანტო	გარანტო
Generate the inflected form for: გუთანი N;DAT(PL)	გუთნებს	გუთნებს
Generate the inflected form for: გუთანი N;DAT(PL;LGSPEC2)	გუთანთა	გუთანთა
Generate the inflected form for: გუთანი N;DAT(SG)	გუთანს	გუთანს
Generate the inflected form for: გუთანი N;ERG(PL)	გუთნებმა	გუთნებმა
Generate the inflected form for: გუთანი N;ERG(PL;LGSPEC2)	გუთანთა	გუთანთა
Generate the inflected form for: გუთანი N;ERG(SG)	გუთანმა	გუთანმა
Generate the inflected form for: გუთანი N;FRML(PL)	გუთნებად	გუთნებად
Generate the inflected form for: გუთანი N;FRML(SG)	გუთანად	გუთნად
Generate the inflected form for: გუთანი N;GEN(PL)	გუთნების	გუთნების
Generate the inflected form for: გუთანი N;GEN(PL;LGSPEC2)	გუთანთა	გუთანთა
Generate the inflected form for: გუთანი N;GEN(SG)	გუთის	გუთნის
Generate the inflected form for: გუთანი N;INS(PL)	გუთნებით	გუთნებით
Generate the inflected form for: გუთანი N;INS(SG)	გუთნით	გუთნით
Generate the inflected form for: გუთანი N;NOM(PL)	გუთნები	გუთნები
Generate the inflected form for: გუთანი N;NOM(PL;LGSPEC2)	გუთანნი	გუთანნი
Generate the inflected form for: გუთანი N;NOM(SG)	გუთნი	გუთანი
Generate the inflected form for: გუთანი N;VOC(PL)	გუთნებო	გუთნებო
Generate the inflected form for: გუთანი N;VOC(PL;LGSPEC2)	გუთანნო	გუთანნო
Generate the inflected form for: გუთანი N;VOC(SG)	გუთანო	გუთანო
Generate the inflected form for: დოლარი N;DAT(PL)	დოლარებს	დოლარებს
Generate the inflected form for: დოლარი N;DAT(PL;LGSPEC2)	დოლართა	დოლართა
Generate the inflected form for: დოლარი N;DAT(SG)	დოლარს	დოლარს
Generate the inflected form for: დოლარი N;ERG(PL)	დოლარებმა	დოლარებმა
Generate the inflected form for: დოლარი N;ERG(PL;LGSPEC2)	დოლართა	დოლართა
Generate the inflected form for: დოლარი N;ERG(SG)	დოლარმა	დოლარმა
Generate the inflected form for: დოლარი N;FRML(PL)	დოლარებად	დოლარებად
Generate the inflected form for: დოლარი N;FRML(SG)	დოლარად	დოლარად
Generate the inflected form for: დოლარი N;GEN(PL)	დოლარების	დოლარების
Generate the inflected form for: დოლარი N;GEN(PL;LGSPEC2)	დოლართა	დოლართა
Generate the inflected form for: დოლარი N;GEN(SG)	დოლარის	დოლარის
Generate the inflected form for: დოლარი N;INS(PL)	დოლარებით	დოლარებით
Generate the inflected form for: დოლარი N;INS(SG)	დოლარით	დოლარით
Generate the inflected form for: დოლარი N;NOM(PL)	დოლარები	დოლარები
Generate the inflected form for: დოლარი N;NOM(PL;LGSPEC2)	დოლარნი	დოლარნი
Generate the inflected form for: დოლარი N;NOM(SG)	დოლარი	დოლარი
Generate the inflected form for: დოლარი N;VOC(PL)	დოლარებო	დოლარებო
Generate the inflected form for: დოლარი N;VOC(PL;LGSPEC2)	დოლარნო	დოლარნო
Generate the inflected form for: დოლარი N;VOC(SG)	დოლარო	დოლარო
Generate the inflected form for: ებონიტი N;DAT(PL)	ებონიტებს	ებონიტებს
Generate the inflected form for: ებონიტი N;DAT(PL;LGSPEC2)	ებონიტთა	ებონიტთა
Generate the inflected form for: ებონიტი N;DAT(SG)	ებონიტს	ებონიტს
Generate the inflected form for: ებონიტი N;ERG(PL)	ებონიტებმა	ებონიტებმა
Generate the inflected form for: ებონიტი N;ERG(PL;LGSPEC2)	ებონიტთა	ებონიტთა
Generate the inflected form for: ებონიტი N;ERG(SG)	ებონიტმა	ებონიტმა
Generate the inflected form for: ებონიტი N;FRML(PL)	ებონიტებად	ებონიტებად
Generate the inflected form for: ებონიტი N;FRML(SG)	ებონიტად	ებონიტად
Generate the inflected form for: ებონიტი N;GEN(PL)	ებონიტების	ებონიტების
Generate the inflected form for: ებონიტი N;GEN(PL;LGSPEC2)	ებონიტთა	ებონიტთა
Generate the inflected form for: ებონიტი N;GEN(SG)	ებონიტის	ებონიტის
Generate the inflected form for: ებონიტი N;INS(PL)	ებონიტებით	ებონიტებით
Generate the inflected form for: ებონიტი N;INS(SG)	ებონიტით	ებონიტით
Generate the inflected form for: ებონიტი N;NOM(PL)	ებონიტები	ებონიტები
Generate the inflected form for: ებონიტი N;NOM(PL;LGSPEC2)	ებონიტნი	ებონიტნი
Generate the inflected form for: ებონიტი N;NOM(SG)	ებონიტი	ებონიტი
Generate the inflected form for: ებონიტი N;VOC(PL)	ებონიტებო	ებონიტებო
Generate the inflected form for: ებონიტი N;VOC(PL;LGSPEC2)	ებონიტნო	ებონიტნო
Generate the inflected form for: ებონიტი N;VOC(SG)	ებონიტო	ებონიტო
Generate the inflected form for: ეზო N;DAT(PL)	ეზოებს	ეზოებს
Generate the inflected form for: ეზო N;DAT(PL;LGSPEC2)	ეზოთა	ეზოთა
Generate the inflected form for: ეზო N;DAT(SG)	ეზოს	ეზოს
Generate the inflected form for: ეზო N;ERG(PL)	ეზოებმა	ეზოებმა
Generate the inflected form for: ეზო N;ERG(PL;LGSPEC2)	ეზოთა	ეზოთა
Generate the inflected form for: ეზო N;ERG(SG)	ეზომ	ეზომ
Generate the inflected form for: ეზო N;FRML(PL)	ეზოებად	ეზოებად
Generate the inflected form for: ეზო N;FRML(SG)	ეზოდ	ეზოდ
Generate the inflected form for: ეზო N;GEN(PL)	ეზოების	ეზოების
Generate the inflected form for: ეზო N;GEN(PL;LGSPEC2)	ეზოთა	ეზოთა
Generate the inflected form for: ეზო N;GEN(SG)	ეზოის	ეზოს
Generate the inflected form for: ეზო N;INS(PL)	ეზოებით	ეზოებით
Generate the inflected form for: ეზო N;INS(SG)	ეზოით	ეზოთი
Generate the inflected form for: ეზო N;NOM(PL)	ეზოები	ეზოები
Generate the inflected form for: ეზო N;NOM(PL;LGSPEC2)	ეზონი	ეზონი
Generate the inflected form for: ეზო N;NOM(SG)	ეზო	ეზო
Generate the inflected form for: ეზო N;VOC(PL)	ეზოებო	ეზოებო
Generate the inflected form for: ეზო N;VOC(PL;LGSPEC2)	ეზონო	ეზონო
Generate the inflected form for: ეზო N;VOC(SG)	ეზოვ	ეზოვ
Generate the inflected form for: ეპიდემიოლოგი N;DAT(PL)	ეპიდემიოლო	ეპიდემიოლოგებს
Generate the inflected form for: ეპიდემიოლოგი N;DAT(PL;LGSPEC2)	ეპიდემიოლო	ეპიდემიოლოგთა
Generate the inflected form for: ეპიდემიოლოგი N;DAT(SG)	ეპიდემიოლო	ეპიდემიოლოგს
Generate the inflected form for: ეპიდემიოლოგი N;ERG(PL)	ეპიდემიოლო	ეპიდემიოლოგებმა
Generate the inflected form for: ეპიდემიოლოგი N;ERG(PL;LGSPEC2)	ეპიდემიოლო	ეპიდემიოლოგთა
Generate the inflected form for: ეპიდემიოლოგი N;ERG(SG)	ეპიდემიოლო	ეპიდემიოლოგმა
Generate the inflected form for: ეპიდემიოლოგი N;FRML(PL)	ეპიდემიოლო	ეპიდემიოლოგებად
Generate the inflected form for: ეპიდემიოლოგი N;FRML(SG)	ეპიდემიოლო	ეპიდემიოლოგად
Generate the inflected form for: ეპიდემიოლოგი N;GEN(PL)	ეპიდემიოლო	ეპიდემიოლოგების
Generate the inflected form for: ეპიდემიოლოგი N;GEN(PL;LGSPEC2)	ეპიდემიოლო	ეპიდემიოლოგთა
Generate the inflected form for: ეპიდემიოლოგი N;GEN(SG)	ეპიდემიოლო	ეპიდემიოლოგის
Generate the inflected form for: ეპიდემიოლოგი N;INS(PL)	ეპიდემიოლო	ეპიდემიოლოგებით
Generate the inflected form for: ეპიდემიოლოგი N;INS(SG)	ეპიდემიოლო	ეპიდემიოლოგით
Generate the inflected form for: ეპიდემიოლოგი N;NOM(PL)	ეპიდემიოლო	ეპიდემიოლოგები
Generate the inflected form for: ეპიდემიოლოგი N;NOM(PL;LGSPEC2)	ეპიდემიოლო	ეპიდემიოლოგნი
Generate the inflected form for: ეპიდემიოლოგი N;NOM(SG)	ეპიდემიოლო	ეპიდემიოლოგი
Generate the inflected form for: ეპიდემიოლოგი N;VOC(PL)	ეპიდემიოლო	ეპიდემიოლოგებო
Generate the inflected form for: ეპიდემიოლოგი N;VOC(PL;LGSPEC2)	ეპიდემიოლო	ეპიდემიოლოგნო
Generate the inflected form for: ეპიდემიოლოგი N;VOC(SG)	ეპიდემიოლო	ეპიდემიოლოგო
Generate the inflected form for: ვაჟი N;DAT(PL)	ვაჟებს	ვაჟებს
Generate the inflected form for: ვაჟი N;DAT(PL;LGSPEC2)	ვაჟთა	ვაჟთა
Generate the inflected form for: ვაჟი N;DAT(SG)	ვაჟს	ვაჟს
Generate the inflected form for: ვაჟი N;ERG(PL)	ვაჟებმა	ვაჟებმა
Generate the inflected form for: ვაჟი N;ERG(PL;LGSPEC2)	ვაჟთა	ვაჟთა
Generate the inflected form for: ვაჟი N;ERG(SG)	ვაჟმა	ვაჟმა
Generate the inflected form for: ვაჟი N;FRML(PL)	ვაჟებად	ვაჟებად
Generate the inflected form for: ვაჟი N;FRML(SG)	ვაჟად	ვაჟად
Generate the inflected form for: ვაჟი N;GEN(PL)	ვაჟების	ვაჟების
Generate the inflected form for: ვაჟი N;GEN(PL;LGSPEC2)	ვაჟთა	ვაჟთა
Generate the inflected form for: ვაჟი N;GEN(SG)	ვაჟის	ვაჟის
Generate the inflected form for: ვაჟი N;INS(PL)	ვაჟებით	ვაჟებით
Generate the inflected form for: ვაჟი N;INS(SG)	ვაჟით	ვაჟით
Generate the inflected form for: ვაჟი N;NOM(PL)	ვაჟები	ვაჟები
Generate the inflected form for: ვაჟი N;NOM(PL;LGSPEC2)	ვაჟნი	ვაჟნი
Generate the inflected form for: ვაჟი N;NOM(SG)	ვაჟი	ვაჟი
Generate the inflected form for: ვაჟი N;VOC(PL)	ვაჟებო	ვაჟებო
Generate the inflected form for: ვაჟი N;VOC(PL;LGSPEC2)	ვაჟნო	ვაჟნო
Generate the inflected form for: ვაჟი N;VOC(SG)	ვაჟო	ვაჟო
Generate the inflected form for: ზამბახიანი ADJ;DAT(PL)	ზამბახიანე	ზამბახებიანებს
Generate the inflected form for: ზამბახიანი ADJ;DAT(PL;LGSPEC2)	ზამბახიანთ	ზამბახებიანთა
Generate the inflected form for: ზამბახიანი ADJ;DAT(SG)	ზამბახიანს	ზამბახებიანს
Generate the inflected form for: ზამბახიანი ADJ;ERG(PL)	ზამბახიანე	ზამბახებიანებმა
Generate the inflected form for: ზამბახიანი ADJ;ERG(PL;LGSPEC2)	ზამბახიანთ	ზამბახებიანთა
Generate the inflected form for: ზამბახიანი ADJ;ERG(SG)	ზამბახიანმ	ზამბახებიანმა
Generate the inflected form for: ზამბახიანი ADJ;FRML(PL)	ზამბახიანე	ზამბახებიანებად
Generate the inflected form for: ზამბახიანი ADJ;FRML(SG)	ზამბახიანა	ზამბახებიანად
Generate the inflected form for: ზამბახიანი ADJ;GEN(PL)	ზამბახიანე	ზამბახებიანების
Generate the inflected form for: ზამბახიანი ADJ;GEN(PL;LGSPEC2)	ზამბახიანთ	ზამბახებიანთა
Generate the inflected form for: ზამბახიანი ADJ;GEN(SG)	ზამბახიანი	ზამბახებიანის
Generate the inflected form for: ზამბახიანი ADJ;INS(PL)	ზამბახიანე	ზამბახებიანებით
Generate the inflected form for: ზამბახიანი ADJ;INS(SG)	ზამბახიანი	ზამბახებიანით
Generate the inflected form for: ზამბახიანი ADJ;NOM(PL)	ზამბახიანე	ზამბახებიანები
Generate the inflected form for: ზამბახიანი ADJ;NOM(PL;LGSPEC2)	ზამბახიანნ	ზამბახებიანნი
Generate the inflected form for: ზამბახიანი ADJ;NOM(SG)	ზამბახიანი	ზამბახებიანი
Generate the inflected form for: ზამბახიანი ADJ;VOC(PL)	ზამბახიანე	ზამბახებიანებო
Generate the inflected form for: ზამბახიანი ADJ;VOC(PL;LGSPEC2)	ზამბახიანნ	ზამბახებიანნო
Generate the inflected form for: ზამბახიანი ADJ;VOC(SG)	ზამბახიანო	ზამბახებიანო
Generate the inflected form for: თარაზო N;DAT(PL)	თარაზოებს	თარაზოებს
Generate the inflected form for: თარაზო N;DAT(PL;LGSPEC2)	თარაზოთა	თარაზოთა
Generate the inflected form for: თარაზო N;DAT(SG)	თარაზოს	თარაზოს
Generate the inflected form for: თარაზო N;ERG(PL)	თარაზოებმა	თარაზოებმა
Generate the inflected form for: თარაზო N;ERG(PL;LGSPEC2)	თარაზოთა	თარაზოთა
Generate the inflected form for: თარაზო N;ERG(SG)	თარაზომ	თარაზომ
Generate the inflected form for: თარაზო N;FRML(PL)	თარაზოებად	თარაზოებად
Generate the inflected form for: თარაზო N;FRML(SG)	თარაზოდ	თარაზოდ
Generate the inflected form for: თარაზო N;GEN(PL)	თარაზოების	თარაზოების
Generate the inflected form for: თარაზო N;GEN(PL;LGSPEC2)	თარაზოთა	თარაზოთა
Generate the inflected form for: თარაზო N;GEN(SG)	თარაზოს	თარაზოს
Generate the inflected form for: თარაზო N;INS(PL)	თარაზოებით	თარაზოებით
Generate the inflected form for: თარაზო N;INS(SG)	თარაზოთი	თარაზოთი
Generate the inflected form for: თარაზო N;NOM(PL)	თარაზოები	თარაზოები
Generate the inflected form for: თარაზო N;NOM(PL;LGSPEC2)	თარაზონი	თარაზონი
Generate the inflected form for: თარაზო N;NOM(SG)	თარაზო	თარაზო
Generate the inflected form for: თარაზო N;VOC(PL)	თარაზოებო	თარაზოებო
Generate the inflected form for: თარაზო N;VOC(PL;LGSPEC2)	თარაზონო	თარაზონო
Generate the inflected form for: თარაზო N;VOC(SG)	თარაზოვ	თარაზოვ
Generate the inflected form for: თეთრდება V;COND;NOM(1,PL)	გავთეთრდებ	გავთეთრდებოდით
Generate the inflected form for: თეთრდება V;COND;NOM(1,SG)	გავთეთრდებ	გავთეთრდებოდი
Generate the inflected form for: თეთრდება V;COND;NOM(2,PL)	გათეთრდებო	გათეთრდებოდით
Generate the inflected form for: თეთრდება V;COND;NOM(3,PL)	გათეთრდებო	გათეთრდებოდნენ
Generate the inflected form for: თეთრდება V;COND;NOM(3,SG)	გათეთრდებო	გათეთრდებოდა
Generate the inflected form for: თეთრდება V;IMP;NOM(1,PL)	გავთეთრეთ	გავთეთრდეთ
Generate the inflected form for: თეთრდება V;IND;FUT;NOM(3,SG)	გათეთრდება	გათეთრდება
Generate the inflected form for: თეთრდება V;IND;IPFV;NOM(1,PL)	ვთეთრდებოდ	ვთეთრდებოდით
Generate the inflected form for: თეთრდება V;IND;IPFV;NOM(3,SG)	თეთრდებოდა	თეთრდებოდა
Generate the inflected form for: თეთრდება V;IND;PRS;NOM(2,PL)	თეთრდებით	თეთრდებით
Generate the inflected form for: თეთრდება V;IND;PRS;NOM(2,SG)	თეთრდები	თეთრდები
Generate the inflected form for: თეთრდება V;IND;PRS;NOM(3,PL)	თეთრდებიან	თეთრდებიან
Generate the inflected form for: თეთრდება V;IND;PRS;NOM(3,SG)	თეთრდება	თეთრდება
Generate the inflected form for: თეთრდება V;IND;PST;PFV;NOM(2,SG)	გათეთრდე	გათეთრდი
Generate the inflected form for: თეთრდება V;IND;PST;PFV;NOM(3,PL)	გათეთრდნენ	გათეთრდნენ
Generate the inflected form for: თეთრდება V;IND;PST;PFV;NOM(3,SG)	გათეთრდა	გათეთრდა
Generate the inflected form for: თეთრდება V;IND;PST;PRF;NOM(2,PL)	გაგეთეთრებ	გათეთრებულიყავით
Generate the inflected form for: თეთრდება V;IND;PST;PRF;NOM(2,SG)	გაგეთეთრებ	გათეთრებულიყავი
Generate the inflected form for: თეთრდება V;OPT;NOM(1,SG)	გავთეთრო	გავთეთრდე
Generate the inflected form for: თეთრდება V;SBJV;FUT;NOM(1,PL)	გავთეთრდებ	გავთეთრდებოდეთ
Generate the inflected form for: თეთრდება V;SBJV;FUT;NOM(2,PL)	გათეთრდებო	გათეთრდებოდეთ
Generate the inflected form for: თეთრდება V;SBJV;FUT;NOM(2,SG)	გათეთრდებო	გათეთრდებოდე
Generate the inflected form for: თეთრდება V;SBJV;FUT;NOM(3,PL)	გათეთრდებო	გათეთრდებოდნენ
Generate the inflected form for: თეთრდება V;SBJV;PRF;NOM(1,SG)	გამეთეთრებ	გავთეთრებულიყო
Generate the inflected form for: თეთრდება V;SBJV;PRS;NOM(1,PL)	ვთეთრდებოდ	ვთეთრდებოდეთ
Generate the inflected form for: თეთრდება V;V.MSDR;PRF	გათეთრებულ	გათეთრა
Generate the inflected form for: ილი N;DAT(PL)	ილებს	ილებს
Generate the inflected form for: ილი N;DAT(PL;LGSPEC2)	ილთა	ილთა
Generate the inflected form for: ილი N;DAT(SG)	ილს	ილს
Generate the inflected form for: ილი N;ERG(PL)	ილებმა	ილებმა
Generate the inflected form for: ილი N;ERG(PL;LGSPEC2)	ილთა	ილთა
Generate the inflected form for: ილი N;ERG(SG)	ილმა	ილმა
Generate the inflected form for: ილი N;FRML(PL)	ილებად	ილებად
Generate the inflected form for: ილი N;FRML(SG)	ილად	ილად
Generate the inflected form for: ილი N;GEN(PL)	ილების	ილების
Generate the inflected form for: ილი N;GEN(PL;LGSPEC2)	ილთა	ილთა
Generate the inflected form for: ილი N;GEN(SG)	ილის	ილის
Generate the inflected form for: ილი N;INS(PL)	ილებით	ილებით
Generate the inflected form for: ილი N;INS(SG)	ილით	ილით
Generate the inflected form for: ილი N;NOM(PL)	ილები	ილები
Generate the inflected form for: ილი N;NOM(PL;LGSPEC2)	ილნი	ილნი
Generate the inflected form for: ილი N;NOM(SG)	ილი	ილი
Generate the inflected form for: ილი N;VOC(PL)	ილებო	ილებო
Generate the inflected form for: ილი N;VOC(PL;LGSPEC2)	ილნო	ილნო
Generate the inflected form for: ილი N;VOC(SG)	ილო	ილო
Generate the inflected form for: იმპერიალისტი N;DAT(PL)	იმპერიალის	იმპერიალისტებს
Generate the inflected form for: იმპერიალისტი N;DAT(PL;LGSPEC2)	იმპერიალის	იმპერიალისტთა
Generate the inflected form for: იმპერიალისტი N;DAT(SG)	იმპერიალის	იმპერიალისტს
Generate the inflected form for: იმპერიალისტი N;ERG(PL)	იმპერიალის	იმპერიალისტებმა
Generate the inflected form for: იმპერიალისტი N;ERG(PL;LGSPEC2)	იმპერიალის	იმპერიალისტთა
Generate the inflected form for: იმპერიალისტი N;ERG(SG)	იმპერიალის	იმპერიალისტმა
Generate the inflected form for: იმპერიალისტი N;FRML(PL)	იმპერიალის	იმპერიალისტებად
Generate the inflected form for: იმპერიალისტი N;FRML(SG)	იმპერიალის	იმპერიალისტად
Generate the inflected form for: იმპერიალისტი N;GEN(PL)	იმპერიალის	იმპერიალისტების
Generate the inflected form for: იმპერიალისტი N;GEN(PL;LGSPEC2)	იმპერიალის	იმპერიალისტთა
Generate the inflected form for: იმპერიალისტი N;GEN(SG)	იმპერიალის	იმპერიალისტის
Generate the inflected form for: იმპერიალისტი N;INS(PL)	იმპერიალის	იმპერიალისტებით
Generate the inflected form for: იმპერიალისტი N;INS(SG)	იმპერიალის	იმპერიალისტით
Generate the inflected form for: იმპერიალისტი N;NOM(PL)	იმპერიალის	იმპერიალისტები
Generate the inflected form for: იმპერიალისტი N;NOM(PL;LGSPEC2)	იმპერიალის	იმპერიალისტნი
Generate the inflected form for: იმპერიალისტი N;NOM(SG)	იმპერიალის	იმპერიალისტი
Generate the inflected form for: იმპერიალისტი N;VOC(PL)	იმპერიალის	იმპერიალისტებო
Generate the inflected form for: იმპერიალისტი N;VOC(PL;LGSPEC2)	იმპერიალის	იმპერიალისტნო
Generate the inflected form for: იმპერიალისტი N;VOC(SG)	იმპერიალის	იმპერიალისტო
Generate the inflected form for: იმპორტი N;DAT(PL)	იმპორტებს	იმპორტებს
Generate the inflected form for: იმპორტი N;DAT(PL;LGSPEC2)	იმპორტთა	იმპორტთა
Generate the inflected form for: იმპორტი N;DAT(SG)	იმპორტს	იმპორტს
Generate the inflected form for: იმპორტი N;ERG(PL)	იმპორტებმა	იმპორტებმა
Generate the inflected form for: იმპორტი N;ERG(PL;LGSPEC2)	იმპორტთა	იმპორტთა
Generate the inflected form for: იმპორტი N;ERG(SG)	იმპორტმა	იმპორტმა
Generate the inflected form for: იმპორტი N;FRML(PL)	იმპორტებად	იმპორტებად
Generate the inflected form for: იმპორტი N;FRML(SG)	იმპორტად	იმპორტად
Generate the inflected form for: იმპორტი N;GEN(PL)	იმპორტების	იმპორტების
Generate the inflected form for: იმპორტი N;GEN(PL;LGSPEC2)	იმპორტთა	იმპორტთა
Generate the inflected form for: იმპორტი N;GEN(SG)	იმპორტის	იმპორტის
Generate the inflected form for: იმპორტი N;INS(PL)	იმპორტებით	იმპორტებით
Generate the inflected form for: იმპორტი N;INS(SG)	იმპორტით	იმპორტით
Generate the inflected form for: იმპორტი N;NOM(PL)	იმპორტები	იმპორტები
Generate the inflected form for: იმპორტი N;NOM(PL;LGSPEC2)	იმპორტნი	იმპორტნი
Generate the inflected form for: იმპორტი N;NOM(SG)	იმპორტი	იმპორტი
Generate the inflected form for: იმპორტი N;VOC(PL)	იმპორტებო	იმპორტებო
Generate the inflected form for: იმპორტი N;VOC(PL;LGSPEC2)	იმპორტნო	იმპორტნო
Generate the inflected form for: იმპორტი N;VOC(SG)	იმპორტო	იმპორტო
Generate the inflected form for: იღება V;COND;NOM(1,PL)	გავიღებოდი	გავიღებოდით
Generate the inflected form for: იღება V;COND;NOM(3,SG)	დაიღებოდა	გაიღებოდა
Generate the inflected form for: იღება V;IMP;NOM(1,PL)	გავიღოთ	გავიღოთ
Generate the inflected form for: იღება V;IMP;NOM(2,PL)	გაიღოთ	გაიღეთ
Generate the inflected form for: იღება V;IND;FUT;NOM(1,SG)	მოვიღები	გავიღები
Generate the inflected form for: იღება V;IND;FUT;NOM(2,SG)	გაიღები	გაიღები
Generate the inflected form for: იღება V;IND;FUT;NOM(3,PL)	დაიღებიან	გაიღებიან
Generate the inflected form for: იღება V;IND;IPFV;NOM(2,PL)	იღებოდით	იღებოდით
Generate the inflected form for: იღება V;IND;PRF;NOM(1,PL)	გავღებულიყ	გავღებულვართ
Generate the inflected form for: იღება V;IND;PRF;NOM(1,SG)	გავღებულიყ	გავღებულვარ
Generate the inflected form for: იღება V;IND;PRF;NOM(2,SG)	გაღებულიყო	გაღებულხარ
Generate the inflected form for: იღება V;IND;PRF;NOM(3,PL)	გაღებულიყო	გაღებულან
Generate the inflected form for: იღება V;IND;PRF;NOM(3,SG)	გაღებულიყო	გაღებულა
Generate the inflected form for: იღება V;IND;PRS;NOM(1,PL)	ვიღებით	ვიღებით
Generate the inflected form for: იღება V;IND;PRS;NOM(1,SG)	ვიღები	ვიღები
Generate the inflected form for: იღება V;IND;PRS;NOM(2,SG)	იღები	იღები
Generate the inflected form for: იღება V;IND;PST;PFV;NOM(1,PL)	გავიღეთ	გავიღეთ
Generate the inflected form for: იღება V;IND;PST;PFV;NOM(2,PL)	გაიღეთ	გაიღეთ
Generate the inflected form for: იღება V;IND;PST;PFV;NOM(3,PL)	დაიღეთ	გაიღნენ
Generate the inflected form for: იღება V;IND;PST;PRF;NOM(1,PL)	გავღებულიყ	გავღებულიყავით
Generate the inflected form for: იღება V;IND;PST;PRF;NOM(3,PL)	გაღებულიყო	გაღებულიყვნენ
Generate the inflected form for: იღება V;OPT;NOM(3,SG)	დაიღოს	გაიღოს
Generate the inflected form for: იღება V;SBJV;PRF;NOM(2,PL)	გაგღებულიყ	გაღებულიყოთ
Generate the inflected form for: იღება V;SBJV;PRF;NOM(2,SG)	გაგღებულიყ	გაღებულიყო
Generate the inflected form for: იღება V;SBJV;PRS;NOM(2,PL)	იღებოდეთ	იღებოდეთ
Generate the inflected form for: იღება V;SBJV;PRS;NOM(3,SG)	იღებოდეს	იღებოდეს
Generate the inflected form for: კანდიდატი N;DAT(PL)	კანდიდატებ	კანდიდატებს
Generate the inflected form for: კანდიდატი N;DAT(PL;LGSPEC2)	კანდიდატთა	კანდიდატთა
Generate the inflected form for: კანდიდატი N;DAT(SG)	კანდიდატს	კანდიდატს
Generate the inflected form for: კანდიდატი N;ERG(PL)	კანდიდატებ	კანდიდატებმა
Generate the inflected form for: კანდიდატი N;ERG(PL;LGSPEC2)	კანდიდატთა	კანდიდატთა
Generate the inflected form for: კანდიდატი N;ERG(SG)	კანდიდატმა	კანდიდატმა
Generate the inflected form for: კანდიდატი N;FRML(PL)	კანდიდატებ	კანდიდატებად
Generate the inflected form for: კანდიდატი N;FRML(SG)	კანდიდატად	კანდიდატად
Generate the inflected form for: კანდიდატი N;GEN(PL)	კანდიდატებ	კანდიდატების
Generate the inflected form for: კანდიდატი N;GEN(PL;LGSPEC2)	კანდიდატთა	კანდიდატთა
Generate the inflected form for: კანდიდატი N;GEN(SG)	კანდიდატის	კანდიდატის
Generate the inflected form for: კანდიდატი N;INS(PL)	კანდიდატებ	კანდიდატებით
Generate the inflected form for: კანდიდატი N;INS(SG)	კანდიდატით	კანდიდატით
Generate the inflected form for: კანდიდატი N;NOM(PL)	კანდიდატებ	კანდიდატები
Generate the inflected form for: კანდიდატი N;NOM(PL;LGSPEC2)	კანდიდატნი	კანდიდატნი
Generate the inflected form for: კანდიდატი N;NOM(SG)	კანდიდატი	კანდიდატი
Generate the inflected form for: კანდიდატი N;VOC(PL)	კანდიდატებ	კანდიდატებო
Generate the inflected form for: კანდიდატი N;VOC(PL;LGSPEC2)	კანდიდატნო	კანდიდატნო
Generate the inflected form for: კანდიდატი N;VOC(SG)	კანდიდატო	კანდიდატო
Generate the inflected form for: კონტური N;DAT(PL)	კონტურებს	კონტურებს
Generate the inflected form for: კონტური N;DAT(PL;LGSPEC2)	კონტურთა	კონტურთა
Generate the inflected form for: კონტური N;DAT(SG)	კონტურს	კონტურს
Generate the inflected form for: კონტური N;ERG(PL)	კონტურებმა	კონტურებმა
Generate the inflected form for: კონტური N;ERG(PL;LGSPEC2)	კონტურთა	კონტურთა
Generate the inflected form for: კონტური N;ERG(SG)	კონტურმა	კონტურმა
Generate the inflected form for: კონტური N;FRML(PL)	კონტურებად	კონტურებად
Generate the inflected form for: კონტური N;FRML(SG)	კონტურად	კონტურად
Generate the inflected form for: კონტური N;GEN(PL)	კონტურების	კონტურების
Generate the inflected form for: კონტური N;GEN(PL;LGSPEC2)	კონტურთა	კონტურთა
Generate the inflected form for: კონტური N;GEN(SG)	კონტურის	კონტურის
Generate the inflected form for: კონტური N;INS(PL)	კონტურებით	კონტურებით
Generate the inflected form for: კონტური N;INS(SG)	კონტურით	კონტურით
Generate the inflected form for: კონტური N;NOM(PL)	კონტურები	კონტურები
Generate the inflected form for: კონტური N;NOM(PL;LGSPEC2)	კონტურნი	კონტურნი
Generate the inflected form for: კონტური N;NOM(SG)	კონტური	კონტური
Generate the inflected form for: კონტური N;VOC(PL)	კონტურებო	კონტურებო
Generate the inflected form for: კონტური N;VOC(PL;LGSPEC2)	კონტურნო	კონტურნო
Generate the inflected form for: კონტური N;VOC(SG)	კონტურო	კონტურო
Generate the inflected form for: კორიდორი N;DAT(PL)	კორიდორებს	კორიდორებს
Generate the inflected form for: კორიდორი N;DAT(PL;LGSPEC2)	კორიდორთა	კორიდორთა
Generate the inflected form for: კორიდორი N;ERG(PL)	კორიდორებმ	კორიდორებმა
Generate the inflected form for: კორიდორი N;ERG(PL;LGSPEC2)	კორიდორთა	კორიდორთა
Generate the inflected form for: კორიდორი N;ERG(SG)	კორიდორმა	კორიდორმა
Generate the inflected form for: კორიდორი N;FRML(SG)	კორიდორად	კორიდორად
Generate the inflected form for: კორიდორი N;GEN(PL)	კორიდორები	კორიდორების
Generate the inflected form for: კორიდორი N;GEN(PL;LGSPEC2)	კორიდორთა	კორიდორთა
Generate the inflected form for: კორიდორი N;GEN(SG)	კორიდორის	კორიდორის
Generate the inflected form for: კორიდორი N;INS(PL)	კორიდორები	კორიდორებით
Generate the inflected form for: კორიდორი N;INS(SG)	კორიდორით	კორიდორით
Generate the inflected form for: კორიდორი N;NOM(PL)	კორიდორები	კორიდორები
Generate the inflected form for: კორიდორი N;NOM(PL;LGSPEC2)	კორიდორნი	კორიდორნი
Generate the inflected form for: კორიდორი N;NOM(SG)	კორიდორი	კორიდორი
Generate the inflected form for: კორიდორი N;VOC(PL)	კორიდორებო	კორიდორებო
Generate the inflected form for: კორიდორი N;VOC(PL;LGSPEC2)	კორიდორნო	კორიდორნო
Generate the inflected form for: კორიდორი N;VOC(SG)	კორიდორო	კორიდორო
Generate the inflected form for: მთისწინეთი N;DAT(PL)	მთისწინეთე	მთისწინეთებს
Generate the inflected form for: მთისწინეთი N;DAT(PL;LGSPEC2)	მთისწინეთთ	მთისწინეთთა
Generate the inflected form for: მთისწინეთი N;DAT(SG)	მთისწინეთს	მთისწინეთს
Generate the inflected form for: მთისწინეთი N;ERG(PL)	მთისწინეთე	მთისწინეთებმა
Generate the inflected form for: მთისწინეთი N;ERG(PL;LGSPEC2)	მთისწინეთთ	მთისწინეთთა
Generate the inflected form for: მთისწინეთი N;ERG(SG)	მთისწინეთმ	მთისწინეთმა
Generate the inflected form for: მთისწინეთი N;FRML(PL)	მთისწინეთე	მთისწინეთებად
Generate the inflected form for: მთისწინეთი N;FRML(SG)	მთისწინეთა	მთისწინეთად
Generate the inflected form for: მთისწინეთი N;GEN(PL)	მთისწინეთე	მთისწინეთების
Generate the inflected form for: მთისწინეთი N;GEN(PL;LGSPEC2)	მთისწინეთთ	მთისწინეთთა
Generate the inflected form for: მთისწინეთი N;GEN(SG)	მთისწინეთი	მთისწინეთის
Generate the inflected form for: მთისწინეთი N;INS(PL)	მთისწინეთე	მთისწინეთებით
Generate the inflected form for: მთისწინეთი N;INS(SG)	მთისწინეთი	მთისწინეთით
Generate the inflected form for: მთისწინეთი N;NOM(PL)	მთისწინეთე	მთისწინეთები
Generate the inflected form for: მთისწინეთი N;NOM(PL;LGSPEC2)	მთისწინეთნ	მთისწინეთნი
Generate the inflected form for: მთისწინეთი N;NOM(SG)	მთისწინეთი	მთისწინეთი
Generate the inflected form for: მთისწინეთი N;VOC(PL)	მთისწინეთე	მთისწინეთებო
Generate the inflected form for: მთისწინეთი N;VOC(PL;LGSPEC2)	მთისწინეთნ	მთისწინეთნო
Generate the inflected form for: მთისწინეთი N;VOC(SG)	მთისწინეთო	მთისწინეთო
Generate the inflected form for: მშვიდი ADJ;DAT(PL)	მშვიდებს	მშვიდებს
Generate the inflected form for: მშვიდი ADJ;DAT(PL;LGSPEC2)	მშვიდთა	მშვიდთა
Generate the inflected form for: მშვიდი ADJ;DAT(SG)	მშვიდს	მშვიდს
Generate the inflected form for: მშვიდი ADJ;ERG(PL)	მშვიდებმა	მშვიდებმა
Generate the inflected form for: მშვიდი ADJ;ERG(PL;LGSPEC2)	მშვიდთა	მშვიდთა
Generate the inflected form for: მშვიდი ADJ;ERG(SG)	მშვიდმა	მშვიდმა
Generate the inflected form for: მშვიდი ADJ;FRML(PL)	მშვიდებად	მშვიდებად
Generate the inflected form for: მშვიდი ADJ;FRML(SG)	მშვიდად	მშვიდად
Generate the inflected form for: მშვიდი ADJ;GEN(PL)	მშვიდების	მშვიდების
Generate the inflected form for: მშვიდი ADJ;GEN(PL;LGSPEC2)	მშვიდთა	მშვიდთა
Generate the inflected form for: მშვიდი ADJ;GEN(SG)	მშვიდის	მშვიდის
Generate the inflected form for: მშვიდი ADJ;INS(PL)	მშვიდებით	მშვიდებით
Generate the inflected form for: მშვიდი ADJ;INS(SG)	მშვიდით	მშვიდით
Generate the inflected form for: მშვიდი ADJ;NOM(PL)	მშვიდები	მშვიდები
Generate the inflected form for: მშვიდი ADJ;NOM(PL;LGSPEC2)	მშვიდნი	მშვიდნი
Generate the inflected form for: მშვიდი ADJ;NOM(SG)	მშვიდი	მშვიდი
Generate the inflected form for: მშვიდი ADJ;VOC(PL)	მშვიდებო	მშვიდებო
Generate the inflected form for: მშვიდი ADJ;VOC(PL;LGSPEC2)	მშვიდნო	მშვიდნო
Generate the inflected form for: მშვიდი ADJ;VOC(SG)	მშვიდო	მშვიდო
Generate the inflected form for: მძინარე ADJ;DAT(PL)	მძინარეებს	მძინარეებს
Generate the inflected form for: მძინარე ADJ;DAT(PL;LGSPEC2)	მძინარეთა	მძინარეთა
Generate the inflected form for: მძინარე ADJ;DAT(SG)	მძინარეს	მძინარეს
Generate the inflected form for: მძინარე ADJ;ERG(PL)	მძინარეებმ	მძინარეებმა
Generate the inflected form for: მძინარე ADJ;ERG(PL;LGSPEC2)	მძინარეთა	მძინარეთა
Generate the inflected form for: მძინარე ADJ;ERG(SG)	მძინარემ	მძინარემ
Generate the inflected form for: მძინარე ADJ;FRML(PL)	მძინარეება	მძინარეებად
Generate the inflected form for: მძინარე ADJ;FRML(SG)	მძინარედ	მძინარედ
Generate the inflected form for: მძინარე ADJ;GEN(PL)	მძინარეები	მძინარეების
Generate the inflected form for: მძინარე ADJ;GEN(PL;LGSPEC2)	მძინარეთა	მძინარეთა
Generate the inflected form for: მძინარე ADJ;GEN(SG)	მძინარის	მძინარის
Generate the inflected form for: მძინარე ADJ;INS(PL)	მძინარეები	მძინარეებით
Generate the inflected form for: მძინარე ADJ;INS(SG)	მძინარით	მძინარით
Generate the inflected form for: მძინარე ADJ;NOM(PL)	მძინარეები	მძინარეები
Generate the inflected form for: მძინარე ADJ;NOM(PL;LGSPEC2)	მძინარენი	მძინარენი
Generate the inflected form for: მძინარე ADJ;NOM(SG)	მძინარე	მძინარე
Generate the inflected form for: მძინარე ADJ;VOC(PL)	მძინარეებო	მძინარეებო
Generate the inflected form for: მძინარე ADJ;VOC(PL;LGSPEC2)	მძინარენო	მძინარენო
Generate the inflected form for: მძინარე ADJ;VOC(SG)	მძინარევ	მძინარევ
Generate the inflected form for: ნამდვილი ADJ;DAT(PL)	ნამდვილებს	ნამდვილებს
Generate the inflected form for: ნამდვილი ADJ;DAT(PL;LGSPEC2)	ნამდვილთა	ნამდვილთა
Generate the inflected form for: ნამდვილი ADJ;DAT(SG)	ნამდვილს	ნამდვილს
Generate the inflected form for: ნამდვილი ADJ;ERG(PL)	ნამდვილებმ	ნამდვილებმა
Generate the inflected form for: ნამდვილი ADJ;ERG(PL;LGSPEC2)	ნამდვილთა	ნამდვილთა
Generate the inflected form for: ნამდვილი ADJ;ERG(SG)	ნამდვილმა	ნამდვილმა
Generate the inflected form for: ნამდვილი ADJ;FRML(PL)	ნამდვილება	ნამდვილებად
Generate the inflected form for: ნამდვილი ADJ;FRML(SG)	ნამდვილად	ნამდვილად
Generate the inflected form for: ნამდვილი ADJ;GEN(PL)	ნამდვილები	ნამდვილების
Generate the inflected form for: ნამდვილი ADJ;GEN(PL;LGSPEC2)	ნამდვილთა	ნამდვილთა
Generate the inflected form for: ნამდვილი ADJ;GEN(SG)	ნამდვილის	ნამდვილის
Generate the inflected form for: ნამდვილი ADJ;INS(PL)	ნამდვილები	ნამდვილებით
Generate the inflected form for: ნამდვილი ADJ;INS(SG)	ნამდვილით	ნამდვილით
Generate the inflected form for: ნამდვილი ADJ;NOM(PL)	ნამდვილები	ნამდვილები
Generate the inflected form for: ნამდვილი ADJ;NOM(PL;LGSPEC2)	ნამდვილნი	ნამდვილნი
Generate the inflected form for: ნამდვილი ADJ;NOM(SG)	ნამდვილი	ნამდვილი
Generate the inflected form for: ნამდვილი ADJ;VOC(PL)	ნამდვილებო	ნამდვილებო
Generate the inflected form for: ნამდვილი ADJ;VOC(PL;LGSPEC2)	ნამდვილნო	ნამდვილნო
Generate the inflected form for: ნამდვილი ADJ;VOC(SG)	ნამდვილო	ნამდვილო
Generate the inflected form for: ოლქი N;DAT(PL)	ოლქებს	ოლქებს
Generate the inflected form for: ოლქი N;DAT(PL;LGSPEC2)	ოლქთა	ოლქთა
Generate the inflected form for: ოლქი N;DAT(SG)	ოლქს	ოლქს
Generate the inflected form for: ოლქი N;ERG(PL)	ოლქებმა	ოლქებმა
Generate the inflected form for: ოლქი N;ERG(PL;LGSPEC2)	ოლქთა	ოლქთა
Generate the inflected form for: ოლქი N;ERG(SG)	ოლქმა	ოლქმა
Generate the inflected form for: ოლქი N;FRML(PL)	ოლქებად	ოლქებად
Generate the inflected form for: ოლქი N;FRML(SG)	ოლქად	ოლქად
Generate the inflected form for: ოლქი N;GEN(PL)	ოლქების	ოლქების
Generate the inflected form for: ოლქი N;GEN(PL;LGSPEC2)	ოლქთა	ოლქთა
Generate the inflected form for: ოლქი N;GEN(SG)	ოლქის	ოლქის
Generate the inflected form for: ოლქი N;INS(PL)	ოლქებით	ოლქებით
Generate the inflected form for: ოლქი N;INS(SG)	ოლქით	ოლქით
Generate the inflected form for: ოლქი N;NOM(PL)	ოლქები	ოლქები
Generate the inflected form for: ოლქი N;NOM(PL;LGSPEC2)	ოლქნი	ოლქნი
Generate the inflected form for: ოლქი N;NOM(SG)	ოლქი	ოლქი
Generate the inflected form for: ოლქი N;VOC(PL)	ოლქებო	ოლქებო
Generate the inflected form for: ოლქი N;VOC(PL;LGSPEC2)	ოლქნო	ოლქნო
Generate the inflected form for: ოლქი N;VOC(SG)	ოლქო	ოლქო
Generate the inflected form for: სამერცხული N;DAT(PL)	სამერცხულე	სამერცხულებს
Generate the inflected form for: სამერცხული N;DAT(PL;LGSPEC2)	სამერცხულთ	სამერცხულთა
Generate the inflected form for: სამერცხული N;DAT(SG)	სამერცხულს	სამერცხულს
Generate the inflected form for: სამერცხული N;ERG(PL)	სამერცხულე	სამერცხულებმა
Generate the inflected form for: სამერცხული N;ERG(PL;LGSPEC2)	სამერცხულთ	სამერცხულთა
Generate the inflected form for: სამერცხული N;ERG(SG)	სამერცხულმ	სამერცხულმა
Generate the inflected form for: სამერცხული N;FRML(PL)	სამერცხულე	სამერცხულებად
Generate the inflected form for: სამერცხული N;FRML(SG)	სამერცხულა	სამერცხულად
Generate the inflected form for: სამერცხული N;GEN(PL)	სამერცხულე	სამერცხულების
Generate the inflected form for: სამერცხული N;GEN(PL;LGSPEC2)	სამერცხულთ	სამერცხულთა
Generate the inflected form for: სამერცხული N;GEN(SG)	სამერცხული	სამერცხულის
Generate the inflected form for: სამერცხული N;INS(PL)	სამერცხულე	სამერცხულებით
Generate the inflected form for: სამერცხული N;INS(SG)	სამერცხული	სამერცხულით
Generate the inflected form for: სამერცხული N;NOM(PL)	სამერცხულე	სამერცხულები
Generate the inflected form for: სამერცხული N;NOM(PL;LGSPEC2)	სამერცხულნ	სამერცხულნი
Generate the inflected form for: სამერცხული N;NOM(SG)	სამერცხული	სამერცხული
Generate the inflected form for: სამერცხული N;VOC(PL)	სამერცხულე	სამერცხულებო
Generate the inflected form for: სამერცხული N;VOC(PL;LGSPEC2)	სამერცხულნ	სამერცხულნო
Generate the inflected form for: სამერცხული N;VOC(SG)	სამერცხულო	სამერცხულო
Generate the inflected form for: სარჩელი N;DAT(PL)	სარჩელებს	სარჩელებს
Generate the inflected form for: სარჩელი N;DAT(PL;LGSPEC2)	სარჩელთა	სარჩელთა
Generate the inflected form for: სარჩელი N;DAT(SG)	სარჩელს	სარჩელს
Generate the inflected form for: სარჩელი N;ERG(PL)	სარჩელებმა	სარჩელებმა
Generate the inflected form for: სარჩელი N;ERG(PL;LGSPEC2)	სარჩელთა	სარჩელთა
Generate the inflected form for: სარჩელი N;ERG(SG)	სარჩელმა	სარჩელმა
Generate the inflected form for: სარჩელი N;FRML(PL)	სარჩელებად	სარჩელებად
Generate the inflected form for: სარჩელი N;FRML(SG)	სარჩელად	სარჩელად
Generate the inflected form for: სარჩელი N;GEN(PL)	სარჩელების	სარჩელების
Generate the inflected form for: სარჩელი N;GEN(PL;LGSPEC2)	სარჩელთა	სარჩელთა
Generate the inflected form for: სარჩელი N;GEN(SG)	სარჩელის	სარჩელის
Generate the inflected form for: სარჩელი N;INS(PL)	სარჩელებით	სარჩელებით
Generate the inflected form for: სარჩელი N;INS(SG)	სარჩელით	სარჩელით
Generate the inflected form for: სარჩელი N;NOM(PL)	სარჩელები	სარჩელები
Generate the inflected form for: სარჩელი N;NOM(PL;LGSPEC2)	სარჩელნი	სარჩელნი
Generate the inflected form for: სარჩელი N;NOM(SG)	სარჩელი	სარჩელი
Generate the inflected form for: სარჩელი N;VOC(PL)	სარჩელებო	სარჩელებო
Generate the inflected form for: სარჩელი N;VOC(PL;LGSPEC2)	სარჩელნო	სარჩელნო
Generate the inflected form for: სარჩელი N;VOC(SG)	სარჩელო	სარჩელო
Generate the inflected form for: საწყალი ADJ;DAT(PL)	საწყლებს	საწყლებს
Generate the inflected form for: საწყალი ADJ;DAT(PL;LGSPEC2)	საწყალთა	საწყალთა
Generate the inflected form for: საწყალი ADJ;DAT(SG)	საწყლს	საწყალს
Generate the inflected form for: საწყალი ADJ;ERG(PL)	საწყლებმა	საწყლებმა
Generate the inflected form for: საწყალი ADJ;ERG(PL;LGSPEC2)	საწყალთა	საწყალთა
Generate the inflected form for: საწყალი ADJ;ERG(SG)	საწყალმა	საწყალმა
Generate the inflected form for: საწყალი ADJ;FRML(PL)	საწყლებად	საწყლებად
Generate the inflected form for: საწყალი ADJ;FRML(SG)	საწყალად	საწყლად
Generate the inflected form for: საწყალი ADJ;GEN(PL)	საწყლების	საწყლების
Generate the inflected form for: საწყალი ADJ;GEN(PL;LGSPEC2)	საწყალთა	საწყალთა
Generate the inflected form for: საწყალი ADJ;GEN(SG)	საწყლის	საწყლის
Generate the inflected form for: საწყალი ADJ;INS(PL)	საწყლებით	საწყლებით
Generate the inflected form for: საწყალი ADJ;INS(SG)	საწყლით	საწყლით
Generate the inflected form for: საწყალი ADJ;NOM(PL)	საწყლები	საწყლები
Generate the inflected form for: საწყალი ADJ;NOM(PL;LGSPEC2)	საწყალნი	საწყალნი
Generate the inflected form for: საწყალი ADJ;NOM(SG)	საწყლი	საწყალი
Generate the inflected form for: საწყალი ADJ;VOC(PL)	საწყლებო	საწყლებო
Generate the inflected form for: საწყალი ADJ;VOC(PL;LGSPEC2)	საწყალნო	საწყალნო
Generate the inflected form for: საწყალი ADJ;VOC(SG)	საწყალო	საწყალო
Generate the inflected form for: სკანერი N;DAT(PL)	სკანერებს	სკანერებს
Generate the inflected form for: სკანერი N;DAT(PL;LGSPEC2)	სკანერთა	სკანერთა
Generate the inflected form for: სკანერი N;DAT(SG)	სკანერს	სკანერს
Generate the inflected form for: სკანერი N;ERG(PL)	სკანერებმა	სკანერებმა
Generate the inflected form for: სკანერი N;ERG(PL;LGSPEC2)	სკანერთა	სკანერთა
Generate the inflected form for: სკანერი N;ERG(SG)	სკანერმა	სკანერმა
Generate the inflected form for: სკანერი N;FRML(PL)	სკანერებად	სკანერებად
Generate the inflected form for: სკანერი N;FRML(SG)	სკანერად	სკანერად
Generate the inflected form for: სკანერი N;GEN(PL)	სკანერების	სკანერების
Generate the inflected form for: სკანერი N;GEN(PL;LGSPEC2)	სკანერთა	სკანერთა
Generate the inflected form for: სკანერი N;GEN(SG)	სკანერის	სკანერის
Generate the inflected form for: სკანერი N;INS(PL)	სკანერებით	სკანერებით
Generate the inflected form for: სკანერი N;INS(SG)	სკანერით	სკანერით
Generate the inflected form for: სკანერი N;NOM(PL)	სკანერები	სკანერები
Generate the inflected form for: სკანერი N;NOM(PL;LGSPEC2)	სკანერნი	სკანერნი
Generate the inflected form for: სკანერი N;NOM(SG)	სკანერი	სკანერი
Generate the inflected form for: სკანერი N;VOC(PL)	სკანერებო	სკანერებო
Generate the inflected form for: სკანერი N;VOC(PL;LGSPEC2)	სკანერნო	სკანერნო
Generate the inflected form for: სკანერი N;VOC(SG)	სკანერო	სკანერო
Generate the inflected form for: ტექტონა N;DAT(PL)	ტექტონებს	ტექტონებს
Generate the inflected form for: ტექტონა N;DAT(PL;LGSPEC2)	ტექტონათა	ტექტონათა
Generate the inflected form for: ტექტონა N;ERG(PL)	ტექტონებმა	ტექტონებმა
Generate the inflected form for: ტექტონა N;ERG(PL;LGSPEC2)	ტექტონათა	ტექტონათა
Generate the inflected form for: ტექტონა N;ERG(SG)	ტექტონამ	ტექტონამ
Generate the inflected form for: ტექტონა N;FRML(PL)	ტექტონებად	ტექტონებად
Generate the inflected form for: ტექტონა N;FRML(SG)	ტექტონად	ტექტონად
Generate the inflected form for: ტექტონა N;GEN(PL)	ტექტონების	ტექტონების
Generate the inflected form for: ტექტონა N;GEN(PL;LGSPEC2)	ტექტონათა	ტექტონათა
Generate the inflected form for: ტექტონა N;GEN(SG)	ტექტონის	ტექტონის
Generate the inflected form for: ტექტონა N;INS(PL)	ტექტონებით	ტექტონებით
Generate the inflected form for: ტექტონა N;INS(SG)	ტექტონით	ტექტონით
Generate the inflected form for: ტექტონა N;NOM(PL)	ტექტონები	ტექტონები
Generate the inflected form for: ტექტონა N;NOM(PL;LGSPEC2)	ტექტონანი	ტექტონანი
Generate the inflected form for: ტექტონა N;NOM(SG)	ტექტონა	ტექტონა
Generate the inflected form for: ტექტონა N;VOC(PL)	ტექტონებო	ტექტონებო
Generate the inflected form for: ტექტონა N;VOC(PL;LGSPEC2)	ტექტონანო	ტექტონანო
Generate the inflected form for: უტყვი ADJ;DAT(PL)	უტყვებს	უტყვებს
Generate the inflected form for: უტყვი ADJ;DAT(PL;LGSPEC2)	უტყვთა	უტყვთა
Generate the inflected form for: უტყვი ADJ;DAT(SG)	უტყვს	უტყვს
Generate the inflected form for: უტყვი ADJ;ERG(PL)	უტყვებმა	უტყვებმა
Generate the inflected form for: უტყვი ADJ;ERG(PL;LGSPEC2)	უტყვთა	უტყვთა
Generate the inflected form for: უტყვი ADJ;ERG(SG)	უტყვმა	უტყვმა
Generate the inflected form for: უტყვი ADJ;FRML(PL)	უტყვებად	უტყვებად
Generate the inflected form for: უტყვი ADJ;FRML(SG)	უტყვად	უტყვად
Generate the inflected form for: უტყვი ADJ;GEN(PL)	უტყვების	უტყვების
Generate the inflected form for: უტყვი ADJ;GEN(PL;LGSPEC2)	უტყვთა	უტყვთა
Generate the inflected form for: უტყვი ADJ;GEN(SG)	უტყვის	უტყვის
Generate the inflected form for: უტყვი ADJ;INS(PL)	უტყვებით	უტყვებით
Generate the inflected form for: უტყვი ADJ;INS(SG)	უტყვით	უტყვით
Generate the inflected form for: უტყვი ADJ;NOM(PL)	უტყვები	უტყვები
Generate the inflected form for: უტყვი ADJ;NOM(PL;LGSPEC2)	უტყვნი	უტყვნი
Generate the inflected form for: უტყვი ADJ;NOM(SG)	უტყვი	უტყვი
Generate the inflected form for: უტყვი ADJ;VOC(PL)	უტყვებო	უტყვებო
Generate the inflected form for: უტყვი ADJ;VOC(PL;LGSPEC2)	უტყვნო	უტყვნო
Generate the inflected form for: უტყვი ADJ;VOC(SG)	უტყვო	უტყვო
Generate the inflected form for: ფრაზა N;DAT(PL)	ფრაზებს	ფრაზებს
Generate the inflected form for: ფრაზა N;DAT(PL;LGSPEC2)	ფრაზათა	ფრაზათა
Generate the inflected form for: ფრაზა N;DAT(SG)	ფრაზას	ფრაზას
Generate the inflected form for: ფრაზა N;ERG(PL)	ფრაზებმა	ფრაზებმა
Generate the inflected form for: ფრაზა N;ERG(PL;LGSPEC2)	ფრაზათა	ფრაზათა
Generate the inflected form for: ფრაზა N;ERG(SG)	ფრაზამ	ფრაზამ
Generate the inflected form for: ფრაზა N;FRML(PL)	ფრაზებად	ფრაზებად
Generate the inflected form for: ფრაზა N;FRML(SG)	ფრაზად	ფრაზად
Generate the inflected form for: ფრაზა N;GEN(PL)	ფრაზების	ფრაზების
Generate the inflected form for: ფრაზა N;GEN(PL;LGSPEC2)	ფრაზათა	ფრაზათა
Generate the inflected form for: ფრაზა N;GEN(SG)	ფრაზის	ფრაზის
Generate the inflected form for: ფრაზა N;INS(PL)	ფრაზებით	ფრაზებით
Generate the inflected form for: ფრაზა N;INS(SG)	ფრაზით	ფრაზით
Generate the inflected form for: ფრაზა N;NOM(PL)	ფრაზები	ფრაზები
Generate the inflected form for: ფრაზა N;NOM(PL;LGSPEC2)	ფრაზანი	ფრაზანი
Generate the inflected form for: ფრაზა N;NOM(SG)	ფრაზა	ფრაზა
Generate the inflected form for: ფრაზა N;VOC(PL)	ფრაზებო	ფრაზებო
Generate the inflected form for: ფრაზა N;VOC(PL;LGSPEC2)	ფრაზანო	ფრაზანო
Generate the inflected form for: ფრაზა N;VOC(SG)	ფრაზავ	ფრაზავ
Generate the inflected form for: ღერო N;DAT(PL)	ღეროებს	ღეროებს
Generate the inflected form for: ღერო N;DAT(PL;LGSPEC2)	ღეროთა	ღეროთა
Generate the inflected form for: ღერო N;DAT(SG)	ღეროს	ღეროს
Generate the inflected form for: ღერო N;ERG(PL)	ღეროებმა	ღეროებმა
Generate the inflected form for: ღერო N;ERG(PL;LGSPEC2)	ღეროთა	ღეროთა
Generate the inflected form for: ღერო N;ERG(SG)	ღერომ	ღერომ
Generate the inflected form for: ღერო N;FRML(PL)	ღეროებად	ღეროებად
Generate the inflected form for: ღერო N;FRML(SG)	ღეროდ	ღეროდ
Generate the inflected form for: ღერო N;GEN(PL)	ღეროების	ღეროების
Generate the inflected form for: ღერო N;GEN(PL;LGSPEC2)	ღეროთა	ღეროთა
Generate the inflected form for: ღერო N;GEN(SG)	ღეროს	ღეროს
Generate the inflected form for: ღერო N;INS(PL)	ღეროებით	ღეროებით
Generate the inflected form for: ღერო N;INS(SG)	ღეროთი	ღეროთი
Generate the inflected form for: ღერო N;NOM(PL)	ღეროები	ღეროები
Generate the inflected form for: ღერო N;NOM(PL;LGSPEC2)	ღერონი	ღერონი
Generate the inflected form for: ღერო N;NOM(SG)	ღერო	ღერო
Generate the inflected form for: ღერო N;VOC(PL)	ღეროებო	ღეროებო
Generate the inflected form for: ღერო N;VOC(PL;LGSPEC2)	ღერონო	ღერონო
Generate the inflected form for: ღერო N;VOC(SG)	ღეროვ	ღეროვ
Generate the inflected form for: ყვერული N;DAT(PL)	ყვერულებს	ყვერულებს
Generate the inflected form for: ყვერული N;DAT(PL;LGSPEC2)	ყვერულთა	ყვერულთა
Generate the inflected form for: ყვერული N;DAT(SG)	ყვერულს	ყვერულს
Generate the inflected form for: ყვერული N;ERG(PL)	ყვერულებმა	ყვერულებმა
Generate the inflected form for: ყვერული N;ERG(PL;LGSPEC2)	ყვერულთა	ყვერულთა
Generate the inflected form for: ყვერული N;ERG(SG)	ყვერულმა	ყვერულმა
Generate the inflected form for: ყვერული N;FRML(PL)	ყვერულებად	ყვერულებად
Generate the inflected form for: ყვერული N;FRML(SG)	ყვერულად	ყვერულად
Generate the inflected form for: ყვერული N;GEN(PL)	ყვერულების	ყვერულების
Generate the inflected form for: ყვერული N;GEN(PL;LGSPEC2)	ყვერულთა	ყვერულთა
Generate the inflected form for: ყვერული N;GEN(SG)	ყვერულის	ყვერულის
Generate the inflected form for: ყვერული N;INS(PL)	ყვერულებით	ყვერულებით
Generate the inflected form for: ყვერული N;INS(SG)	ყვერულით	ყვერულით
Generate the inflected form for: ყვერული N;NOM(PL)	ყვერულები	ყვერულები
Generate the inflected form for: ყვერული N;NOM(PL;LGSPEC2)	ყვერულნი	ყვერულნი
Generate the inflected form for: ყვერული N;NOM(SG)	ყვერული	ყვერული
Generate the inflected form for: ყვერული N;VOC(PL)	ყვერულებო	ყვერულებო
Generate the inflected form for: ყვერული N;VOC(PL;LGSPEC2)	ყვერულნო	ყვერულნო
Generate the inflected form for: ყვერული N;VOC(SG)	ყვერულო	ყვერულო
Generate the inflected form for: შხაპი N;DAT(PL)	შხაპებს	შხაპებს
Generate the inflected form for: შხაპი N;DAT(PL;LGSPEC2)	შხაპთა	შხაპთა
Generate the inflected form for: შხაპი N;DAT(SG)	შხაპს	შხაპს
Generate the inflected form for: შხაპი N;ERG(PL)	შხაპებმა	შხაპებმა
Generate the inflected form for: შხაპი N;ERG(PL;LGSPEC2)	შხაპთა	შხაპთა
Generate the inflected form for: შხაპი N;ERG(SG)	შხაპმა	შხაპმა
Generate the inflected form for: შხაპი N;FRML(PL)	შხაპებად	შხაპებად
Generate the inflected form for: შხაპი N;FRML(SG)	შხაპად	შხაპად
Generate the inflected form for: შხაპი N;GEN(PL)	შხაპების	შხაპების
Generate the inflected form for: შხაპი N;GEN(PL;LGSPEC2)	შხაპთა	შხაპთა
Generate the inflected form for: შხაპი N;GEN(SG)	შხაპის	შხაპის
Generate the inflected form for: შხაპი N;INS(PL)	შხაპებით	შხაპებით
Generate the inflected form for: შხაპი N;INS(SG)	შხაპით	შხაპით
Generate the inflected form for: შხაპი N;NOM(PL)	შხაპები	შხაპები
Generate the inflected form for: შხაპი N;NOM(PL;LGSPEC2)	შხაპნი	შხაპნი
Generate the inflected form for: შხაპი N;NOM(SG)	შხაპი	შხაპი
Generate the inflected form for: შხაპი N;VOC(PL)	შხაპებო	შხაპებო
Generate the inflected form for: შხაპი N;VOC(PL;LGSPEC2)	შხაპნო	შხაპნო
Generate the inflected form for: შხაპი N;VOC(SG)	შხაპო	შხაპო
Generate the inflected form for: ჩქარობს V;COND;NOM(3,PL)	იჩქარებდნე	იჩქარებდნენ
Generate the inflected form for: ჩქარობს V;COND;NOM(3,SG)	იჩქარებდა	იჩქარებდა
Generate the inflected form for: ჩქარობს V;IND;FUT;NOM(2,SG)	იჩქარებ	იჩქარებ
Generate the inflected form for: ჩქარობს V;IND;FUT;NOM(3,PL)	იჩქარებენ	იჩქარებენ
Generate the inflected form for: ჩქარობს V;IND;FUT;NOM(3,SG)	იჩქარებს	იჩქარებს
Generate the inflected form for: ჩქარობს V;IND;IPFV;NOM(1,PL)	ვჩქარობდით	ვჩქარობდით
Generate the inflected form for: ჩქარობს V;IND;IPFV;NOM(3,PL)	ჩქარობდნენ	ჩქარობდნენ
Generate the inflected form for: ჩქარობს V;IND;IPFV;NOM(3,SG)	ჩქარობდა	ჩქარობდა
Generate the inflected form for: ჩქარობს V;IND;PRF;NOM(2,PL)	გეჩქარიათ	გიჩქარიათ
Generate the inflected form for: ჩქარობს V;IND;PRF;NOM(2,SG)	გეჩქარია	გიჩქარია
Generate the inflected form for: ჩქარობს V;IND;PRS;NOM(3,PL)	ჩქარობენ	ჩქარობენ
Generate the inflected form for: ჩქარობს V;IND;PST;PFV;NOM(1,PL)	ვიჩქარეთ	ვიჩქარეთ
Generate the inflected form for: ჩქარობს V;IND;PST;PFV;NOM(1,SG)	ვიჩქარე	ვიჩქარე
Generate the inflected form for: ჩქარობს V;IND;PST;PFV;NOM(3,PL)	იჩქარეს	იჩქარეს
Generate the inflected form for: ჩქარობს V;IND;PST;PRF;NOM(1,PL)	გვეჩქარა	გვეჩქარა
Generate the inflected form for: ჩქარობს V;IND;PST;PRF;NOM(3,SG)	ეჩქარა	ეჩქარა
Generate the inflected form for: ჩქარობს V;OPT;NOM(1,PL)	ვიჩქაროთ	ვიჩქაროთ
Generate the inflected form for: ჩქარობს V;SBJV;FUT;NOM(1,SG)	ვიჩქარებდე	ვიჩქარებდე
Generate the inflected form for: ჩქარობს V;SBJV;FUT;NOM(2,PL)	იჩქარებდეთ	იჩქარებდეთ
Generate the inflected form for: ჩქარობს V;SBJV;FUT;NOM(3,PL)	იჩქარებდნე	იჩქარებდნენ
Generate the inflected form for: ჩქარობს V;SBJV;FUT;NOM(3,SG)	იჩქარებდეს	იჩქარებდეს
Generate the inflected form for: ჩქარობს V;SBJV;PRF;NOM(2,SG)	გეჩქაროს	გეჩქაროს
Generate the inflected form for: ჩქარობს V;SBJV;PRF;NOM(3,PL)	ეჩქაროთ	ეჩქაროთ
Generate the inflected form for: ჩქარობს V;SBJV;PRS;NOM(2,PL)	ჩქარობდეთ	ჩქარობდეთ
Generate the inflected form for: ჩქარობს V;SBJV;PRS;NOM(2,SG)	ჩქარობდე	ჩქარობდე
Generate the inflected form for: ჩქარობს V;SBJV;PRS;NOM(3,PL)	ჩქარობდნენ	ჩქარობდნენ
Generate the inflected form for: ცერობი N;DAT(PL)	ცერობებს	ცერობებს
Generate the inflected form for: ცერობი N;DAT(PL;LGSPEC2)	ცერობთა	ცერობთა
Generate the inflected form for: ცერობი N;DAT(SG)	ცერობს	ცერობს
Generate the inflected form for: ცერობი N;ERG(PL)	ცერობებმა	ცერობებმა
Generate the inflected form for: ცერობი N;ERG(PL;LGSPEC2)	ცერობთა	ცერობთა
Generate the inflected form for: ცერობი N;ERG(SG)	ცერობმა	ცერობმა
Generate the inflected form for: ცერობი N;FRML(PL)	ცერობებად	ცერობებად
Generate the inflected form for: ცერობი N;FRML(SG)	ცერობად	ცერობად
Generate the inflected form for: ცერობი N;GEN(PL)	ცერობების	ცერობების
Generate the inflected form for: ცერობი N;GEN(PL;LGSPEC2)	ცერობთა	ცერობთა
Generate the inflected form for: ცერობი N;GEN(SG)	ცერობის	ცერობის
Generate the inflected form for: ცერობი N;INS(PL)	ცერობებით	ცერობებით
Generate the inflected form for: ცერობი N;INS(SG)	ცერობით	ცერობით
Generate the inflected form for: ცერობი N;NOM(PL)	ცერობები	ცერობები
Generate the inflected form for: ცერობი N;NOM(PL;LGSPEC2)	ცერობნი	ცერობნი
Generate the inflected form for: ცერობი N;NOM(SG)	ცერობი	ცერობი
Generate the inflected form for: ცერობი N;VOC(PL)	ცერობებო	ცერობებო
Generate the inflected form for: ცერობი N;VOC(PL;LGSPEC2)	ცერობნო	ცერობნო
Generate the inflected form for: ცერობი N;VOC(SG)	ცერობო	ცერობო
Generate the inflected form for: ცური N;DAT(PL)	ცურებს	ცურებს
Generate the inflected form for: ცური N;DAT(PL;LGSPEC2)	ცურთა	ცურთა
Generate the inflected form for: ცური N;DAT(SG)	ცურს	ცურს
Generate the inflected form for: ცური N;ERG(PL)	ცურებმა	ცურებმა
Generate the inflected form for: ცური N;ERG(PL;LGSPEC2)	ცურთა	ცურთა
Generate the inflected form for: ცური N;ERG(SG)	ცურმა	ცურმა
Generate the inflected form for: ცური N;FRML(PL)	ცურებად	ცურებად
Generate the inflected form for: ცური N;FRML(SG)	ცურად	ცურად
Generate the inflected form for: ცური N;GEN(PL)	ცურების	ცურების
Generate the inflected form for: ცური N;GEN(PL;LGSPEC2)	ცურთა	ცურთა
Generate the inflected form for: ცური N;GEN(SG)	ცურის	ცურის
Generate the inflected form for: ცური N;INS(PL)	ცურებით	ცურებით
Generate the inflected form for: ცური N;INS(SG)	ცურით	ცურით
Generate the inflected form for: ცური N;NOM(PL)	ცურები	ცურები
Generate the inflected form for: ცური N;NOM(PL;LGSPEC2)	ცურნი	ცურნი
Generate the inflected form for: ცური N;VOC(PL)	ცურებო	ცურებო
Generate the inflected form for: ცური N;VOC(PL;LGSPEC2)	ცურნო	ცურნო
Generate the inflected form for: ცური N;VOC(SG)	ცურო	ცურო
Generate the inflected form for: წონის V;COND;NOM(1,PL);ACC(2,PL)	დაგწონებდი	აგწონიდით
Generate the inflected form for: წონის V;COND;NOM(1,PL);ACC(3,SG)	დავწონებდი	ავწონიდით
Generate the inflected form for: წონის V;IND;IPFV;NOM(1,PL);ACC(2,PL)	გწონოდით	გწონიდით
Generate the inflected form for: წონის V;IND;IPFV;NOM(1,PL);ACC(3,SG)	ვწონოდით	ვწონიდით
Generate the inflected form for: წონის V;IND;IPFV;NOM(1,SG);ACC(3,PL)	ვწონოდი	ვწონიდი
Generate the inflected form for: წონის V;IND;IPFV;NOM(2,PL);ACC(3,PL)	წონოდით	წონიდით
Generate the inflected form for: წონის V;IND;PRS;NOM(3,SG);ACC(2,SG)	გწონის	გწონის
Generate the inflected form for: წონის V;IND;PRS;NOM(3,SG);ACC(3,PL)	წონის	წონის
Generate the inflected form for: წონის V;IND;PST;PFV;NOM(1,PL);ACC(3,SG)	დავწონეთ	ავწონეთ
Generate the inflected form for: წონის V;IND;PST;PFV;NOM(1,SG);ACC(2,PL)	დაგწონეთ	აგწონეთ
Generate the inflected form for: წონის V;IND;PST;PFV;NOM(1,SG);ACC(3,PL)	მოვწონე	ავწონე
Generate the inflected form for: წონის V;IND;PST;PFV;NOM(2,PL);ACC(1,PL)	დაგვწონეთ	აგვწონეთ
Generate the inflected form for: წონის V;IND;PST;PFV;NOM(2,SG);ACC(1,PL)	დაგვწონე	აგვწონე
Generate the inflected form for: წონის V;IND;PST;PFV;NOM(3,SG);ACC(3,SG)	დაწონე	აწონა
Generate the inflected form for: წონის V;IND;PST;PRF;NOM(1,PL);ACC(2,SG)	გაგწონებოდ	აგვეწონე
Generate the inflected form for: წონის V;OPT;NOM(2,SG);ACC(1,PL)	დაგვწონო	აგვწონო
Generate the inflected form for: წონის V;OPT;NOM(3,PL);ACC(1,PL)	დაგვწონოს	აგვწონონ
Generate the inflected form for: წონის V;OPT;NOM(3,PL);ACC(2,SG)	დაგწონონ	აგწონონ
Generate the inflected form for: წონის V;OPT;NOM(3,SG);ACC(2,PL)	დაგწონოთ	აგწონოთ
Generate the inflected form for: წონის V;SBJV;FUT;NOM(1,SG);ACC(3,PL)	მოვწონებოდ	ავწონიდე
Generate the inflected form for: წონის V;SBJV;FUT;NOM(3,PL);ACC(1,SG)	დამწონებდნ	ამწონიდნენ
Generate the inflected form for: წონის V;SBJV;FUT;NOM(3,SG);ACC(1,SG)	მომწონებოდ	ამწონიდეს
Generate the inflected form for: წონის V;SBJV;PRF;NOM(1,PL);ACC(3,SG)	დავწონებოდ	აგვეწონოს
Generate the inflected form for: წონის V;SBJV;PRF;NOM(2,PL);ACC(3,SG)	გაწონებოდე	აგეწონოთ
Generate the inflected form for: წონის V;SBJV;PRF;NOM(3,PL);ACC(2,SG)	დაგწონებოდ	აეწონოთ
Generate the inflected form for: წონის V;SBJV;PRS;NOM(2,PL);ACC(1,PL)	გვწონოდეთ	გვწონიდეთ
Generate the inflected form for: ჭილიბი N;DAT(PL)	ჭილიბებს	ჭილიბებს
Generate the inflected form for: ჭილიბი N;DAT(PL;LGSPEC2)	ჭილიბთა	ჭილიბთა
Generate the inflected form for: ჭილიბი N;DAT(SG)	ჭილიბს	ჭილიბს
Generate the inflected form for: ჭილიბი N;ERG(PL)	ჭილიბებმა	ჭილიბებმა
Generate the inflected form for: ჭილიბი N;ERG(PL;LGSPEC2)	ჭილიბთა	ჭილიბთა
Generate the inflected form for: ჭილიბი N;ERG(SG)	ჭილიბმა	ჭილიბმა
Generate the inflected form for: ჭილიბი N;FRML(PL)	ჭილიბებად	ჭილიბებად
Generate the inflected form for: ჭილიბი N;FRML(SG)	ჭილიბად	ჭილიბად
Generate the inflected form for: ჭილიბი N;GEN(PL)	ჭილიბების	ჭილიბების
Generate the inflected form for: ჭილიბი N;GEN(PL;LGSPEC2)	ჭილიბთა	ჭილიბთა
Generate the inflected form for: ჭილიბი N;GEN(SG)	ჭილიბის	ჭილიბის
Generate the inflected form for: ჭილიბი N;INS(PL)	ჭილიბებით	ჭილიბებით
Generate the inflected form for: ჭილიბი N;INS(SG)	ჭილიბით	ჭილიბით
Generate the inflected form for: ჭილიბი N;NOM(PL)	ჭილიბები	ჭილიბები
Generate the inflected form for: ჭილიბი N;NOM(PL;LGSPEC2)	ჭილიბნი	ჭილიბნი
Generate the inflected form for: ჭილიბი N;NOM(SG)	ჭილიბი	ჭილიბი
Generate the inflected form for: ჭილიბი N;VOC(PL)	ჭილიბებო	ჭილიბებო
Generate the inflected form for: ჭილიბი N;VOC(PL;LGSPEC2)	ჭილიბნო	ჭილიბნო
Generate the inflected form for: ჭილიბი N;VOC(SG)	ჭილიბო	ჭილიბო
Generate the inflected form for: ჭრის V;COND;NOM(2,PL);ACC(1,PL)	შეგვჭრებოდ	გაგვჭრიდით
Generate the inflected form for: ჭრის V;IMP;NOM(2,PL);ACC(3,PL)	შეგჭროთ	გაჭერით
Generate the inflected form for: ჭრის V;IMP;NOM(3,SG);ACC(3,PL)	შეჭროს	გაჭრას
Generate the inflected form for: ჭრის V;IND;FUT;NOM(1,PL);ACC(3,PL)	შევჭრებთ	გავჭრით
Generate the inflected form for: ჭრის V;IND;FUT;NOM(1,PL);ACC(3,SG)	შევჭრებთ	გავჭრით
Generate the inflected form for: ჭრის V;IND;FUT;NOM(1,SG);ACC(2,SG)	შეგჭრები	გაგჭრი
Generate the inflected form for: ჭრის V;IND;FUT;NOM(2,PL);ACC(3,SG)	შეჭრებთ	გაჭრით
Generate the inflected form for: ჭრის V;IND;FUT;NOM(3,SG);ACC(1,SG)	შემჭრებს	გამჭრის
Generate the inflected form for: ჭრის V;IND;PRF;NOM(1,PL);ACC(2,PL)	შეგჭრიათ	გაგვიჭრიხართ
Generate the inflected form for: ჭრის V;IND;PRF;NOM(1,PL);ACC(2,SG)	შეგჭრიათ	გაგვიჭრიხარ
Generate the inflected form for: ჭრის V;IND;PRF;NOM(2,SG);ACC(1,SG)	შეგჭრია	გაგიჭრივარ
Generate the inflected form for: ჭრის V;IND;PRF;NOM(3,PL);ACC(1,PL)	შეგვჭრია	გავუჭრივართ
Generate the inflected form for: ჭრის V;IND;PRF;NOM(3,PL);ACC(3,SG)	შეჭრიათ	გაუჭრიათ
Generate the inflected form for: ჭრის V;IND;PRS;NOM(1,PL);ACC(3,PL)	ვჭრით	ვჭრით
Generate the inflected form for: ჭრის V;IND;PRS;NOM(3,SG);ACC(1,SG)	მჭრის	მჭრის
Generate the inflected form for: ჭრის V;IND;PST;PFV;NOM(3,PL);ACC(1,SG)	შემჭრეს	გამჭრეს
Generate the inflected form for: ჭრის V;IND;PST;PFV;NOM(3,PL);ACC(2,SG)	შეგჭრეთ	გაგჭრეს
Generate the inflected form for: ჭრის V;IND;PST;PFV;NOM(3,SG);ACC(2,SG)	შეგჭრე	გაგჭრა
Generate the inflected form for: ჭრის V;IND;PST;PRF;NOM(1,PL);ACC(2,PL)	შეგჭრიათ	გაგვეჭერით
Generate the inflected form for: ჭრის V;IND;PST;PRF;NOM(2,PL);ACC(3,PL)	შეგჭრიათ	გაგეჭრათ
Generate the inflected form for: ჭრის V;OPT;NOM(3,PL);ACC(3,PL)	შეჭრონ	გაჭრან
Generate the inflected form for: ჭრის V;OPT;NOM(3,SG);ACC(1,SG)	შემჭროს	გამჭრას
Generate the inflected form for: ჭრის V;SBJV;FUT;NOM(1,PL);ACC(2,PL)	შეგჭრებოდე	გაგჭრიდეთ
Generate the inflected form for: ჭრის V;SBJV;FUT;NOM(1,SG);ACC(2,PL)	შეგჭრებოდე	გაგჭრიდეთ
Generate the inflected form for: ჭრის V;SBJV;FUT;NOM(3,SG);ACC(3,SG)	შეჭრებდეს	გაჭრიდეს
Generate the inflected form for: ჭრის V;SBJV;PRS;NOM(3,SG);ACC(1,PL)	გვჭროდეს	გვჭრიდეს
Generate the inflected form for: ხვართქლა N;DAT(PL)	ხვართქლებს	ხვართქლებს
Generate the inflected form for: ხვართქლა N;DAT(PL;LGSPEC2)	ხვართქლათა	ხვართქლათა
Generate the inflected form for: ხვართქლა N;DAT(SG)	ხვართქლას	ხვართქლას
Generate the inflected form for: ხვართქლა N;ERG(PL)	ხვართქლებმ	ხვართქლებმა
Generate the inflected form for: ხვართქლა N;ERG(PL;LGSPEC2)	ხვართქლათა	ხვართქლათა
Generate the inflected form for: ხვართქლა N;ERG(SG)	ხვართქლამ	ხვართქლამ
Generate the inflected form for: ხვართქლა N;FRML(PL)	ხვართქლება	ხვართქლებად
Generate the inflected form for: ხვართქლა N;FRML(SG)	ხვართქლად	ხვართქლად
Generate the inflected form for: ხვართქლა N;GEN(PL)	ხვართქლები	ხვართქლების
Generate the inflected form for: ხვართქლა N;GEN(PL;LGSPEC2)	ხვართქლათა	ხვართქლათა
Generate the inflected form for: ხვართქლა N;GEN(SG)	ხვართქლის	ხვართქლის
Generate the inflected form for: ხვართქლა N;INS(PL)	ხვართქლები	ხვართქლებით
Generate the inflected form for: ხვართქლა N;INS(SG)	ხვართქლით	ხვართქლით
Generate the inflected form for: ხვართქლა N;NOM(PL)	ხვართქლები	ხვართქლები
Generate the inflected form for: ხვართქლა N;NOM(PL;LGSPEC2)	ხვართქლანი	ხვართქლანი
Generate the inflected form for: ხვართქლა N;NOM(SG)	ხვართქლა	ხვართქლა
Generate the inflected form for: ხვართქლა N;VOC(PL)	ხვართქლებო	ხვართქლებო
Generate the inflected form for: ხვართქლა N;VOC(PL;LGSPEC2)	ხვართქლანო	ხვართქლანო
Generate the inflected form for: ხვართქლა N;VOC(SG)	ხვართქლავ	ხვართქლავ
Generate the inflected form for: ხვია N;DAT(PL)	ხვიებს	ხვიებს
Generate the inflected form for: ხვია N;DAT(PL;LGSPEC2)	ხვიათა	ხვიათა
Generate the inflected form for: ხვია N;DAT(SG)	ხვიას	ხვიას
Generate the inflected form for: ხვია N;ERG(PL)	ხვიებმა	ხვიებმა
Generate the inflected form for: ხვია N;ERG(PL;LGSPEC2)	ხვიათა	ხვიათა
Generate the inflected form for: ხვია N;ERG(SG)	ხვიამ	ხვიამ
Generate the inflected form for: ხვია N;FRML(PL)	ხვიებად	ხვიებად
Generate the inflected form for: ხვია N;FRML(SG)	ხვიად	ხვიად
Generate the inflected form for: ხვია N;GEN(PL)	ხვიების	ხვიების
Generate the inflected form for: ხვია N;GEN(PL;LGSPEC2)	ხვიათა	ხვიათა
Generate the inflected form for: ხვია N;GEN(SG)	ხვიის	ხვიის
Generate the inflected form for: ხვია N;INS(PL)	ხვიებით	ხვიებით
Generate the inflected form for: ხვია N;INS(SG)	ხვიით	ხვიით
Generate the inflected form for: ხვია N;NOM(PL)	ხვიები	ხვიები
Generate the inflected form for: ხვია N;NOM(PL;LGSPEC2)	ხვიანი	ხვიანი
Generate the inflected form for: ხვია N;NOM(SG)	ხვია	ხვია
Generate the inflected form for: ხვია N;VOC(PL)	ხვიებო	ხვიებო
Generate the inflected form for: ხვია N;VOC(PL;LGSPEC2)	ხვიანო	ხვიანო
Generate the inflected form for: ხვია N;VOC(SG)	ხვიავ	ხვიავ
Generate the inflected form for: ხუმარა N;DAT(PL)	ხუმარებს	ხუმარებს
Generate the inflected form for: ხუმარა N;DAT(PL;LGSPEC2)	ხუმარათა	ხუმარათა
Generate the inflected form for: ხუმარა N;DAT(SG)	ხუმარას	ხუმარას
Generate the inflected form for: ხუმარა N;ERG(PL)	ხუმარებმა	ხუმარებმა
Generate the inflected form for: ხუმარა N;ERG(PL;LGSPEC2)	ხუმარათა	ხუმარათა
Generate the inflected form for: ხუმარა N;ERG(SG)	ხუმარამ	ხუმარამ
Generate the inflected form for: ხუმარა N;FRML(PL)	ხუმარებად	ხუმარებად
Generate the inflected form for: ხუმარა N;FRML(SG)	ხუმარად	ხუმარად
Generate the inflected form for: ხუმარა N;GEN(PL)	ხუმარების	ხუმარების
Generate the inflected form for: ხუმარა N;GEN(PL;LGSPEC2)	ხუმარათა	ხუმარათა
Generate the inflected form for: ხუმარა N;GEN(SG)	ხუმარის	ხუმარის
Generate the inflected form for: ხუმარა N;INS(PL)	ხუმარებით	ხუმარებით
Generate the inflected form for: ხუმარა N;INS(SG)	ხუმარით	ხუმარით
Generate the inflected form for: ხუმარა N;NOM(PL)	ხუმარები	ხუმარები
Generate the inflected form for: ხუმარა N;NOM(PL;LGSPEC2)	ხუმარანი	ხუმარანი
Generate the inflected form for: ხუმარა N;NOM(SG)	ხუმარა	ხუმარა
Generate the inflected form for: ხუმარა N;VOC(PL)	ხუმარებო	ხუმარებო
Generate the inflected form for: ხუმარა N;VOC(PL;LGSPEC2)	ხუმარანო	ხუმარანო
Generate the inflected form for: ხუმარა N;VOC(SG)	ხუმარავ	ხუმარავ
Generate the inflected form for: ჰქვია V;IND;FUT;NOM(1,PL)	გვექნება	გვერქმევა
Generate the inflected form for: ჰქვია V;IND;FUT;NOM(1,SG)	მექნება	მერქმევა
Generate the inflected form for: ჰქვია V;IND;FUT;NOM(2,PL)	გექნებათ	გერქმევათ
Generate the inflected form for: ჰქვია V;IND;FUT;NOM(2,SG)	გექნება	გერქმევა
Generate the inflected form for: ჰქვია V;IND;FUT;NOM(3,PL)	ექნებათ	ერქმევათ
Generate the inflected form for: ჰქვია V;IND;FUT;NOM(3,SG)	ექნება	ერქმევა
Generate the inflected form for: ჰქვია V;IND;PRF;NOM(2,PL)	გქონიათ	გრქმევიათ
Generate the inflected form for: ჰქვია V;IND;PRF;NOM(2,SG)	გქონია	გრქმევია
Generate the inflected form for: ჰქვია V;IND;PRF;NOM(3,PL)	ჰქონიათ	რქმევიათ
Generate the inflected form for: ჰქვია V;IND;PRF;NOM(3,SG)	ჰქონია	რქმევია
Generate the inflected form for: ჰქვია V;IND;PRS;NOM(1,PL)	ვქვიათ	გვქვია
Generate the inflected form for: ჰქვია V;IND;PRS;NOM(1,SG)	ვქვია	მქვია
Generate the inflected form for: ჰქვია V;IND;PRS;NOM(2,SG)	ჰქვია	გქვია
Generate the inflected form for: ჰქვია V;IND;PRS;NOM(3,PL)	ჰქვიათ	ჰქვიათ
Generate the inflected form for: ჰქვია V;IND;PRS;NOM(3,SG)	ჰქვია	ჰქვია
Generate the inflected form for: ჰქვია V;IND;PST;PFV;NOM(1,PL)	გვექნებოდა	გვერქვა
Generate the inflected form for: ჰქვია V;IND;PST;PFV;NOM(1,SG)	მექნე	მერქვა
Generate the inflected form for: ჰქვია V;IND;PST;PFV;NOM(2,PL)	გქონეთ	გერქვათ
Generate the inflected form for: ჰქვია V;IND;PST;PFV;NOM(3,PL)	ექნეს	ერქვათ
Generate the inflected form for: ჰქვია V;IND;PST;PRF;NOM(2,SG)	გქონებოდა	გრქმევოდა
Generate the inflected form for: ჰქვია V;IND;PST;PRF;NOM(3,PL)	ჰქონებოდათ	რქმევოდათ
Generate the inflected form for: ჰქვია V;IND;PST;PRF;NOM(3,SG)	ჰქონებოდა	რქმევოდა
Generate the inflected form for: ჰქვია V;OPT;NOM(1,PL)	გვექნოს	გვერქვას
Generate the inflected form for: ჰქვია V;OPT;NOM(2,PL)	გქონოთ	გერქვათ
Generate the inflected form for: ჰქვია V;OPT;NOM(2,SG)	გქონო	გერქვას
Generate the inflected form for: ჰქვია V;OPT;NOM(3,SG)	ექნოს	ერქვას

Accuracy: 0.6880 (688/1000)
Mismatches (prediction | gold):
აბსტრაქტულ | აბსტრაქტულებს
აბსტრაქტულ | აბსტრაქტულთა
აბსტრაქტულ | აბსტრაქტულს
აბსტრაქტულ | აბსტრაქტულებმა
აბსტრაქტულ | აბსტრაქტულთა
