Arabize V;PRS;NOM(3,SG)	arabize V;PRS;NOM(3,SG)jarabiz
Arabize V;V.PTCP;PRS	an Arabize V;V.PTCP;PRSarabize
Arabize V;V.PTCP;PST	 Traktor V PTCP PTCP PTCP PTCP
DL V;PST	 P P P P P P P P P P P P P P P
DL V;V.PTCP;PST	 PTC P S T S T S T S T S T S T
GI V;PRS;NOM(3,SG)	(3, SG)PRS;NOM(3, SG)PRS;NOM(3
GI V;V.PTCP;PRS	;V.PTCP;PRSans de er er er er 
GI V;V.PTCP;PST	;V.PTCP;PSTL.PTCP.PSTL.PTCP.PS
Godcast V;PRS;NOM(3,SG)	 V;PRS;NOM(3,SG)nom(3,SG)nom(3
Godcast V;V.PTCP;PRS	;PRSgodc;PRSgodc;PRSgodc;PRSgo
Godcast V;V.PTCP;PST	;V.PTCP;PSTGodchase V;V.PTCP;P
IRC V;NFIN	IRC V;NFINmirc V;NFINmirc V;NF
IRC V;PRS;NOM(3,SG)	 ;PRS;NOM(3,SG)a ;NOM(3,SG)a ;
IRC V;PST	 PST IRC V; PST IRC V; PST IRC
IRC V;V.PTCP;PST	V.PTCP;PSTC;PSTTCP;PSTTCP;PSTT
Muhammadanize V;NFIN	and the complete service of th
Muhammadanize V;PRS;NOM(3,SG)	 V;PRS;NOM(3,SG)g PRS;NOM(3,SG
Muhammadanize V;V.PTCP;PST	 PTCP;PSTa PTCP;PSTa PTCP;PSTa
Salafize V;PRS;NOM(3,SG)	;NOM(3,SG)ge V;PRS;NOM(3,SG)ge
Salafize V;PST	 Salafize V;PST V;PST V;PST V;
Salafize V;V.PTCP;PST	 PTCP PST PTCP PTCP PTCP PTCP 
Sufize V;PRS;NOM(3,SG)	 PRS;NOM(3,SG)age V;PRS;NOM(3,
Sufize V;V.PTCP;PRS	arabi Sufize V;V.PTCP;PRSufize
Sufize V;V.PTCP;PST	fize V;V.PTCP;PSTC;PSTC.PTCP.P
abode V;NFIN	bode V;NFINsbode V;NFINsbode V
abode V;PRS;NOM(3,SG)	abode PRS;NOM(3,SG)jode PRS;NO
abode V;V.PTCP;PRS	 to be a match abode V;V.PTCP;
absolve V;PRS;NOM(3,SG)	 absolve V;PRS;NOM(3,SG)absolv
absolve V;PST	 V;
PST absolve V;
PST absolve
absolve V;V.PTCP;PRS	 absolve V;V.PTCP;PRSdefine V;
accept V;NFIN	accept V;NFINstitute of the V;
accept V;PRS;NOM(3,SG)	tion accept V;PRS;NOM(3,SG)acc
accept V;V.PTCP;PRS	t V;V.PTCP.PTCP.PTCP.PTCP.PTCP
accept V;V.PTCP;PST	t a cept a cept a cept a cept 
accession V;NFIN	;NFINterest Nterest Nterest Nt
accession V;PRS;NOM(3,SG)	 contents V PRS NOM(3,SG)gener
accession V;V.PTCP;PRS	 date PRSacc PRSacc PRSacc PRS
acetize V;PRS;NOM(3,SG)	acetize V;PRS;NOM(3,SG)acetize
acetize V;PST	etize V;PSTacetize V;PSTacetiz
acquire V;NFIN	acquire V;NFINitial V;NFINitia
acquire V;PRS;NOM(3,SG)	ire acquire acquire acquire ac
acquire V;PST	acquire V;PST지원의 전체 
acquire V;V.PTCP;PRS	 acquire acquire acquire acqui
adhære V;NFIN	dhære V; NFINminminminminminm
adhære V;PST	dhære V;PSTᛸn ᛨᛀẦᛀ
adhære V;V.PTCP;PST	 af sammenligningsvisse adhær
adipocerate V;PRS;NOM(3,SG)	epocerate V;PRS;NOM(3,SG)adipo
adipocerate V;PST	 PST PST PST PST PST PST PST P
adipocerate V;V.PTCP;PRS	ate V;V.PTCP;PRSS;PRESS;PRESS.
affect V;NFIN	affect V;NFIN affect V;NFIN af
affect V;PST	 PST affect V;PST affect V;PST
affect V;V.PTCP;PRS	;PRSaffect V;V.PTCP;PRSaffect 
affect V;V.PTCP;PST	 a f a f a f a f a f a f a f a
affine V;NFIN	e V;NFIN V;NFIN V;NFIN V;NFIN 
affine V;PRS;NOM(3,SG)	 Propionion Propionion Propion
affine V;PST	 P;
PST P;PST P;PST P;PST P;PS
anticipate V;NFIN	anticipate anticipate anticipa
anticipate V;PRS;NOM(3,SG)	erate V;PRS;NOM(3,SG)anticipat
anticipate V;PST	anticipate P;PSTbanticipate P;
anticipate V;V.PTCP;PRS	ate V;V.PTCP;PRSe;PR;Se.PTCPR;
assail V;PRS;NOM(3,SG)	assail V;PRS;NOM(3,SG)assail V
assail V;PST	 PST V;PST V;PST V;PST V;PST V
assail V;V.PTCP;PRS	 March 2017 - Pars : V;V.PTCP;
assail V;V.PTCP;PST	 P;PST;PST.PTCP.PST.PST.PST.PS
atsake V;NFIN	atsake V;NFINe Ne Ne Ne Ne Ne 
atsake V;PRS;NOM(3,SG)	atsake V;PRS;NOM(3,SG)atsake V
atsake V;PST	 PST T PST T PST T PST T PST T
aumail V;NFIN	aumail V;NFINmail V;NFINmail V
aumail V;PRS;NOM(3,SG)	aumail Aumail Aumail Aumail Au
aumail V;V.PTCP;PRS	 P;PTCP;PRSe P;PRSe P;PRSe P;P
babify V;NFIN	bify V.NFINlify V.Nlify V.Nlif
babify V;PRS;NOM(3,SG)	 PRS;NOM(3,SG)V PRS;NOM(3,SG)V
babify V;PST	 PST V PST V PST V PST V PST V
babify V;V.PTCP;PST	 P;PST;PTC;PST.PTCP.ST.PTCP.ST
barhop V;NFIN	arhop V;NFINminminminminminmin
barhop V;PRS;NOM(3,SG)	arhop PRS;NOM(3,SG)garhop PRS;
barhop V;V.PTCP;PRS	 Salah salah lah di salah lah 
base V;NFIN	ase V;NFIN;NFIN;NFIN;NFIN;NFIN
base V;PRS;NOM(3,SG)	e se se se se se se se se se s
base V;PST	ase V;PSTfase V;PSTfase V;PSTf
base V;V.PTCP;PST	 the same as the same as the s
bemaul V;NFIN	maul V;NFINMAUL V;NFINMAUL V;N
bemaul V;PRS;NOM(3,SG)	emaul PRS;NOM(3,SG)aul V;PRS;N
bemaul V;V.PTCP;PRS	 S;PRS S;PRS P;PRS P;PRS P;PRS
bemaul V;V.PTCP;PST	 a a a a a a a a a a a a a a a
beshape V;NFIN	;NFINging and beshpe V;NFINgin
beshape V;PRS;NOM(3,SG)	eshape V;PRS;NOM(3,SG)ape V;PR
beshape V;V.PTCP;PRS	;PRSdirectional control prsdir
beshape V;V.PTCP;PST	eshape V;V.PTCP;PST.PST.PST.PS
bespirt V;NFIN	t V;NFIN N N N N N N N N N N N
bespirt V;PRS;NOM(3,SG)	et bespirt bespirt bespirt bes
bespirt V;V.PTCP;PRS	 t V;V.PTCP;PRSe de flere mate
bespirt V;V.PTCP;PST	 e e e e e e e s t e s t e s t
bioactivate V;NFIN	;NFINzest V;NFINzest V;NFINzes
bioactivate V;PST	 PST V;PST V;PST V;PST V;PST V
bioactivate V;V.PTCP;PRS	;V.PTCP;PRSa;PRSa.PTCP;PRSa.PT
biodegrade V;NFIN	;NFIN;NFIN;NFIN;NFIN;NFIN;NFIN
biodegrade V;PST	ST;PST;PST;PST;PST;PST;PST;PST
biodegrade V;V.PTCP;PRS	;V.PTCP;PRSalient degradation 
biodegrade V;V.PTCP;PST	;V.PTCP;PSTa;PSTa.PTCP;PSTa.PT
biostimulate V;NFIN	identifier V;NFINeuraminidate 
biostimulate V;PRS;NOM(3,SG)	(3,SG)biostimulate V;PRS;NOM(3
biostimulate V;PST	imparted PST and PST and PST a
biostimulate V;V.PTCP;PRS	;V.PTCP;PRSe;V.PTCP;PRSe;V.PTC
bliken V;NFIN	retningsliste med for mer info
bliken V;PST	retter lengter lengter lengter
bliken V;V.PTCP;PRS	 a a a a a a a a a a a a a a a
bliken V;V.PTCP;PST	 og o s t e s t e s t e s t e 
bodysurf V;NFIN	ysurf V;NFINeineineineineinein
bodysurf V;PST	 PST PST PST PST PST PST PST P
bodysurf V;V.PTCP;PST	er V;V.PTCP;PST;PST.PST.PST.PS
brickfilm V;PRS;NOM(3,SG)	(3,SG)ang)ang ang ang ang ang 
brickfilm V;PST	 PST PST PST PST PST PST PST P
brickfilm V;V.PTCP;PRS	 PTCP;PRSee PTCP;PRSee PTCP;PR
brickfilm V;V.PTCP;PST	 PTC PTC PTC PTC PTC PTC PTC P
bulletize V;NFIN	bulltize V;NFINe V;Ne V;Ne V;N
bulletize V;PST	bulltize PSTmatic bulltize PST
bulletize V;V.PTCP;PRS	 bulletize V;V.PTCP;PRSe bulle
bus V;NFIN	s V;NFINmus V;NFINmus V;NFINmu
change V;NFIN	 change V;NFINg V;NFINg V;NFIN
change V;PRS;NOM(3,SG)	e change V;PRS;NOM(3,SG)just c
change V;PST	 PSTg PSTg PSTg PSTg PSTg PSTg
change V;V.PTCP;PST	 series V;V.PTCP;PSTg series V
chequer V;PRS;NOM(3,SG)	 1 2 3 4 5 6 7 8 9 10 11 12 13
chequer V;PST	er V;PST០PST ០PST ០PST 
chequer V;V.PTCP;PRS	 PTCP;PRSai PTCP;PRSai PTCP;PR
chinwag V;NFIN	g V;NFINwag V;NFINwag V;NFINwa
chinwag V;V.PTCP;PRS	ner V;V.PTCP;PRServer V;V.PTCP
chinwag V;V.PTCP;PST	er Schinwag V;V.PTCP;PST.PST.P
chirr V;NFIN	 V;NFINe Ne Ne Ne Ne Ne Ne Ne 
chirr V;PRS;NOM(3,SG)	 Schirr Schirr Schirr Schirr S
chirr V;PST	 PSTer V;PSTer V;PSTer V;PSTer
chirr V;V.PTCP;PRS	;V.PTCP;PRSahirr V;V.PTCP;PRSa
co-locate V;PRS;NOM(3,SG)	 co-locate V;PRS;NOM(3,SG)j co
co-locate V;PST	 predictive V;PST부정형 V;P
co-locate V;V.PTCP;PST	 P;P.PTCP;PST.PTCP;PST.PTCP.PT
codeshare V;NFIN	share codeshare codeshare code
codeshare V;PRS;NOM(3,SG)	eshere V;PRS;NOM(3,SG)jeshere 
codeshare V;V.PTCP;PRS	;V.PTCP;PRSerial no: V;V.PTCP;
codeshare V;V.PTCP;PST	;V.PTCP;PSTkeys V;V.PTCP;PSTke
coimmunoprecipitate V;NFIN	 precipitate V;NFINprecipitate
coimmunoprecipitate V;PRS;NOM(3,SG)	enterococcal V;PRS;NOM(3,SG)an
coimmunoprecipitate V;V.PTCP;PRS	;V.PTCP;PRSa;PRSa.PTCP;PRSa.PT
coimmunoprecipitate V;V.PTCP;PST	 PTCP PST PST PST PST PST PST 
comarket V;PRS;NOM(3,SG)	(3,SG)arket t t t t t t t t t 
comarket V;PST	 PST PST PST PST PST PST PST P
comarket V;V.PTCP;PRS	;V.PTCP;PRSaaS ; V.PTCP;PRSaaS
comarket V;V.PTCP;PST	 P;P.ST;P.ST;P.ST.PTCP;PST;PST
commiserate V;NFIN	ommate commate commate commate
commiserate V;PST	 commiserate commiserate commi
commiserate V;V.PTCP;PRS	 commiserate V;V.PTCP;PRSerate
commiserate V;V.PTCP;PST	 commiserate V;V.PTCP;PST;PST.
compost V;NFIN	 compost V;NFINs V;NFINs V;NFI
compost V;PRS;NOM(3,SG)	ompost V;PRS;NOM(3,SG)jompost 
compost V;PST	ost PSTjost PSTjost PSTjost PS
compost V;V.PTCP;PST	 PTCP;PST V;V.PTCP;PST V.PTCP;
congest V;NFIN	 congest V;NFINe congest V;NFI
congest V;PRS;NOM(3,SG)	(3,SG)g)g;NOM(3,SG)g;NOM(3,SG)
congest V;V.PTCP;PST	 PTCP PST PST PST PST PST PST 
conquer V;PRS;NOM(3,SG)	 PRS;NOM(3,SG)a conquer V;PRS;
conquer V;V.PTCP;PRS	onquer V;V.PTCP;PRSeries of th
conversation V;NFIN	letterie et conversation V;NFI
conversation V;PRS;NOM(3,SG)	;NOM(3,SG)and NOM(3,SG)and NOM
conversation V;V.PTCP;PRS	 2010 1 2 3 4 5 6 7 8 9 10 11 
conversation V;V.PTCP;PST	 PTCP;PSTe PTCP;PSTe PTCP;PSTe
cordon V;PST	 PST T PST T PST T PST T PST T
cordon V;V.PTCP;PRS	;V.PTCP;PRService Cordon V;V.P
cordon V;V.PTCP;PST	 P;P;P.PTCP;P.ST;P.ST.PTCP.ST.
cosponsor V;NFIN	or sponsor V;NFINet sponsor V;
cosponsor V;PRS;NOM(3,SG)	or cosponsor or cosponsor or c
cosponsor V;PST	 PST PST PST PST PST PST PST P
counterindoctrinate V;NFIN	outerindoctrinate V;NFIN;NFIN;
counterindoctrinate V;V.PTCP;PST	 counterindoctrinate V;V.PTCP;
crescendo V;NFIN	anco a caro a caro a caro a ca
crescendo V;PST	 PST PST PST PST PST PST PST P
crescendo V;V.PTCP;PRS	 PTCP;PRService de control de 
crescendo V;V.PTCP;PST	 PTCP;PSTJ aumentando as possi
croggle V;PRS;NOM(3,SG)	R(1,SG)stroggle Stroggle Strog
croggle V;PST	 PST joint the PST joint the P
croggle V;V.PTCP;PRS	 PTCP;PRServer Server Server S
declamate V;PRS;NOM(3,SG)	 declarate V;PRS;NOM(3,SG)and 
declamate V;V.PTCP;PRS	;V.PTCP;PRSeclamate V;V.PTCP;P
declamate V;V.PTCP;PST	;V.PTCP;PSTand declarate V;V.P
decompartmentalize V;NFIN	er V;NFINew V;NFINew V;NFINew 
decompartmentalize V;PST	;PST;PST;PST;PST;PST;PST;PST;P
decompartmentalize V;V.PTCP;PRS	ergic decompartmentalize V;V.P
decompartmentalize V;V.PTCP;PST	ectometrically decompartmental
deconcentrate V;NFIN	 and the concentration of the 
deconcentrate V;PST	 deconcentrate V;PSTn deconcen
deconcentrate V;V.PTCP;PST	 PTCP;PSTn PTCP.PTCP.PTCP.PTCP
defunctionalize V;NFIN	;NFINet;Net;Net;Net;Net;Net;Ne
defunctionalize V;PRS;NOM(3,SG)	errorize defunctionalize defun
defunctionalize V;PST	efunctionalize V;PSTprotein st
defunctionalize V;V.PTCP;PST	;V.PTCP;PSTation defunctionali
degroup V;NFIN	;NFINeighboring group V;NFINei
degroup V;PRS;NOM(3,SG)	(3,SG)group P;PRS;NOM(3,SG)gro
degroup V;PST	 degroup V;PST ;PST ;PST ;PST 
degroup V;V.PTCP;PRS	 and analysis of the V.PTCP;PR
deke V;PRS;NOM(3,SG)	e V;PRS;NOM(3,SG)ve e V;PRS;NO
deke V;PST	e e e e e e e e e e e e e e e 
deke V;V.PTCP;PST	er V;V.PTCP;PST;PST;PST;PST;PS
deliberate V;NFIN	 and the results and the resul
deliberate V;PST	 and the results of the result
deliberate V;V.PTCP;PRS	 PRSe PRSe PRSe PRSe PRSe PRSe
deliberate V;V.PTCP;PST	 PTCP;PST deliberate V;V.PTCP;
delve V;PST	er de la salle de batalha er d
delve V;V.PTCP;PRS	 V;V.PTCP;PRSe V;V.PTCP;PRSe V
delve V;V.PTCP;PST	ere ve V.PTCP;PST.PST.PST.PST.
demorify V;NFIN	emorify N N N N N N N N       
demorify V;PRS;NOM(3,SG)	V;PRS;NOM(3,SG)age demorify V;
demorify V;PST	;PSTvs PSTvs PSTvs PSTvs PSTvs
demorify V;V.PTCP;PST	effect of the participation of
denuclearize V;NFIN	enuclearize V;NFINenuclearize 
denuclearize V;PRS;NOM(3,SG)	arize denuclearize denucleariz
denuclearize V;PST	enuclearize V;PSTnuclearize V;
denuclearize V;V.PTCP;PST	arize V;V.PTCP;PSTarize V;V.PT
deraign V;NFIN	eraign V;NFINFINFINFINFINFINFI
deraign V;PRS;NOM(3,SG)	(3,SG)aign V;PRS;NOM(3,SG)aign
deraign V;PST	PSTE STE STE STE STE STE STE S
deraign V;V.PTCP;PRS	 PTCP;PRSe a part of the PTCP 
destruct V;PRS;NOM(3,SG)	tilization of the control of t
destruct V;PST	tres con parte de destruct V;P
destruct V;V.PTCP;PRS	 V;V.PTCP;PRSestrict V;V.PTCP.
detumesce V;NFIN	etumesce N;NFIN etumesce N;NFI
detumesce V;PRS;NOM(3,SG)	etumesce tumesce tumesce tumes
detumesce V;PST	 V;PST;PST;PST;PST;PST;PST;PST
detumesce V;V.PTCP;PST	este articole de la V . PTCP P
deurbanize V;NFIN	est un peu le destructure de l
deurbanize V;PRS;NOM(3,SG)	established and residentize th
deurbanize V;PST	 deuropenize ;PST ;PST ;PST ;P
deurbanize V;V.PTCP;PRS	english V;V.PTCP;PRSenglish V.
devenustate V;NFIN	evenustate V;NFIN N;NFIN N;NFI
devenustate V;PRS;NOM(3,SG)	estate V;PRS;NOM(3,SG)aestate 
devenustate V;PST	 PST PST PST PST PST PST PST P
devenustate V;V.PTCP;PRS	;V.PTCP;PRSales of the V;V.PTC
dewret V;PRS;NOM(3,SG)	evret V;PRS;NOM(3,SG)wret V;PR
dewret V;V.PTCP;PRS	 P;PRServer P;PRServer P.PTCP;
dewret V;V.PTCP;PST	 P;P.PTCP;P.ST.PTCP.PTCP.PTCP.
digiscope V;PST	 digiscope V;
Digiscope V;
Dig
digiscope V;V.PTCP;PRS	;PRSe V;PTCP.PTCP.PTCP.PTCP.PT
digiscope V;V.PTCP;PST	 PTCP PST PST.PTCP.PST.PST.PST
dishonnour V;NFIN	annour dishonnour dishonnour d
dishonnour V;PRS;NOM(3,SG)	;NOM(3,SG)ashonnour V;PRS;NOM(
dishonnour V;V.PTCP;PRS	allah dishonnour V;V.PTCP;PRSa
dishonnour V;V.PTCP;PST	il dishonnour dishonnour disho
dissettle V;PRS;NOM(3,SG)	(3,SG)and dissettle V;PRS;NOM(
dissettle V;V.PTCP;PRS	 dissettle V;V.PTCP;PRSettle V
dissettle V;V.PTCP;PST	 dissettle V;V.PTCP;PSTgender 
dissonate V;NFIN	 dissonate dissonate dissonate
dissonate V;V.PTCP;PRS	 dissonate V;V.PTCP;PRSate V;V
dissonate V;V.PTCP;PST	 dissonate V;V.PTCP;PSTdissona
disuse V;NFIN	isuse IIIIIIIIIIIIIIIIIIIIIIII
disuse V;PRS;NOM(3,SG)	est tan disuse tan disuse tan 
disuse V;V.PTCP;PST	isuse V.PTCP;PSTbesuse V.PTCP;
dodd V;PRS;NOM(3,SG)	dd odd odd odd odd odd odd odd
dodd V;PST	 PST PST PST PST PST PST PST P
dodd V;V.PTCP;PRS	 2017 | 1 items from cannon sa
dodd V;V.PTCP;PST	 a a a a a a a a a a a a a a a
douche V;NFIN	ouche V;NFINme Nme Nme Nme Nme
douche V;PRS;NOM(3,SG)	;PRS;NOM(3,SG)ausg;nom(3,SG)au
douche V;PST	 douche V;PST V;PST V;PST V;PS
douche V;V.PTCP;PRS	 PTCP PTCP PTCP PTCP PTCP PTCP
downclock V;PRS;NOM(3,SG)	clock upclock upupclock upupcl
downclock V;PST	 1080P 1080P 1080P 1080P 1080P
downclock V;V.PTCP;PRS	compare at 150000 Add at 15000
dram V;NFIN	am V;NFINm V;NFINm V;NFINm V;N
dram V;PRS;NOM(3,SG)	a dram P;PRS;NOM(3,SG)dram P;P
dram V;PST	aram V;PSTj;pstj;pstj;pstj;pst
dram V;V.PTCP;PRS	 0 | Login Music Bonuses | Aug
duress V;NFIN	ress V;NFINess V;Ness V;Ness V
duress V;PRS;NOM(3,SG)	ess PRS;NOM(3,SG)and 3,SG and 
earnest V;PRS;NOM(3,SG)	arnest V;PRS;NOM(3,SG)arnest V
earnest V;V.PTCP;PST	 PTCP PST PST PST PST PST PST 
empassion V;NFIN	mpassion V;NFIN empassion V;NF
empassion V;PRS;NOM(3,SG)	(3,SG)g)empassion PRS;NOM(3,SG
encoach V;PRS;NOM(3,SG)	ach V;PRS;NOM(3,SG)ach V;PRS;N
encoach V;PST	 PST PST PST PST PST PST PST P
encoach V;V.PTCP;PRS	 PTCP;PRSales Teacher PTCP;PRS
enlace V;NFIN	ace V;NFINsenlace V;NFINsenlac
enlace V;PRS;NOM(3,SG)	ante en la calle en la calle e
enlace V;V.PTCP;PRS	;V.PTCP;PRSenlistened to a sea
enlace V;V.PTCP;PST	a en la en la en la en la en l
enrank V;NFIN	 N;NFINen Nen Nen Nen Nen Nen 
enring V;PRS;NOM(3,SG)	 PRS;NOM(3,SG)arts;NOM(3,SG)ar
enring V;PST	 PSTenring V;PSTenring V;PSTen
enring V;V.PTCP;PRS	 PTCP;PRSenring V;V.PTCP;PRSen
ensky V;NFIN	e New V;NFINew V;NFINew V;NFIN
ensky V;PRS;NOM(3,SG)	; PRS;NOM(3,SG)a PRS;NOM(3,SG)
ensky V;PST	 PSTě PSTě PSTě PSTě PSTě
ensky V;V.PTCP;PST	ovicky PTCP;PST.ST.ST.ST.ST.ST
enwisen V;NFIN	enwisen V;NFIN;NFIN;NFIN;NFIN;
enwisen V;PRS;NOM(3,SG)	n wisen wisen wisen wisen wise
enwisen V;V.PTCP;PRS	einer der größeren Den der g
exceed V;NFIN	;NFINs and the last of the tot
exceed V;PRS;NOM(3,SG)	each each each each each each 
exceed V;V.PTCP;PRS	ed V;V.PTCP;PRSed V.PTCP;PRSed
fainten V;PRS;NOM(3,SG)	en de la prendre la prendre la
fainten V;PST	est le produit de la recherche
fainten V;V.PTCP;PRS	 de conservation de la santé 
fainten V;V.PTCP;PST	 les consignes de recherche de
fanaticize V;PRS;NOM(3,SG)	anaticize fanaticize fanaticiz
fanaticize V;V.PTCP;PRS	endant self control and self c
feel V;NFIN	eel V;NFINseel V;NFINseel V;NF
feel V;PRS;NOM(3,SG)	(3,SG)s;NOM(3,SG)s;NOM(3,SG)s;
feel V;V.PTCP;PRS	 a a a a a a a a a a a a a a a
flail V;PST	 PST PST PST PST PST PST PST P
fluff V;NFIN	ff V;NFIN FIN FIN FIN FIN FIN 
fluff V;V.PTCP;PRS	luff V;V.PTCP;PRSelect your fl
flutter V;NFIN	 NFIN NFIN NFIN NFIN NFIN NFIN
flutter V;PRS;NOM(3,SG)	 1 1 1 1 1 1 1 1 1 1 1 1 1 1 1
flutter V;PST	 PST PST PST PST PST PST PST P
flutter V;V.PTCP;PST	ter V;V.PTCP;PSTflutter V;V.PT
forestal V;NFIN	estal V;NFINstal V;NFINstal V;
forestal V;PRS;NOM(3,SG)	a controla reduccion de la cos
forestal V;PST	forestal V;PST. V;PST. V;PST. 
formicate V;NFIN	 Final Formicate V;NFINational
formicate V;V.PTCP;PRS	;V.PTCP;PRSaturn V;V.PTCP;PRSa
formicate V;V.PTCP;PST	 PTCP PTCP PTCP PTCP PTCP PTCP
forthcast V;NFIN	 NFINfinfinfinfinfinfinfinfinf
forthcast V;PRS;NOM(3,SG)	;NOM(3,SG)ast II;PRS;NOM(3,SG)
forthcast V;V.PTCP;PRS	;PRSersonality and the state o
forthcast V;V.PTCP;PST	 PTCP;PSTj PTCP;PSTj PTCP;PSTj
forwrap V;PRS;NOM(3,SG)	wrap and forwrap forwrap and f
forwrap V;V.PTCP;PRS	wrap V;V.PTCP;PRSforwrap V;V.P
forwrap V;V.PTCP;PST	wrap V;V.PTCP;PST.PTCP.ST.PTCP
fraternise V;PST	fraternise V;PSTve PSTve PSTve
fraternise V;V.PTCP;PRS	ernise V;V.PTCP;PRSernise V;V.
fraternise V;V.PTCP;PST	a a a a a a a a a a a a a a a 
frustrate V;PST	ruginthes frustrate frustrate 
frustrate V;V.PTCP;PRS	rectionate V;V.PTCP;PRSerectio
fustigate V;PST	ate V;PST V;PST V;PST V;PST V;
fustigate V;V.PTCP;PRS	;V.PTCP;PRSedited by V;V.PTCP;
fustigate V;V.PTCP;PST	 P;PST P S T P S T P S T P S T
geck V;NFIN	eck V;NFINmeck V;NFINmeck V;NF
geck V;PRS;NOM(3,SG)	eck V;PRS;NOM(3,SG)geck V;PRS;
geck V;V.PTCP;PRS	eck V;V.PTCP;PRS PRS PRS PRS P
geck V;V.PTCP;PST	k V.PTCP;PST;PST.PST.PST.PST.P
germinate V;NFIN	 and the antibiotic and the an
germinate V;PRS;NOM(3,SG)	(3,SG)a(3,SG)a(3,SG)a(3,SG)a(3
germinate V;V.PTCP;PST	;V.PTCP;PSTa;PSTa.PTCP;PSTa.PT
glycolyze V;PRS;NOM(3,SG)	(3,SG)and (3,SG)and (3,SG)and 
glycolyze V;V.PTCP;PST	;PTCP;PST.PST.PST.PST.PST.PST.
graffiti V;PRS;NOM(3,SG)	estiti V;PRS;NOM(3,SG)graffiti
graffiti V;PST	 1 2 3 4 5 6 7 8 9 10 11 12 13
graffiti V;V.PTCP;PRS	;V.PTCP;PRSe;PRSe.PTCP;PRSe.PT
graffiti V;V.PTCP;PST	 PTCP;PST.PTCP;PST.PTCP.STCP;P
grammaticize V;PRS;NOM(3,SG)	rammaticize V;PRS;NOM(3,SG)gra
grammaticize V;PST	;PST V;PST V;PST V;PST V;PST V
grammaticize V;V.PTCP;PRS	 construction of a phonetic sp
grammaticize V;V.PTCP;PST	 V;V.PTCP;PST;PST.PTCP;PST.PTC
grid V;NFIN	rid V;NFINminid V;NFINminid V;
grid V;PRS;NOM(3,SG)	(1,SG)grid V;PRS;NOM(3,SG)grid
grid V;PST	 PST E PST E PST E PST E PST E
grid V;V.PTCP;PST	 P;PST ; PST ; PST ; PST ; PST
grill V;NFIN	ll V;NFINeineineineineineinein
grill V;PRS;NOM(3,SG)	(1,SG)g) 1 2 3 4 5 6 7 7 7 7 7
grill V;PST	ll PSTPSTPSTPSTPSTPSTPSTPSTPST
grill V;V.PTCP;PRS	 1 2 3 4 5 6 7 8 9 10 11 12 13
gub V;PRS;NOM(3,SG)	ub V;PRS;NOM(3,SG)ib V;PRS;NOM
gub V;PST	V. PST V. PST V. PST V. PST V.
gub V;V.PTCP;PRS	adab V;V.PTCP;PRSandang V;V.PT
gub V;V.PTCP;PST	 P;P;P.ST;P.S.T;P.S.T;P.S.T;P.
hand V;PRS;NOM(3,SG)	aman Shankar Shankar Shankar S
hand V;V.PTCP;PRS	and V;V.PTCP;PRServe PTCP;PRSe
hand V;V.PTCP;PST	 Patil V;Patil V.PTCP;PSTᐽ P
happify V;PRS;NOM(3,SG)	the happify and happify and ha
happify V;PST	 Startup Startup Startup Start
happify V;V.PTCP;PST	 P;P;P.ST;P.PTCP;PST.ST;PST.ST
harpoon V;NFIN	 Sharpoon Sharpoon Sharpoon Sh
harpoon V;PRS;NOM(3,SG)	 PRS;NOM(3,SG)g charpoon V;PRS
harpoon V;V.PTCP;PST	 S;S.PTCP;PST;PST;PST;PST;PST;
heli-ski V;NFIN	ki V;NFINELI-ski V;NFINELI-ski
heli-ski V;PST	eli-ski V;PST-ski V;PST-ski V;
heli-ski V;V.PTCP;PRS	;V.PTCP;PRSarge V;V.PTCP;PRSar
heli-ski V;V.PTCP;PST	 s date of biology and biology
hickup V;PRS;NOM(3,SG)	; PRS;NOM(3,SG)and (3,SG)and (
hickup V;PST	 PST PST PST PST PST PST PST P
hickup V;V.PTCP;PST	is not a startup in 2019 marke
high-step V;NFIN	 high-step V;NFINstep V;NFINst
high-step V;PRS;NOM(3,SG)	(3,SG)a,SG)a,SG;NOM(3,SG)a,SG;
high-step V;PST	 P; PST P; PST P; PST P; PST P
high-step V;V.PTCP;PST	igh-step V;V.PTCP;PST;PST.PTCP
hiss V;NFIN	iss V;NFIN N;NFIN N;NFIN N;NFI
hiss V;PST	 s s s s s s s s s s s s s s s
hiss V;V.PTCP;PRS	 C P RS P RS P RS P RS P RS P 
hiss V;V.PTCP;PST	s are all about the product of
hydrolyze V;NFIN	;NFINet and hydrolyze V;Net an
hydrolyze V;PRS;NOM(3,SG)	ydrolyze V;PRS;NOM(3,SG)age 1 
hydrolyze V;V.PTCP;PRS	;PRSales Tags: PTCP;PRSales Ta
hydrolyze V;V.PTCP;PST	 PTCP PTCP PTCP PTCP PTCP PTCP
illure V;V.PTCP;PRS	 PTCP;PRSe contre le contre le
imboil V;NFIN	mboil V;NFINeil V;NFINeil V;NF
imboil V;PRS;NOM(3,SG)	(3,SG)mboil V;PRS;NOM(3,SG)mbo
imboil V;PST	mboil V;PSTEMBOIL V;PSTEMBOIL 
imboil V;V.PTCP;PST	 PTCP;PSTEPSTEPSTEPSTEPSTEPSTE
imbower V;NFIN	mbower V;NFINet Imbower V;NFIN
imbower V;PRS;NOM(3,SG)	 Simbower Simbower Simbower Si
imbower V;V.PTCP;PRS	www.ptcp.prsa.com/ptcp/ptcp.pr
imparl V;PST	 PSTEE E PSTEE E PSTEE E PSTEE
imparl V;V.PTCP;PRS	 PTCP;PRSe don t t t t t t t t
imperialize V;NFIN	;NFINcontentment V;NFINcontent
imperialize V;PRS;NOM(3,SG)	;NOM(3,SG)and 3,SG and 3,SG an
imperialize V;V.PTCP;PRS	ize V;V.PTCP;PRSelect PTCP;PRS
indorse V;NFIN	re indorse V;NFINeindorse V;Ne
indorse V;PRS;NOM(3,SG)	(1,1,1,1,1,1,1,1,1,1,1,1,1,1,1
indorse V;PST	;PST;PST;PST;PST;PST;PST;PST;P
infeeble V;PRS;NOM(3,SG)	 infeeble V;PRS;NOM(3,SG)and i
infeeble V;V.PTCP;PRS	;V.PTCP;PRSeeble V;V.PTCP;PRSe
infumate V;NFIN	infumate V;NFINZ INFUMATE V;NF
infumate V;PRS;NOM(3,SG)	(3,SG)ate V;PRS;NOM(3,SG)ate V
infumate V;PST	 propionic acid V;PST propioni
infumate V;V.PTCP;PRS	;V.PTCP;PRSe;V.PTCP;PRSe.PTCP;
inhere V;NFIN	ere V;NFINsere V;NFINsere V;NF
inhere V;PRS;NOM(3,SG)	e V;PRS;NOM(3,SG)justice V;PRS
inhere V;V.PTCP;PST	e PTCP;PST.PST.PST.PST.PST.PST
instrengthen V;NFIN	then V;NFIN;NFIN;NFIN;NFIN;NFI
instrengthen V;PRS;NOM(3,SG)	then V;PRS;NOM(3,SG)and (3,SG)
instrengthen V;PST	en V;PST instrengthen V;PST in
instrengthen V;V.PTCP;PRS	;PRSent the second set of the 
intergrade V;PRS;NOM(3,SG)	 Saturn is a saturn in the spa
intergrade V;PST	 intergrade V;PSTnergrade V;PS
intergrade V;V.PTCP;PRS	 PTCP;PRSale PTCP;PRSale PTCP;
internetwork V;PRS;NOM(3,SG)	(3,SG)and the internet of thin
internetwork V;V.PTCP;PRS	network V;V.PTCP;PRSenetwork V
internetwork V;V.PTCP;PST	 PTCP;PSTattoo PTCP;PSTattoo P
interplay V;NFIN	 interplay V;NFINerplay V;Nerp
interplay V;PRS;NOM(3,SG)	(3,SG);NOM(3,SG);NOM(3,SG);NOM
interplay V;V.PTCP;PRS	 PRS PRS PRS PRS PRS PRS PRS P
interplay V;V.PTCP;PST	 PTCP PTCP PTCP PTCP PTCP PTCP
interpoint V;NFIN	 Strobosome Strobosome Strobos
interpoint V;V.PTCP;PRS	 PTCP;PRSalient PTCP;PRSalient
interpoint V;V.PTCP;PST	 PTCP PTCP PTCP PTCP PTCP PTCP
jetski V;NFIN	etski V;NFINetski V;NFINetski 
jetski V;V.PTCP;PRS	i V;V.PTCP;PRSekundari s domas
jetski V;V.PTCP;PST	etski V;V.PTCP;PST.PTCP.STCP.S
jockey V;PRS;NOM(3,SG)	(1,TG)and (1,SG)and (1,SG)and 
jockey V;V.PTCP;PRS	wikipedia- https://www.google.
jockey V;V.PTCP;PST	er V;V.PTCP;PST;PST.PTCP;PST.P
joke V;NFIN	oke V;NFINE NFINE NFINE NFINE 
joke V;PRS;NOM(3,SG)	e PRS;NOM(3,SG)joke PRS;NOM(3,
joke V;PST	 PST PST PST PST PST PST PST P
juice V;NFIN	 and NFIN juice V;NFIN juice V
juice V;PRS;NOM(3,SG)	 PRS;NOM(3,SG)and NOM(3,SG)and
juice V;V.PTCP;PST	 and an anniversary anniversar
knuckleball V;NFIN	knuckleball V;NFINsinsinsinsin
knuckleball V;PRS;NOM(3,SG)	; PRS;NOM(3,SG)all V;PRS;NOM(3
knuckleball V;PST	knuckleball V;PST V;PST V;PST 
knuckleball V;V.PTCP;PST	nuckleball V;V.PTCP;PSTmaster 
laud V;V.PTCP;PRS	 Parker Parker Parker Parker P
laud V;V.PTCP;PST	aaaamiaa aaa aaa aaa aaa aaa a
lave V;NFIN	 V;NFINe V;NFINe V;NFINe V;NFI
lave V;PRS;NOM(3,SG)	ave V;PRS;NOM(3,SG)ave V;PRS;N
lave V;PST	 PSTJ PSTJ PSTJ PSTJ PSTJ PSTJ
lave V;V.PTCP;PRS	 1 2 3 4 5 6 7 8 9 10 11 12 13
lear V;NFIN	 Strain of the V;NFINet Strain
lear V;V.PTCP;PRS	 P;P.PTCP;P.R.Salinized PTCP;P
legislate V;NFIN	ate V;NFINegislate V;NFINegisl
legislate V;PST	 ; PST ; PST ; PST ; PST ; PST
legislate V;V.PTCP;PRS	;prseed legislation and legisl
legislate V;V.PTCP;PST	ate V;V.PTCP;PSTg V.PTCP;PSTg 
livetweet V;NFIN	inet livetweet V;NFINet livetw
livetweet V;PRS;NOM(3,SG)	itao sheng hao tao tao tao tao
livetweet V;PST	;PSTJ;PSTSTJ;PSTSTJ;PSTSTJ;PST
livetweet V;V.PTCP;PST	 PTC P ST P S T P S T P S T P 
loun V;PRS;NOM(3,SG)	 PRS;NOM(3,SG)a PRS;NOM(3,SG)a
loun V;PST	 2019-04-11 10:04:00 V;PST;PST
loun V;V.PTCP;PRS	 1 2 3 4 5 6 7 8 9 10 11 12 13
loun V;V.PTCP;PST	 professions de la semence de 
lush V;NFIN	 V;NFIN V;NFIN V;NFIN V;NFIN V
lush V;PRS;NOM(3,SG)	 Sh P P S P S P S P S P S P S 
lush V;V.PTCP;PRS	 PTCP;PRS S S S S S S S S S S 
machicolate V;PRS;NOM(3,SG)	machicolate V;PRS;NOM(3,SG)NOM
machicolate V;PST	machicolate V;PSTamachicolate 
machicolate V;V.PTCP;PRS	;V.PTCP;PRSalicylic acid V;V.P
machicolate V;V.PTCP;PST	ate V;V.PTCP;PSTate V;V.PTCP;P
mactate V;PRS;NOM(3,SG)	mactate V;PRS;NOM(3,SG,NOM(3,S
mactate V;PST	mactate V;PST;ST;ST;ST;ST;ST;S
mactate V;V.PTCP;PRS	mactate V;V.PTCP;PRS;PRS;PRS;P
mactate V;V.PTCP;PST	mactate V;V.PTCP;PST;PST.PST;P
mand V;NFIN	mamand V;NFIN;NFIN;NFIN;NFIN;N
mand V;PST	PSTjpstjpstjpstjpstjpstjpstjps
mand V;V.PTCP;PRS	 categories research and resea
mand V;V.PTCP;PST	 PTCP;PSTg PTCP;PSTg PTCP;PSTg
maternalize V;NFIN	eralize V;NFINetNetNetNetNetNe
maternalize V;PRS;NOM(3,SG)	maternalize V;PRS;NOM(3,SG)ate
maternalize V;V.PTCP;PRS	e V.PTCP;PRSe V.PTCP;PRSe V.PT
maternalize V;V.PTCP;PST	entertain V.V.PTCP;PSTby V.PTC
meach V;PRS;NOM(3,SG)	aistritheoir chórais chórais
meach V;PST	 PST PST PST PST PST PST PST P
meach V;V.PTCP;PRS	 - Comh faid thigh a chuireach
meach V;V.PTCP;PST	 a bhaineaí dhíolacháin an 
mirk V;NFIN	mirk V;NINmirk V;NINmirk V;NIN
mirk V;PRS;NOM(3,SG)	(3,SG)irkmirkmirkmirkmirkmirkm
mirk V;PST	;PST; PST; PST; PST; PST; PST;
mirk V;V.PTCP;PRS	;V.PTCP;PRSalg V;V.PTCP;PRSalg
misken V;NFIN	 Nen Nen Nen Nen Nen Nen Nen N
misken V;PST	 PST PST PST PST PST PST PST P
misken V;V.PTCP;PRS	 sken V;V.PTCP;PRSen V;V.PTCP;
misstructure V;NFIN	;NFINg V;NFINg V;NFINg V;NFINg
misstructure V;PRS;NOM(3,SG)	;NOM(3,SG)and NOM(3,SG)and NOM
misstructure V;V.PTCP;PST	e PTCP PST PST PST PST PST PST
misvalue V;NFIN	and a series of parallels and 
misvalue V;PST	 PST;PST;PST;PST;PST;PST;PST;P
misvalue V;V.PTCP;PRS	 a s a s a s a s a s a s a s a
misvalue V;V.PTCP;PST	allowant to to to to to to to 
mold V;PST	 PSTfold PSTfold PSTfold PSTfo
mongrelize V;NFIN	elize V;NFINFINFINFINFINFINFIN
mongrelize V;PRS;NOM(3,SG)	(3,SG) mongrelize V;PRS;NOM(3,
mongrelize V;PST	enteromongrelize V;PST V;PST V
mongrelize V;V.PTCP;PRS	;V.PTCP;PRS;V.PTCP;PRS;V.PTCP;
mounch V;NFIN	 See the following the followi
mounch V;V.PTCP;PST	 PTCP PST PST PST PST PST PST 
nasalise V;NFIN	nasalise V;NFIN;NFIN;NFIN;NFIN
nasalise V;PRS;NOM(3,SG)	(3,SG)nasalise V;PRS;NOM(3,SG)
nasalise V;PST	alise V;PSTalise V;PSTalise V;
nasalise V;V.PTCP;PST	alise V;V.PTCP;PST.PTCP;PST.PT
newname V;NFIN	ewname V;NFINsewname V;NFINsew
newname V;PRS;NOM(3,SG)	ewname newname newname newname
newname V;PST	age 1970-1979 newname V;PST지
newname V;V.PTCP;PST	entry 1990 1991 1992 1992 1992
obdure V;NFIN	bdure V;NFINle bdure V;NFINle 
obdure V;PST	bdure V;PSTve PSTve PSTve PSTv
obdure V;V.PTCP;PRS	 PTCP;PRSent obdure V;V.PTCP;P
obdure V;V.PTCP;PST	 P;PSTbdure V.PTCP;PSTbdure V.
obsolete V;NFIN	obsolete V;NFINe obsolete V;Ne
obsolete V;PRS;NOM(3,SG)	(3,SG)obsolete PRS;NOM(3,SG)ob
obsolete V;PST	 observanti e observante V;PST
obsolete V;V.PTCP;PRS	;prsent observance of observan
outbud V;NFIN	 outbud V;NFINstitute V;NFINst
outbud V;PRS;NOM(3,SG)	 outbud outbud outbud outbud o
outbud V;V.PTCP;PRS	 2017 2018 2019 2019 2019 2019
outbud V;V.PTCP;PST	 PTCP;PSTmanagement PTCP;PSTma
outduel V;NFIN	duel outduel outduel outduel o
outduel V;PRS;NOM(3,SG)	duel outduel outduel outduel o
outduel V;V.PTCP;PST	 outduel V;V.PTCP;PST.PTCP;PST
outgush V;PRS;NOM(3,SG)	(3,SG)outgush V;PRS;NOM(3,SG)o
outgush V;PST	; PST Tv PST Tv PST Tv PST Tv 
outgush V;V.PTCP;PRS	 PRSe with prse prse prse prse
outgush V;V.PTCP;PST	 PTCP;PST.PST.PST.PST.PST.PST.
outjuggle V;NFIN	 New Youtube Soutjuggle Soutju
outjuggle V;PRS;NOM(3,SG)	;NOM(3,TG)juggle outjuggle out
outjuggle V;PST	; PST PST PST PST PST PST PST 
outjuggle V;V.PTCP;PRS	 prserserserserserserserserser
outplace V;NFIN	 No competition outplace V;NFI
outplace V;PRS;NOM(3,SG)	;NOM(3,SG)and NOM(3,SG)and NOM
outplace V;PST	 STATE STATE STATE STATE STATE
outplace V;V.PTCP;PRS	;PRSent a free start of a star
outwin V;NFIN	 China Household Stock Co.,ltd
outwin V;PRS;NOM(3,SG)	utwin PRS;NOM(3,SG)and;NOM(3,S
outwin V;V.PTCP;PST	 P;P.PTCP;PST.PTCP;PST.PTCP.PT
overdot V;NFIN	 V;NFINFINFINFINFINFINFINFINFI
overdot V;PST	 PST PST PST PST PST PST PST P
overdot V;V.PTCP;PRS	;V.PTCP;PRSartorius V;V.PTCP;P
overdot V;V.PTCP;PST	 PTCP PTCP PTCP PTCP PTCP PTCP
overexpose V;NFIN	;NFINsee V;NFINsee V;NFINsee V
overexpose V;PST	 ; ; ; ; ; ; ; ; ; ; ; ; ; ; ;
overexpose V;V.PTCP;PST	;V.PTCP;PST;PTC.PTCP.ST;ST.PTC
overgloom V;NFIN	om V;NFINsinsinsinsinsinsinsin
overgloom V;PRS;NOM(3,SG)	 GLOOM GLOOM GLOOM GLOOM GLOOM
overgloom V;PST	 PSTj PSTj PSTj PSTj PSTj PSTj
overgloom V;V.PTCP;PST	 overgloom overgloom overgloom
overgrow V;PRS;NOM(3,SG)	 SG SG SG SG SG SG SG SG SG SG
overgrow V;V.PTCP;PRS	;V.PTCP;PRSname V;V.PTCP;PRSna
overplow V;NFIN	;NFINerplow V;NFINerplow V;NFI
overplow V;PST	 PST PST PST PST PST PST PST P
overplow V;V.PTCP;PRS	 PTCP;PRSan V;PTCP;PRSan V.PTC
overplow V;V.PTCP;PST	er PTCP PST PST PST PST PST PS
overpublicize V;NFIN	erpublicize V;NFINerpublicize 
overpublicize V;V.PTCP;PRS	erpublicize V;V.PTCP;PRSerpubl
overpublicize V;V.PTCP;PST	 V;V.PTCP;PST.PTCP;PST.PTCP.PT
overreckon V;NFIN	reckon V;NFINerreckon V;NFINer
overreckon V;PRS;NOM(3,SG)	reckon PRS;NOM(3,SG)just as a 
overreckon V;PST	reckon PST PST PST PST PST PST
overreckon V;V.PTCP;PRS	reckon V;V.PTCP;PRS;PRS;PRS;PR
overtask V;NFIN	rtask V;NFINs V;NFINs V;NFINs 
overtask V;PRS;NOM(3,SG)	(3,SG)sk PRS;NOM(3,SG)sk PRS;N
overtask V;V.PTCP;PRS	;v.ptcp;prsentask V;v.ptcp;prs
overtask V;V.PTCP;PST	 P;P.STJ.PTCP;PSTJ.PTCP.STJ.PT
overwater V;NFIN	 overwind overwind overwind ov
overwater V;PST	erwood overwiert overwiert ove
palatalize V;NFIN	; NFINew York Youth Youth Yout
palatalize V;PST	alatalize V;PST V;PST V;PST V;
palatalize V;V.PTCP;PRS	;PRService all rights reserved
palatalize V;V.PTCP;PST	alatalize P;P.PTCP;PST;PTCP.PT
paralyze V;NFIN	e V;NFINFINFINFINFINFINFINFINF
paralyze V;PRS;NOM(3,SG)	y paralyze V;PRS;NOM(3,SG)and 
paralyze V;V.PTCP;PRS	enterocerebellar cell paralyze
parboil V;NFIN	arboil V;NFINeil V;Neil V;Neil
parboil V;PRS;NOM(3,SG)	arboil PRS;NOM(3,SG)arboil PRS
parboil V;V.PTCP;PRS	 Parboil V;V.PTCP;PRSe parboil
parboil V;V.PTCP;PST	 P;P.PTCP;PSTj P;P.PTCP.PTCP.P
pauperise V;PRS;NOM(3,SG)	interesse P;PRS;NOM(3,SG)junct
pauperise V;PST	auperise V;PST j PST j PST j P
pauperise V;V.PTCP;PRS	a pauperise V;V.PTCP;PRSe V.PT
pauperise V;V.PTCP;PST	a pauperise V;V.PTCP;PST.PST.P
perhorresce V;PRS;NOM(3,SG)	;NOM(3,SG)generalis PRS;NOM(3,
perhorresce V;PST	 perhorror sce V;PST horror sc
perhorresce V;V.PTCP;PRS	;PRSe PTCP;PRSe PTCP;PRSe PTCP
perhorresce V;V.PTCP;PST	;V.PTCP;PST.PTCP;PST.PTCP.PTCP
phosphorylate V;NFIN	 New New New New New New New N
phosphorylate V;V.PTCP;PST	;V.PTCP;PSTa;PSTa.PTCP;PSTa.PT
piggyback V;PRS;NOM(3,SG)	(3,SG)and (3,SG)and (3,SG)and 
piggyback V;PST	beck V;PSTə
PSTə
PSTə
PSTə
piggyback V;V.PTCP;PRS	;prsn;prsn.ptcp;prsn.ptcp;prsn
piggyback V;V.PTCP;PST	back piggyback piggyback piggy
politize V;NFIN	ize V;NFINcollege Ncollege Nco
politize V;PST	 ; PST ; PST ; PST ; PST ; PST
politize V;V.PTCP;PST	internationalist democratise V
polycondense V;NFIN	erythritosis resistant and pol
polycondense V;PRS;NOM(3,SG)	(3,SG)j;NOM(3,SG)j;NOM(3,SG)j;
polycondense V;PST	 polycondycondycondycondycondy
polycondense V;V.PTCP;PST	;V.PTCP;PSTags: PTCP;PSTags: P
polytenize V;NFIN	 Polytenize V;NFINeness Polyte
polytenize V;PRS;NOM(3,SG)	(3,SG)and a polytenize a polyt
polytenize V;V.PTCP;PST	analytical and analytical and 
pork V;PST	 PST PST PST PST PST PST PST P
pork V;V.PTCP;PRS	 2019 | Author keywords color 
pork V;V.PTCP;PST	 P;PTCP;PSTG PSTG PSTG PSTG PS
pouch V;NFIN	ouch V;NFINternal Field V;NFIN
pouch V;PST	 V;
PST V;
PST V;
PST V;
PST V
pouch V;V.PTCP;PRS	;V.PTCP;PRSaud V;V.PTCP;PRSaud
pouch V;V.PTCP;PST	 Pouch Pouch Pouch Pouch Pouch
practicalize V;NFIN	alize V;NFINcalize V;NFINcaliz
practicalize V;PRS;NOM(3,SG)	;NOM(3,SG)and practicalize V;P
practicalize V;PST	;PST;PST;PST;PST;PST;PST;PST;P
practicalize V;V.PTCP;PRS	alize V;V.PTCP;PRService V;V.P
praise V;NFIN	aise V;NFIN praise V;NFIN prai
praise V;V.PTCP;PST	 Praise Praise Praise Praise P
predicate V;NFIN	est predicate V;NFIN;NFIN;NFIN
predicate V;V.PTCP;PRS	end predicate V;V.PTCP;PRSend 
preprogram V;NFIN	er V;NFIN;NFIN;NFIN;NFIN;NFIN;
preprogram V;PRS;NOM(3,SG)	reprogram PRS;NOM(3,SG)gram PR
preprogram V;V.PTCP;PRS	 PTCP PRSnew technology prepro
preprogram V;V.PTCP;PST	ografie PTCP PST PST PST PST P
preseed V;NFIN	eed preseed preseed preseed pr
preseed V;PRS;NOM(3,SG)	RESEED PRESEED PRESEED PRESEED
preseed V;PST	 PST PST PST PST PST PST PST P
preseed V;V.PTCP;PST	 PTCP;PST.PTCP;PST.PTCP.PTCP.P
preshow V;PST	 PST PST PST PST PST PST PST P
preshow V;V.PTCP;PRS	.PTCP;PRSd.PTCP;PRSd.PTCP;PRSd
preshow V;V.PTCP;PST	allow preshow V;V.PTCP;PST pre
pretest V;PRS;NOM(3,SG)	est pretest pretest pretest pr
pretest V;PST	retest PST PST PST PST PST PST
pretest V;V.PTCP;PRS	;PTCP;PRSaturated for pretest 
pretest V;V.PTCP;PST	 the pretest V;V.PTCP;PST.PTCP
proclaime V;NFIN	est proclaime V;NFINg proclaim
proclaime V;V.PTCP;PST	 proclaime V;V.PTCP;PST;PST.PT
protocol V;PRS;NOM(3,SG)	 PRS PRS PRS PRS PRS PRS PRS P
protocol V;PST	 protocol V;PST형 PST형 PST
protocol V;V.PTCP;PRS	 PTCP PRSn prsn prsn prsn prsn
provinciate V;NFIN	e provinciate V;NFINsinte prov
provinciate V;PST	e provinciate V;PST V;PST V;PS
provinciate V;V.PTCP;PRS	ate V;V.PTCP;PRSe V;V.PTCP;PRS
provinciate V;V.PTCP;PST	a provinciate V;V.PTCP;PST.PTC
re-dye V;NFIN	e Dye Dye Dye Dye Dye Dye Dye 
re-dye V;PST	e-dye re-dye re-dye re-dye re-
re-dye V;V.PTCP;PRS	;PRSe dye V;PRSe dye V;PRSe dy
re-dye V;V.PTCP;PST	e dye dye dye dye dye dye dye 
re-use V;NFIN	;NFINGINGINGINGINGINGINGINGING
re-use V;PRS;NOM(3,SG)	(3,SG)3,SG)3,SG)3,SG)3,SG)3,SG
re-use V;PST	 PST PST PST PST PST PST PST P
re-use V;V.PTCP;PRS	 PRServer use V;V.PTCP;PRServe
rearrest V;NFIN	arrearrearrearrearrearrearrear
rearrest V;V.PTCP;PRS	;PRSearrest V;V.PTCP;PRSearres
redemand V;NFIN	 ;NFINe ;Ne ;Ne ;Ne ;Ne ;Ne ;N
redemand V;V.PTCP;PRS	;V.PTCP;PRSgredemand V;V.PTCP;
redemand V;V.PTCP;PST	eur de la part de PTCP;PST;PST
redline V;PST	 PST PST PST PST PST PST PST P
redline V;V.PTCP;PST	 P;PST Production P;PST.PTC P;
refamiliarize V;NFIN	efamiliarize V;NFINefamiliariz
refamiliarize V;PRS;NOM(3,SG)	economically refamiliarize V;P
refamiliarize V;PST	efamiliarize V;PSTbrefamiliari
refamiliarize V;V.PTCP;PRS	ectorialize V;V.PTCP;PRSectori
refold V;PRS;NOM(3,SG)	(3,SG)arefold V;PRS;NOM(3,SG)a
refold V;PST	d V;PSTjrefold V;PSTjrefold V;
refold V;V.PTCP;PRS	 date is 2009-09-20 10:00:00 U
refold V;V.PTCP;PST	 transcript and preview transc
regale V;NFIN	e V;NFINMINMINMINMINMINMINMINM
regale V;PRS;NOM(3,SG)	PRS;NOM(3,SG)gale V;PRS;NOM(3,
regale V;V.PTCP;PRS	;V.PTCP;PRSales de la section 
regale V;V.PTCP;PST	anne de la regale V;V.PTCP;PST
regiment V;PST	est le regiment de regiment de
regiment V;V.PTCP;PST	 PTCP PST PTCP PTCP PTCP PTCP 
rehybridize V;NFIN	erythrinize V;NFINerythrinize 
rehybridize V;PRS;NOM(3,SG)	Para(3,SG)a(3,SG)a(3,SG)a(3,SG
rehybridize V;PST	epihybe V;PST V;PST V;PST V;PS
rehybridize V;V.PTCP;PRS	epigenesis prehybridize V;V.PT
reinsulate V;NFIN	; FIN ; FIN ; FIN ; FIN ; FIN 
reinsulate V;V.PTCP;PST	 PTCP;PSTn PSTn PTCP;PSTn PTCP
relodge V;NFIN	;NFINEINEINEINEINEINEINEINEINE
relodge V;PST	 Relodge V;PST V;PST V;PST V;P
relodge V;V.PTCP;PRS	www.bestmotels.com/booking.htm
relodge V;V.PTCP;PST	;V.PTCP;PST.PTCP.PTCP.PTCP.PTC
remodel V;PRS;NOM(3,SG)	emodel V;PRS;NOM(3,SG)aremodel
remodel V;PST	articles 1 2 3 4 5 6 7 8 9 10 
remodel V;V.PTCP;PRS	 PTCP;PRSale PRSale PRSale PRS
remodel V;V.PTCP;PST	 PTCP;PSTg PSTg PSTg PSTg PSTg
renaturalize V;NFIN	alize V;NFINetherlands V;NFINe
renaturalize V;PRS;NOM(3,SG)	enationalize V;PRS;NOM(3,SG)an
renaturalize V;V.PTCP;PRS	alize V;V.PTCP;PRSalize V;V.PT
renaturalize V;V.PTCP;PST	enationalize V;V.PTCP;PST.PTCP
reperuse V;NFIN	e N;N;N;N;N;N;N;N;N;N;N;N;N;N;
reperuse V;PRS;NOM(3,SG)	(3,SG)3,SG)3,SG 3,SG 4,SG 5,SG
reperuse V;PST	eruse PST PST PST PST PST PST 
reperuse V;V.PTCP;PST	eruse P;P.PTCP;PST;PSS.PTCS.PT
repipe V;NFIN	e peripheral peripheral periph
repipe V;PRS;NOM(3,SG)	PRS(1,SG) PRS(1,SG) PRS(1,SG) 
repipe V;V.PTCP;PST	 prepipe V;V.PTCP;PST.PST.PST.
repopularise V;NFIN	;NFINepopularise V;Nepopularis
repopularise V;PST	 PSTB PSTB PSTB PSTB PSTB PSTB
repopularise V;V.PTCP;PRS	erepopularise V;V.PTCP;PRSerep
repopularise V;V.PTCP;PST	establishes and repopularise V
repot V;NFIN	ot V;NFINminminminminminminmin
repot V;PST	 PST T V;PST T V;PST T V;PST T
repot V;V.PTCP;PRS	 P;PRSa P;PRSa P;PRSa P;PRSa P
repot V;V.PTCP;PST	epot V;V.PTCP;PSTj;PSTj. PTCP 
reprice V;NFIN	eprice V;NFIN price V;NFIN pri
reprice V;PRS;NOM(3,SG)	est price of the market in the
reprice V;V.PTCP;PRS	end of the beginning of the be
reprice V;V.PTCP;PST	 Preprice V;V.PTCP;PSTglobal M
reprogramme V;NFIN	lecture de l'automne de l'ann
reprogramme V;PRS;NOM(3,SG)	ing V;PRS;NOM(3,SG)a PRS;NOM(3
reprogramme V;V.PTCP;PRS	eur de compte sur le programme
reprogramme V;V.PTCP;PST	europe V;V.PTCP;PST;PST.PTCP;P
resent V;PST	 PST PST PST PST PST PST PST P
resent V;V.PTCP;PRS	 present V;V.PTCP;PRSness pres
resent V;V.PTCP;PST	 PTCP;PSTgo to school PTCP;PST
revector V;NFIN	ector V;NFIN FIN FIN FIN FIN F
revector V;PRS;NOM(3,SG)	ector PRS;NOM(3,SG)and revecto
revector V;PST	 PST PST PST PST PST PST PST P
revector V;V.PTCP;PST	and the prevector V;V.PTCP;PST
rewetten V;NFIN	 V;NFINg FINg FINg FINg FINg F
rewetten V;PST	etten P;ST;PST;PST;PST;PST;PST
rewetten V;V.PTCP;PRS	en V;V.PTCP;PRSeiten V;V.PTCP;
rewetten V;V.PTCP;PST	en V;V.PTCP;PST;PST.PTCP;PST.P
rigidize V;NFIN	 III; IIIIIIIIIIIIIIIIIIIIIIII
rigidize V;PRS;NOM(3,SG)	(3,SG)rigidize V;PRS;NOM(3,SG)
rigidize V;V.PTCP;PRS	entrance P;PRSentrance P;PRSen
rigidize V;V.PTCP;PST	ing P;PST;PST.PTCP;PST.PTCP.ST
roadshow V;PRS;NOM(3,SG)	(3,SG)a(3,SG)a(3,SG)a(3,SG)a(3
roadshow V;PST	 PST PST PST PST PST PST PST P
roadshow V;V.PTCP;PRS	;PRSfefefefefefefefefefefefefe
roadshow V;V.PTCP;PST	the roadshow the roadshow the 
romanticise V;NFIN	 N;NFIN;NFIN;NFIN;NFIN;NFIN;NF
romanticise V;PRS;NOM(3,SG)	 romanticise V;PRS;NOM(3,SG)an
romanticise V;V.PTCP;PRS	e V;V.PTCP;PRSe V.PTCP;PRSe V.
romanticise V;V.PTCP;PST	 PTCP;PST.PTCP;PST.PTCP;PST.PT
rong V;NFIN	 trong N;NFIN;N;N;N;N;N;N;N;N;
rong V;PRS;NOM(3,SG)	a PRS;NOM(3,SG)jong PRS;NOM(3,
rong V;V.PTCP;PRS	 hao hao yang sang suo hao yan
rong V;V.PTCP;PST	 cartoon cartoon cartoon carto
ross V;NFIN	 V;NFINew V;New V;New V;New V;
ross V;PRS;NOM(3,SG)	RSS PRS PRS PRS PRS PRS PRS PR
ross V;PST	 : 0 0 0 0 0 0 0 0 0 0 0 0 0 0
roughen V;NFIN	 the roughen the roughen the r
roughen V;PRS;NOM(3,SG)	 PRS PRS PRS PRS PRS PRS PRS P
roughen V;V.PTCP;PST	 the star of the star of the s
roundtrip V;NFIN	 N;N;N;N;N;N;N;N;N;N;N;N;N;N;N
roundtrip V;PST	;PST PST PST PST PST PST PST P
roundtrip V;V.PTCP;PRS	 PRS and PRS and PRS and PRS a
sail V;PRS;NOM(3,SG)	ail V;PRS;NOM(3,SG)ail V;PRS;N
sail V;PST	;PSTM;PSTM;PSTM;PSTM;PSTM;PSTM
sail V;V.PTCP;PRS	 a a a a a a a a a a a a a a a
sap V;V.PTCP;PRS	 P;PRSg P;PRSg P;PRSg P;PRSg P
sap V;V.PTCP;PST	 a a b a b a b a b a b a b a b
sardine V;NFIN	 NFINe V;NFINe V;NFINe V;NFINe
sardine V;PRS;NOM(3,SG)	 1 1 1 1 1 1 1 1 1 1 1 1 1 1 1
sardine V;PST	 V;PSTV;PSTV;PSTV;PSTV;PSTV;PS
sardine V;V.PTCP;PST	 V;V.PTCP;PST.ST.;PST.ST.PTCP.
scapegoat V;NFIN	at V;NFINew York Times New Zea
scapegoat V;PRS;NOM(3,SG)	(3,SG)ascapegoat V;PRS;NOM(3,S
scapegoat V;V.PTCP;PRS	 PTCP PRSales PTCP PRSales PTC
scapegoat V;V.PTCP;PST	 P;P.STJ PST PST PST PST PST P
scone V;NFIN	e V;NFINe V;NFINe V;NFINe V;NF
scone V;PRS;NOM(3,SG)	PRS;NOM(3,SG)jPRS;NOM(3,SG)jPR
scone V;PST	 Scone V;PST - PST - PST - PST
scone V;V.PTCP;PST	 Parte da Parte da V;Parte da 
season V;NFIN	season IV;NFINfiNfiNfiNfiNfiNf
season V;PST	eason V;PST season V;PST seaso
season V;V.PTCP;PRS	eason V;V.PTCP;PRSkin color V;
season V;V.PTCP;PST	eason V.PTCP;PST5.PTCP
PTCP se
seceed V;PRS;NOM(3,SG)	(3,SG)d ceedd ceedd ceedd ceed
seceed V;PST	eceed eed eed eed eed eed eed 
seceed V;V.PTCP;PRS	eceed V;V.PTCP;PRSECEED V;V.PT
seceed V;V.PTCP;PST	eed eed eed eed eed eed eed ee
sheal V;NFIN	heal V;NFINsheal V;NFINsheal V
sheal V;PRS;NOM(3,SG)	 Sheal V;PRS;NOM(3,SG)j Sheal 
sheal V;PST	al V;PST 1000 V;PST 1000 V;PST
sheal V;V.PTCP;PST	er S;S.PTCP;PST.PST.PST.PST.PS
sie V;NFIN	 V;NFINE V;NFINE V;NFINE V;NFI
sie V;PST	 V;PSTęPSTęPSTęPSTęPSTęPS
sie V;V.PTCP;PRS	 P;PRS P;PRS S;PRS S;PRS S;PRS
sie V;V.PTCP;PST	 i d a p a p a p a p a p a p a
slick V;NFIN	 No Production Slick No Produc
slick V;PST	 PST T PST T PST T PST T PST T
slick V;V.PTCP;PST	length 1000 1000 1000 1000 100
smirk V;NFIN	mirk V;NFINsmirk V;NfiNsmirk V
smirk V;PRS;NOM(3,SG)	(3,RG)smirk PRS;NOM(3,SG)smirk
smirk V;V.PTCP;PRS	mirk V;V.PTCP;PRSamirk V.PTCP;
smush V;NFIN	 V;NFINe V;NFINe V;NFINe V;NFI
smush V;PST	 PSTjar PSTjar PSTjar PSTjar P
smush V;V.PTCP;PRS	 PRSamush V;V.PTCP;PRSamush V.
softload V;NFIN	oftload V;NFINFINFINFINFINFINF
softload V;PRS;NOM(3,SG)	oftload softload softload soft
softload V;PST	 softload softload softload so
softload V;V.PTCP;PRS	oftload V;V.PTCP;PRServer soft
somnambulate V;PRS;NOM(3,SG)	(3,SG)a(3,SG)a(3,SG)a(3,SG)a(3
somnambulate V;PST	a carinate V;PSTq paracarinate
somnambulate V;V.PTCP;PRS	;PRSa;PRSa.PTCP;PRSa.PTCP.PTCP
somnambulate V;V.PTCP;PST	 parallel structures and subco
spile V;NFIN	 spille V;NFINFINfinfinfinfinf
spile V;PRS;NOM(3,SG)	e spile spile spile spile spil
spile V;PST	er på lager 2019 Deltag i det
spile V;V.PTCP;PRS	ende spille V;V.PTCP;PRSalg af
staddle V;NFIN	taddle V;NFIN N;NFIN N;NFIN N;
staddle V;PRS;NOM(3,SG)	the staddle V;PRS;NOM(3,SG)and
staddle V;V.PTCP;PRS	;V.PTCP;PRSe;PRSe.PRSe.PRSe.PR
starburst V;PRS;NOM(3,SG)	 Starburst Starburst Starburst
starburst V;PST	 PST PST PST PST PST PST PST P
starburst V;V.PTCP;PRS	;V.PTCP;PRSe;PRSe;PRSe;PRSe;PR
stark V;NFIN	 New Start of the Start of the
stark V;PRS;NOM(3,SG)	ark V;PRS;NOM(3,SG)ark V;PRS;N
stark V;PST	 PST PST PST PST PST PST PST P
stark V;V.PTCP;PRS	;V.PTCP;PRServer V;V.PTCP;PRSe
sternutate V;PRS;NOM(3,SG)	e V;PRS;NOM(3,SG)ate V;PRS;NOM
sternutate V;PST	 PST PST PST PST PST PST PST P
sternutate V;V.PTCP;PRS	 PTCP;PRSalata V;V.PTCP;PRSala
sternutate V;V.PTCP;PST	 PTCP;PSTernutate P;PSTernutat
storm V;NFIN	 Storm V;NFINe Storm V;NFINe S
storm V;PRS;NOM(3,SG)	torm V;PRS;NOM(3,SG)and storm 
storm V;V.PTCP;PST	 P;PTCP;PSTerminal Storm V;V.P
storyboard V;PRS;NOM(3,SG)	associates storyboard storyboa
storyboard V;PST	board storyboard storyboard st
stringify V;NFIN	tringify V;NFINgify V;Ngify V;
stringify V;PST	tringify V;PSTringify V;PSTrin
stringify V;V.PTCP;PRS	;PRSe;PRSe.PTCP.PRSe.PRSe.PRSe
stringify V;V.PTCP;PST	;PSTstructuredfromtheparticula
strip-search V;NFIN	 Search Results Search Results
strip-search V;V.PTCP;PRS	;prsg-search ptcp-search ptcp-
strip-search V;V.PTCP;PST	 ptcp-search V;V.PTCP;PSTn ptc
strow V;NFIN	;NFINFINFINFINFINFINFINFINFINF
strow V;PST	 PST PST PST PST PST PST PST P
strow V;V.PTCP;PRS	;V.PTCP;PRSa;V.PTCP;PRSa.PTCP;
strow V;V.PTCP;PST	row V;V.PTCP;PSTmarow V.PTCP;P
sublime V;NFIN	;NFINessus sublime V;NFINessus
sublime V;V.PTCP;PST	 PTCP;PSTj PSTj PSTj PSTj PSTj
subsidise V;PRS;NOM(3,SG)	se V;PRS;NOM(3,SG)ationem subs
subsidise V;V.PTCP;PRS	est subsidise V;V.PTCP;PRSest 
subsidise V;V.PTCP;PST	est subsidise V;V.PTCP;PST.PTC
superordinate V;NFIN	;NFINe;NFINe;NFINe;NFINe;NFINe
superordinate V;PRS;NOM(3,SG)	;NOM(3,SG)ate V;PRS;NOM(3,SG)a
superordinate V;PST	erythrin I;PSTn I;PSTn II;PSTn
supervene V;NFIN	in proprietate supervene V;NFI
supervene V;PRS;NOM(3,SG)	est supervene V;PRS;NOM(3,SG)a
supervene V;PST	e V;PST V;PST V;PST V;PST V;PS
supervene V;V.PTCP;PRS	;V.PTCP;PRSatus est et superve
survive V;PRS;NOM(3,SG)	 to survive V;PRS;NOM(3,SG)a t
survive V;PST	 V;
PST - Projet de recherche 
survive V;V.PTCP;PRS	;V.PTCP;PRService to reduce th
terp V;NFIN	erp V;NFINerp V;Nerp V;Nerp V;
terp V;PST	erp V;PSTjerp V;PSTjerp V;PSTj
terp V;V.PTCP;PRS	 Sales Teacher Teacher Teacher
terp V;V.PTCP;PST	 PTCP;PSTjuvelp V;V.PTCP;PSTju
thrombose V;NFIN	;NFINeighbor;Neighbor;Neighbor
thrombose V;PRS;NOM(3,SG)	(3,SG)thrombose II; PRS;NOM(3,
thrombose V;V.PTCP;PST	;V.PTCP;PSTn thrombose V;V.PTC
tint V;NFIN	 In the V;NFINm In the V;NFINm
tint V;PRS;NOM(3,SG)	 am am am am am am am am am am
tint V;V.PTCP;PRS	 2017 - 2018 - 2019 - 2019 - 2
tint V;V.PTCP;PST	 PTCP PST PTCP PST PTCP PST PT
tipple V;PRS;NOM(3,SG)	PRS;NOM(3,SG)and stipple V;PRS
tipple V;PST	 PST PST PST PST PST PST PST P
tipple V;V.PTCP;PRS	 PTCP PRS PTCP PRS PTCP PRS PT
tipple V;V.PTCP;PST	 the primary tipple V;V.PTCP;P
titivate V;PRS;NOM(3,SG)	III;PRS;NOM(3,SG)ivate V;PRS;N
titivate V;V.PTCP;PRS	itivate V;V.PTCP;PRSequence of
titivate V;V.PTCP;PST	 PTCP PTCP PTCP PTCP PTCP PTCP
transsexualize V;PRS;NOM(3,SG)	 transsexualize V;PRS;NOM(3,SG
transsexualize V;PST	;PST;PST;PST;PST;PST;PST;PST;P
transsexualize V;V.PTCP;PRS	;PRSales of the PTCP to transs
transsexualize V;V.PTCP;PST	;V.PTCP;PST.TRANSSEXUALIZE V;V
trench-plough V;NFIN	lough V;NFINstrench-plough V;N
trench-plough V;PRS;NOM(3,SG)	rench-plough V;PRS;NOM(3,SG)an
trench-plough V;V.PTCP;PST	rench-plough V;V.PTCP;PSTandar
trice V;PRS;NOM(3,SG)	e comentarii de "V;PRS;NOM(3,S
trice V;PST	 autorité par le registre de 
trice V;V.PTCP;PRS	;V.PTCPRSe web site download a
trypsinise V;NFIN	 and trypsinise V;NFINse V;NFI
trypsinise V;PRS;NOM(3,SG)	(3,SG)trypsinise V;PRS;NOM(3,S
trypsinise V;V.PTCP;PRS	 : PTCP;PRSaturated Trypsinise
trypsinise V;V.PTCP;PST	 PTCP;PST.PTCP;PST.PTCP.PTCP.P
tubulate V;PRS;NOM(3,SG)	(3,SG)and (3,SG)and (3,SG)and 
tubulate V;PST	 PST V;PST V;PST V;PST V;PST V
twine V;PRS;NOM(3,SG)	wine V;PRS;NOM(3,SG)and all tw
twine V;PST	 PST 2017 PST 2018 PST 2019 PS
twine V;V.PTCP;PRS	 S;S. PTCP;PRSe call given by 
twist V;PRS;NOM(3,SG)	wist V;PRS;NOM(3,SG)and 3,SG a
twist V;PST	 1 2 3 4 5 6 7 8 9 10 11 12 13
twist V;V.PTCP;PRS	;PRSent a new beginning to the
twist V;V.PTCP;PST	 The PTCP PST PTCP PST PTCP PS
unclamp V;NFIN	 III III III III III III III I
unclamp V;PRS;NOM(3,SG)	announclamp V;PRS;NOM(3,SG)ann
unclamp V;V.PTCP;PRS	;prsentation;prsentation.com;p
undeceave V;NFIN	deceave V;NFINsinsinsinsinsins
undeceave V;PST	 PST PST PST PST PST PST PST P
underdose V;PRS;NOM(3,SG)	;NOM(3,SG)and underdose S;NOM(
underdose V;V.PTCP;PRS	;V.PTCP;PRSe;PRSe.PTCP.PTCP.PT
underdose V;V.PTCP;PST	;V.PTCP;PSTable of course V;V.
unfocus V;PST	 PST V;PST V;PST V;PST V;PST V
unfocus V;V.PTCP;PRS	 to ref V;V.PTCP;PRSe all to r
unfocus V;V.PTCP;PST	focus V;V.PTCP;PST.PTCP;PST.PT
unhyphenate V;PRS;NOM(3,SG)	ate V;PRS;NOM(3,SG)gate V;PRS;
unhyphenate V;PST	ate V;PSTate V;PSTate V;PSTate
unhyphenate V;V.PTCP;PRS	 10 (10) methyl ester 10 methy
unhyphenate V;V.PTCP;PST	ate V;V.PTCP;PSTate V.PTCP;PST
unpaint V;NFIN	paint V;NFINs V;NFINs V;NFINs 
unpaint V;PRS;NOM(3,SG)	nt stain to stain to stain to 
unperplex V;PRS;NOM(3,SG)	(3,SG)antis perplex V;PRS;NOM(
unperplex V;V.PTCP;PRS	;V.PTCP;PRSaunperplex V;V.PTCP
unperplex V;V.PTCP;PST	erplex V;V.PTCP;PSTj;V.PTCP;PS
unplat V;NFIN	par V;NFIN;NFIN;NFIN;NFIN;NFIN
unplat V;PRS;NOM(3,SG)	(3,PG)at PRS;NOM(3,SG)at PRS;N
unplat V;V.PTCP;PST	plat V;V.PTCP;PSTjunplat V.PTC
unplug V;NFIN	plug V;NFINsinsinsinsinsinsins
unplug V;PRS;NOM(3,SG)	plug PLUG PLUG PLUG PLUG PLUG 
unplug V;PST	 PST PST PST PST PST PST PST P
unplug V;V.PTCP;PST	plug V.PTCP;PSTjunplug V.PTCP;
unsell V;NFIN	sell V;NFINsell V;NFINsell V;N
unsell V;PRS;NOM(3,SG)	eine sternen sternen sternen s
unsell V;PST	ell V;PSTell V;PSTell V;PSTell
unsell V;V.PTCP;PST	en V;V.PTCP;PSTen V.PTCP;PSTen
unstabilize V;PRS;NOM(3,SG)	as a start point of the day an
upbar V;NFIN	 N;NFINmin N;NFINmin N;NFINmin
upbar V;PRS;NOM(3,SG)	bar PRS;NOM(3,SG)gan pbar PRS;
upbar V;PST	 PST par V;PST par V;PST par V
upbar V;V.PTCP;PST	 par to be new to be new to be
usher V;NFIN	NFIN NFIN NFIN NFIN NFIN NFIN 
usher V;PST	 V;PST office V;PST office V;P
usher V;V.PTCP;PRS	 PRS A P R S S A P R S S A P R
usher V;V.PTCP;PST	 p s t c p s t c p s t c p s t
vaccinate V;NFIN	accinate V;NFINseparate V;NFIN
vaccinate V;PST	accinate V;PST V;PST V;PST V;P
vaccinate V;V.PTCP;PRS	accinate the vaccinate the vac
vaccinate V;V.PTCP;PST	a prevention of vaccination an
vacillate V;PRS;NOM(3,SG)	;PRS;NOM(3,SG)and V;PRS;NOM(3,
vacillate V;V.PTCP;PRS	 1990 1990 1990 1990 1990 1990
vacillate V;V.PTCP;PST	;V.PTCP;PST;PST.PTCP;PST.PTCP.
vell V;NFIN	 V;NFINe V;NFINe V;NFINe V;NFI
vell V;PRS;NOM(3,SG)	 1 2 3 4 5 6 7 7 7 7 7 7 7 7 7
vell V;V.PTCP;PST	 PTCP;PST;PST.PTCP.PST.PTCP.PS
verbigerate V;NFIN	erbigerate V;NFINminminminminm
verbigerate V;PRS;NOM(3,SG)	erate PRS;NOM(3,SG)gerate PRS;
verbigerate V;PST	 PST te PST te PST te PST te P
verbigerate V;V.PTCP;PRS	erbigerate V;V.PTCP;PRSerbiger
viscerate V;NFIN	avisconsultate V;NFINsultate V
viscerate V;PST	a V;PST V;PST V;PST V;PST V;PS
viscerate V;V.PTCP;PRS	 PTCP;PRSe PTCP;PRSe PTCP;PRSe
viscerate V;V.PTCP;PST	 PTCP;PST PTCP PTCP PTCP PTCP 
vivificate V;NFIN	ivificate V;NFIN;NFIN;NFIN;NFI
vivificate V;PRS;NOM(3,SG)	 PRS;NOM(3,SG)vivificate V;PRS
vivificate V;PST	 V;
1 V;PST V;PST V;PST V;PST 
vivificate V;V.PTCP;PST	 Viviviviviviviviviviviviviviv
wabble V;NFIN	 V;NFINg V;NFINg V;NFINg V;NFI
wabble V;PRS;NOM(3,SG)	 wabble V;PRS;NOM(3,SG)a wabbl
wabble V;PST	 PSTO PSTO PSTO PSTO PSTO PSTO
wabble V;V.PTCP;PRS	 PTCP;PRS results 1 2 3 4 5 6 
watchdog V;NFIN	therapy and watchdog V;NFINein
watchdog V;PST	the star of the star of the st
watchdog V;V.PTCP;PST	andrologist watchdog V.PTCP;PS
water V;NFIN	 Sun Sun Sun Sun Sun Sun Sun S
water V;PST	 PST PST PST PST PST PST PST P
water V;V.PTCP;PST	 a pair of stem cells and arti
wham V;PRS;NOM(3,SG)	am am am am am am am am am am 
wham V;V.PTCP;PST	am V. V. V. V. V. V. V. V. V. 
whoomp V;NFIN	hoomp V;NFINs V;NFINs V;NFINs 
whoomp V;PRS;NOM(3,SG)	 omp omp omp omp omp omp omp o
whoomp V;PST	 ; PST ; PST ; PST ; PST ; PST
whoomp V;V.PTCP;PST	hoomp V;V.PTCP;PST.PTCP.PTCP.P
whoot V;PRS;NOM(3,SG)	 whoot whoot whoot whoot whoot
whoot V;PST	whoot V;PST V;PST V;PST V;PST 
whoot V;V.PTCP;PRS	 P;P.PTCP;PRS;PRS.PTCP.RS;PRS.
whoot V;V.PTCP;PST	 whoop V;V.PTCP;PSTraining ser
withsay V;NFIN	andsay thereinay V;NFINeithsay
withsay V;PRS;NOM(3,SG)	thearthersay PRS;NOM(3,SG)ay;N
withsay V;V.PTCP;PRS	 PRS 2009 PRS 2009 PRS 2009 PR
withsay V;V.PTCP;PST	there is a study of there is a
world V;NFIN	 No.1 No.1 No.1 No.1 No.1 No.1
world V;PRS;NOM(3,SG)	 world V;PRS;NOM(3,SG)a world 
world V;V.PTCP;PRS	 PTCP;PRS;PRS;PRS;PRS;PRS;PRS;
world V;V.PTCP;PST	 PTCP;PST;PST;PST;PST;PST;PST;
xeriscape V;PRS;NOM(3,SG)	(3,SG)a(1,00)a(1,00)a(1,00)a(1
yabby V;PRS;NOM(3,SG)	abbyabbyabbyabbyabbyabbyabbyab
yabby V;PST	abbyabbyabbyabbyabbyabbyabbyab
yearn V;NFIN	earn V;NFINteriorn V;NFINterio
yearn V;PRS;NOM(3,SG)	earn V;PRS;NOM(3,SG)arn V;PRS;
yearn V;PST	earn V;PSTfeatured yearn V;PST
yellow V;PRS;NOM(3,SG)	(3,SG)yellow V;PRS;NOM(3,SG)ye
yellow V;PST	ellow V;PST V;PST V;PST V;PST 
yellow V;V.PTCP;PRS	 V;V.PTCP;PRSe do not show off
yellow V;V.PTCP;PST	 s s s s s s s s s s s s s s s
